реагира	r e a ɡ i ɾ a
ненадарен	n e n a d a ɾ e n
овенување	ɔ v e n u v a ɲ e
залижан	z a l i ʒ a n
гостилничар	ɡ ɔ s t i ɫ n i t͡ʃ a r
неконструктивно	n e k ɔ n s t r u k t i v n ɔ
парижанка	p a r i ʒ a ŋ k a
менторка	m e n t ɔ r k a
смотанковци	s m ɔ t a ŋ k ɔ f t͡s i
уснен	u s n e n
префарбан	p r e f a r b a n
инкубација	i ŋ k u b a t͡s i j a
неразделност	n e r a z d e ɫ n ɔ s t
монтажен	m ɔ n t a ʒ e n
организми	ɔ r ɡ a n i z m i
дочува	d ɔ t͡ʃ u v a
расчепкан	r a ʃ t͡ʃ e p k a n
конечен	k ɔ n e t͡ʃ e n
држава	d r̩ ʒ a v a
бистра	b i s t r a
потсмешлив	p ɔ t s m e ʃ l i f
штетници	ʃ t e t n i t͡s i
јува	j u v a
преполнет	p r e p ɔ ɫ n e t
ојаловен	ɔ j a ɫ ɔ v e n
немаскирање	n e m a s k i ɾ a ɲ e
поручек	p ɔ ɾ u t͡ʃ e k
препознае	p r e p ɔ z n a e
оружја	ɔ ɾ u ʒ j a
бивол	b i v ɔ ɫ
врколачки	v r̩ k ɔ ɫ a t͡ʃ k i
недеактивиран	n e d e a k t i v i ɾ a n
крштевка	k r̩ ʃ t e f k a
иновативност	i n ɔ v a t i v n ɔ s t
нестоење	n e s t ɔ e ɲ e
фокусен	f ɔ k u s e n
осаменост	ɔ s a m e n ɔ s t
трапови	t r a p ɔ v i
нераздвоен	n e r a z d v ɔ e n
ѕиркан	d͡z i r k a n
љубоморење	ʎ u b ɔ m ɔ ɾ e ɲ e
избезумувачки	i z b e z u m u v a t͡ʃ k i
мустаќ	m u s t a c
драмица	d r a m i t͡s a
раскопчуван	r a s k ɔ p t͡ʃ u v a n
девет	d e v e t
напнатост	n a p n a t ɔ s t
неподатлив	n e p ɔ d a t l i f
изнапреден	i z n a p r e d e n
кривопаланечки	k r i v ɔ p a ɫ a n e t͡ʃ k i
сигурен	s i ɡ u ɾ e n
легално	l e ɡ a ɫ n ɔ
молкома	m ɔ ɫ k ɔ m a
одвратност	ɔ d v r a t n ɔ s t
лупа	ɫ u p a
дебранци	d e b r a n t͡s i
абаџија	a b a d͡ʒ i j a
стршлениште	s t r̩ ʃ l e n i ʃ t e
зла	z ɫ a
вика	v i k a
стражарка	s t r a ʒ a r k a
бановина	b a n ɔ v i n a
наврнат	n a v r̩ n a t
манипулиран	m a n i p u l i ɾ a n
земјопоседник	z e m j ɔ p ɔ s e d n i k
имј	i m a j a
чудотворци	t͡ʃ u d ɔ t v ɔ r t͡s i
али	a l i
покриви	p ɔ k r i v i
мое	m ɔ e
штипалка	ʃ t i p a ɫ k a
непретставен	n e p r e t s t a v e n
стишување	s t i ʃ u v a ɲ e
хормонално	x ɔ r m ɔ n a ɫ n ɔ
подзатегне	p ɔ d z a t e ɡ n e
извинува	i z v i n u v a
кошта	k ɔ ʃ t a
немаркирање	n e m a r k i ɾ a ɲ e
продолжува	p r ɔ d ɔ ɫ ʒ u v a
преоптеретува	p r e ɔ p t e r e t u v a
лекомисленост	l e k ɔ m i s l e n ɔ s t
соодветство	s ɔ ɔ d v e t s t v ɔ
клавичембало	k ɫ a v i t͡ʃ e m b a ɫ ɔ
катиљи	k a t i ʎ i
антифашист	a n t i f a ʃ i s t
папан	p a p a n
формализација	f ɔ r m a l i z a t͡s i j a
бојкоти	b ɔ j k ɔ t i
зашамара	z a ʃ a m a ɾ a
крекер	k r e k e r
ледина	l e d i n a
јагленисан	j a ɡ l e n i s a n
дупол	d u p ɔ ɫ
пожелност	p ɔ ʒ e ɫ n ɔ s t
целосен	t͡s e ɫ ɔ s e n
изјазен	i z j a z e n
спонзориште	s p ɔ n z ɔ ɾ i ʃ t e
трореден	t r ɔ ɾ e d e n
прататковина	p r a t a t k ɔ v i n a
достојно	d ɔ s t ɔ j n ɔ
атематски	a t e m a t s k i
сочувство	s ɔ t͡ʃ u f s t v ɔ
нереизбран	n e r e i z b r a n
сношти	s n ɔ ʃ t i
заглавување	z a ɡ ɫ a v u v a ɲ e
смлачен	s m ɫ a t͡ʃ e n
радовишанец	r a d ɔ v i ʃ a n e t͡s
издлабување	i z d ɫ a b u v a ɲ e
греши	ɡ r e ʃ i
нуакшотјанка	n u a k ʃ ɔ t j a ŋ k a
недоближување	n e d ɔ b l i ʒ u v a ɲ e
шминкан	ʃ m i ŋ k a n
отпишување	ɔ t p i ʃ u v a ɲ e
неактуализирање	n e a k t u a l i z i ɾ a ɲ e
пеликански	p e l i k a n s k i
претрпен	p r e t r̩ p e n
зачитување	z a t͡ʃ i t u v a ɲ e
поштува	p ɔ ʃ t u v a
бури	b u ɾ i
доларче	d ɔ ɫ a r t͡ʃ e
алабастер	a ɫ a b a s t e r
траурен	t r a u ɾ e n
неверодостоен	n e v e ɾ ɔ d ɔ s t ɔ e n
интригантка	i n t r i ɡ a n t k a
комедиограф	k ɔ m e d i j ɔ ɡ r a f
флуиден	f ɫ u i d e n
истражуван	i s t r a ʒ u v a n
порочност	p ɔ ɾ ɔ t͡ʃ n ɔ s t
обзнанет	ɔ b z n a n e t
препарирање	p r e p a r i ɾ a ɲ e
отплетка	ɔ t p l e t k a
неподмирување	n e p ɔ d m i r u v a ɲ e
шокира	ʃ ɔ k i ɾ a
парталко	p a r t a ɫ k ɔ
постава	p ɔ s t a v a
четврточен	t͡ʃ e t v r̩ t ɔ t͡ʃ e n
анимиран	a n i m i ɾ a n
реформиран	r e f ɔ r m i ɾ a n
подвлекува	p ɔ d v l e k u v a
колкумина	k ɔ ɫ k u m i n a
бактериолог	b a k t e ɾ i j ɔ ɫ ɔ k
самоуштво	s a m ɔ u ʃ t v ɔ
дооблечен	d ɔ ɔ b l e t͡ʃ e n
горица	ɡ ɔ ɾ i t͡s a
непреправен	n e p r e p r a v e n
дигитализира	d i ɡ i t a l i z i ɾ a
чуе	t͡ʃ u e
гризли	ɡ r i z l i
сликнува	s l i k n u v a
ливади	l i v a d i
лактозен	ɫ a k t ɔ z e n
ненадоместливост	n e n a d ɔ m e s t l i v ɔ s t
принцип	p r i n t͡s i p
говедарски	ɡ ɔ v e d a r s k i
податок	p ɔ d a t ɔ k
опрасување	ɔ p r a s u v a ɲ e
вовчиња	v ɔ f t͡ʃ i ɲ a
солитер	s ɔ l i t e r
прилегнување	p r i l e ɡ n u v a ɲ e
шнајдер	ʃ n a j d e r
бут	b u t
неклонирање	n e k ɫ ɔ n i ɾ a ɲ e
ќирил	c i ɾ i ɫ
порази	p ɔ ɾ a z i
раскашавува	r a s k a ʃ a v u v a
понишан	p ɔ n i ʃ a n
реши	r e ʃ i
изврива	i z v r i v a
чувар	t͡ʃ u v a r
горичанка	ɡ ɔ r i t͡ʃ a ŋ k a
нагласува	n a ɡ ɫ a s u v a
модернизатор	m ɔ d e r n i z a t ɔ r
цвилење	t͡s v i l e ɲ e
коректен	k ɔ r e k t e n
перфиден	p e r f i d e n
алјаски	a ʎ a s k i
мноштво	m n ɔ ʃ t v ɔ
неаболиран	n e a b ɔ l i ɾ a n
излаже	i z ɫ a ʒ e
бунар	b u n a r
мотори	m ɔ t ɔ ɾ i
осовременува	ɔ s ɔ v r e m e n u v a
автомеханичари	a f t ɔ m e x a n i t͡ʃ a ɾ i
авторитетен	a f t ɔ ɾ i t e t e n
мајмунка	m a j m u ŋ k a
поништен	p ɔ n i ʃ t e n
џудо	d͡ʒ u d ɔ
калабриски	k a ɫ a b r i s k i
отапување	ɔ t a p u v a ɲ e
кумулативно	k u m u ɫ a t i v n ɔ
обелување	ɔ b e ɫ u v a ɲ e
курбан	k u r b a n
алвеоларен	a ɫ v e ɔ ɫ a ɾ e n
шмрчка	ʃ m r̩ t͡ʃ k a
хлор	x ɫ ɔ r
кадифе	k a d i f e
отпаѓање	ɔ t p a ɟ a ɲ e
уметничиште	u m e t n i t͡ʃ i ʃ t e
воздивнува	v ɔ z d i v n u v a
долу	d ɔ ɫ u
искоренува	i s k ɔ ɾ e n u v a
бунгалов	b u ŋ ɡ a ɫ ɔ f
резервација	r e z e r v a t͡s i j a
наруча	n a ɾ u t͡ʃ a
вработува	v r a b ɔ t u v a
зашили	z a ʃ i l i
географ	ɡ e ɔ ɡ r a f
шверцува	ʃ v e r t͡s u v a
екипиче	e k i p i t͡ʃ e
бае	b a e
разѕида	r a z d͡z i d a
висина	v i s i n a
камилица	k a m i l i t͡s a
приврзаници	p r i v r̩ z a n i t͡s i
дополна	d ɔ p ɔ ɫ n a
намекне	n a m e k n e
монети	m ɔ n e t i
масиште	m a s i ʃ t e
тривиден	t r i v i d e n
поткрепи	p ɔ t k r e p i
архитект	a r x i t e k t
богомил	b ɔ ɡ ɔ m i ɫ
водоотпорно	v ɔ d ɔ ɔ t p ɔ r n ɔ
мамец	m a m e t͡s
мирнотија	m i r n ɔ t i j a
добрина	d ɔ b r i n a
материјалистка	m a t e ɾ i j a l i s t k a
летаргија	l e t a r ɡ i j a
бодрост	b ɔ d r ɔ s t
дивизија	d i v i z i j a
далечен	d a l e t͡ʃ e n
падарче	p a d a r t͡ʃ e
акнување	a k n u v a ɲ e
разврски	r a z v r̩ s k i
некодифициран	n e k ɔ d i f i t͡s i ɾ a n
гулаб	ɡ u ɫ a p
дорешен	d ɔ ɾ e ʃ e n
кипар	k i p a r
неетички	n e e t i t͡ʃ k i
постоперативен	p ɔ s t ɔ p e ɾ a t i v e n
зрее	z r e e
аранжирајќи	a ɾ a n ʒ i r a j c i
еј	e j
кал	k a ɫ
попишувач	p ɔ p i ʃ u v a t͡ʃ
балтија	b a ɫ t i j a
распојаса	r a s p ɔ j a s a
искамшикува	i s k a m ʃ i k u v a
букурештанка	b u k u r e ʃ t a ŋ k a
бинго	b i ŋ ɡ ɔ
ленинистички	l e n i n i s t i t͡ʃ k i
стомниште	s t ɔ m n i ʃ t e
човекон	t͡ʃ ɔ v e k ɔ n
заслепувачки	z a s l e p u v a t͡ʃ k i
сенкар	s e ŋ k a r
непредизвикување	n e p r e d i z v i k u v a ɲ e
модерно	m ɔ d e r n ɔ
доплеткува	d ɔ p l e t k u v a
урнува	u r n u v a
вијадукти	v i j a d u k t i
ене	e n e
пижами	p i ʒ a m i
титриран	t i t r i ɾ a n
вѕидан	v d͡z i d a n
оригиналност	ɔ ɾ i ɡ i n a ɫ n ɔ s t
влече	v l e t͡ʃ e
недостижно	n e d ɔ s t i ʒ n ɔ
ембрион	e m b r i ɔ n
оглупавуван	ɔ ɡ ɫ u p a v u v a n
облива	ɔ b l i v a
монокл	m ɔ n ɔ k ɫ̩
глави	ɡ ɫ a v i
непрооден	n e p r ɔ ɔ d e n
ректално	r e k t a ɫ n ɔ
разурнувачки	r a z u r n u v a t͡ʃ k i
катче	k a t t͡ʃ e
отпуштање	ɔ t p u ʃ t a ɲ e
внатре	v n a t r e
клепки	k l e p k i
нокширче	n ɔ k ʃ i r t͡ʃ e
серолошки	s e r ɔ ɫ ɔ ʃ k i
амарилис	a m a r i l i s
фризури	f r i z u ɾ i
исушува	i s u ʃ u v a
клириншки	k l i ɾ i n ʃ k i
непредложување	n e p r e d ɫ ɔ ʒ u v a ɲ e
рожба	r ɔ ʒ b a
јамб	j a m p
многулик	m n ɔ ɡ u l i k
надменост	n a d m e n ɔ s t
целивање	t͡s e l i v a ɲ e
ликвидира	l i k v i d i ɾ a
матријархат	m a t r i j a r x a t
протеруван	p r ɔ t e ɾ u v a n
претерување	p r e t e r u v a ɲ e
јуфка	j u f k a
педофилка	p e d ɔ f i ɫ k a
валандовски	v a ɫ a n d ɔ f s k i
ненаситно	n e n a s i t n ɔ
подносливо	p ɔ d n ɔ s l i v ɔ
арогантен	a ɾ ɔ ɡ a n t e n
мјанмар	m j a n m a r
продуценти	p r ɔ d u t͡s e n t i
градбено	ɡ r a d b e n ɔ
неследен	n e s l e d e n
ротквица	r ɔ t k v i t͡s a
мафне	m a f n e
хиенски	x i e n s k i
заебавање	z a e b a v a ɲ e
бара	b a ɾ a
погрми	p ɔ ɡ r̩ m i
зетски	z e t s k i
архивист	a r x i v i s t
бута	b u t a
азијати	a z i j a t i
ошлака	ɔ ʃ ɫ a k a
епопеја	e p ɔ p e j a
тотемизам	t ɔ t e m i z a m
возникне	v ɔ z n i k n e
бурно	b u r n ɔ
зрачење	z r a t͡ʃ e ɲ e
воочлив	v ɔ ɔ t͡ʃ l i f
спрегнат	s p r e ɡ n a t
илјадница	i ʎ a d n i t͡s a
бубалица	b u b a l i t͡s a
привлекуван	p r i v l e k u v a n
разгрнат	r a z ɡ r̩ n a t
позира	p ɔ z i ɾ a
откопча	ɔ t k ɔ p t͡ʃ a
разголување	r a z ɡ ɔ ɫ u v a ɲ e
менаџерски	m e n a d͡ʒ e r s k i
диоптер	d i ɔ p t e r
јачменче	j a t͡ʃ m e n t͡ʃ e
трансформација	t r a n s f ɔ r m a t͡s i j a
невосприемање	n e v ɔ s p r i e m a ɲ e
пушилница	p u ʃ i ɫ n i t͡s a
неисхранет	n e i s x r a n e t
свазиски	s v a z i s k i
изгубен	i z ɡ u b e n
спроведе	s p r ɔ v e d e
правец	p r a v e t͡s
непобарување	n e p ɔ b a r u v a ɲ e
огин	ɔ ɡ i n
крадешкум	k r a d e ʃ k u m
микроскопи	m i k r ɔ s k ɔ p i
краишта	k r a i ʃ t a
обмислен	ɔ b m i s l e n
идеален	i d e a l e n
апстрахиран	a p s t r a x i ɾ a n
добричи	d ɔ b r i t͡ʃ i
обеспокои	ɔ b e s p ɔ k ɔ i
шугаво	ʃ u ɡ a v ɔ
надвикан	n a d v i k a n
братучеда	b r a t u t͡ʃ e d a
поддржувач	p ɔ d d r̩ ʒ u v a t͡ʃ
идиотизам	i d i j ɔ t i z a m
укажува	u k a ʒ u v a
патешественици	p a t e ʃ e s t v e n i t͡s i
златарници	z ɫ a t a r n i t͡s i
искажан	i s k a ʒ a n
изделка	i z d e ɫ k a
месапски	m e s a p s k i
клиентелизам	k l i j e n t e l i z a m
поплави	p ɔ p ɫ a v i
етикетичка	e t i k e t i t͡ʃ k a
пленик	p l e n i k
михаил	m i x a i ɫ
беспримерност	b e s p r i m e r n ɔ s t
коментатор	k ɔ m e n t a t ɔ r
лупкање	ɫ u p k a ɲ e
непочитување	n e p ɔ t͡ʃ i t u v a ɲ e
збунетост	z b u n e t ɔ s t
кондензација	k ɔ n d e n z a t͡s i j a
склучен	s k ɫ u t͡ʃ e n
оставка	ɔ s t a f k a
ненадзиран	n e n a d z i ɾ a n
расчленуван	r a ʃ t͡ʃ l e n u v a n
кумановка	k u m a n ɔ f k a
инвентар	i ɱ v e n t a r
изземе	i z z e m e
ас	a s
меѓуножја	m e ɟ u n ɔ ʒ j a
губитничка	ɡ u b i t n i t͡ʃ k a
топаз	t ɔ p a s
воздивне	v ɔ z d i v n e
нададе	n a d a d e
затрпа	z a t r̩ p a
сатиричари	s a t i r i t͡ʃ a ɾ i
топи	t ɔ p i
саѓа	s a ɟ a
разбуричка	r a z b u ɾ i t͡ʃ k a
женствено	ʒ e n s t v e n ɔ
скубне	s k u b n e
метериз	m e t e ɾ i s
слива	s l i v a
палачинка	p a ɫ a t͡ʃ i ŋ k a
пичкари	p i t͡ʃ k a ɾ i
дипломски	d i p ɫ ɔ m s k i
довиткување	d ɔ v i t k u v a ɲ e
поткастрен	p ɔ t k a s t r e n
исекува	i s e k u v a
минималистка	m i n i m a l i s t k a
претрупува	p r e t r u p u v a
шегаџика	ʃ e ɡ a d͡ʒ i k a
водоземен	v ɔ d ɔ z e m e n
богота	b ɔ ɡ ɔ t a
ризикуван	r i z i k u v a n
заведен	z a v e d e n
небраска	n e b r a s k a
налага	n a ɫ a ɡ a
сателит	s a t e l i t
хиперактивно	x i p e r a k t i v n ɔ
осрамотуван	ɔ s r a m ɔ t u v a n
датотека	d a t ɔ t e k a
раскинок	r a s k i n ɔ k
впечатливо	f p e t͡ʃ a t l i v ɔ
чембала	t͡ʃ e m b a ɫ a
крштеница	k r̩ ʃ t e n i t͡s a
ремонтира	r e m ɔ n t i ɾ a
предупреден	p r e d u p r e d e n
реинкарнација	r e i ŋ k a r n a t͡s i j a
поплавуван	p ɔ p ɫ a v u v a n
психолингвистички	p s i x ɔ l i ŋ ɡ v i s t i t͡ʃ k i
претпочитање	p r e t p ɔ t͡ʃ i t a ɲ e
филозофија	f i ɫ ɔ z ɔ f i j a
дневник	d n e v n i k
судбоносен	s u d b ɔ n ɔ s e n
редактира	r e d a k t i ɾ a
засолнет	z a s ɔ ɫ n e t
спринтер	s p r i n t e r
херметички	x e r m e t i t͡ʃ k i
добрка	d ɔ b r̩ k a
шампион	ʃ a m p i ɔ n
багажници	b a ɡ a ʒ n i t͡s i
милосрдие	m i ɫ ɔ s r̩ d i j e
дур	d u r
незаборавање	n e z a b ɔ r a v a ɲ e
реформист	r e f ɔ r m i s t
ѕидајќи	d͡z i d a j c i
нуспроизвод	n u s p r ɔ i z v ɔ t
магистрирање	m a ɡ i s t r i ɾ a ɲ e
пополнува	p ɔ p ɔ ɫ n u v a
оддуван	ɔ d d u v a n
маршалка	m a r ʃ a ɫ k a
тастер	t a s t e r
пишува	p i ʃ u v a
семен	s e m e n
неподмачкување	n e p ɔ d m a t͡ʃ k u v a ɲ e
џезерка	d͡ʒ e z e r k a
истретира	i s t r e t i ɾ a
лабав	ɫ a b a f
малоумник	m a ɫ ɔ u m n i k
ориентациски	ɔ ɾ i j e n t a t͡s i s k i
воздигнат	v ɔ z d i ɡ n a t
отплетува	ɔ t p l e t u v a
истурен	i s t u ɾ e n
местенка	m e s t e ŋ k a
адаптери	a d a p t e ɾ i
накитување	n a k i t u v a ɲ e
прикаска	p r i k a s k a
манометар	m a n ɔ m e t a r
сеул	s e u ɫ
златица	z ɫ a t i t͡s a
игла	i ɡ ɫ a
гостилничарски	ɡ ɔ s t i ɫ n i t͡ʃ a r s k i
филип	f i l i p
неотскокнување	n e ɔ t s k ɔ k n u v a ɲ e
ракопис	r a k ɔ p i s
саатчиски	s a t t͡ʃ i s k i
идолка	i d ɔ ɫ k a
изнакопан	i z n a k ɔ p a n
табеларен	t a b e ɫ a ɾ e n
подмлади	p ɔ d m ɫ a d i
оставински	ɔ s t a v i n s k i
нетемпиран	n e t e m p i ɾ a n
валкано	v a ɫ k a n ɔ
тиркизен	t i r k i z e n
велешанче	v e l e ʃ a n t͡ʃ e
плотови	p ɫ ɔ t ɔ v i
нескротен	n e s k r ɔ t e n
попречно	p ɔ p r e t͡ʃ n ɔ
побудување	p ɔ b u d u v a ɲ e
свршеница	s v r̩ ʃ e n i t͡s a
објективност	ɔ b j e k t i v n ɔ s t
исплевен	i s p l e v e n
резимирање	r e z i m i ɾ a ɲ e
камо	k a m ɔ
ослонуван	ɔ s ɫ ɔ n u v a n
срамнет	s r a m n e t
судење	s u d e ɲ e
ординарии	ɔ r d i n a ɾ i i
масакрирање	m a s a k r i ɾ a ɲ e
необоснованост	n e ɔ b ɔ s n ɔ v a n ɔ s t
бејрут	b e j r u t
криволов	k r i v ɔ ɫ ɔ f
неизброен	n e i z b r ɔ e n
возмутување	v ɔ z m u t u v a
мице	m i t͡s e
проблематизира	p r ɔ b l e m a t i z i ɾ a
кикиритка	k i k i r i t k a
конец	k ɔ n e t͡s
состојби	s ɔ s t ɔ j b i
фунти	f u n t i
прешкрта	p r e ʃ k r̩ t a
намигнување	n a m i ɡ n u v a ɲ e
брегови	b r e ɡ ɔ v i
хокеист	x ɔ k e i s t
попее	p ɔ p e e
хедонизам	x e d ɔ n i z a m
мировен	m i ɾ ɔ v e n
крадлив	k r a d l i f
згаснување	z ɡ a s n u v a ɲ e
поѕвони	p ɔ d͡z v ɔ n i
наиде	n a i d e
филмаџии	f i ɫ m a d͡ʒ i i
разменет	r a z m e n e t
рецензира	r e t͡s e n z i ɾ a
конексија	k ɔ n e k s i j a
сатир	s a t i r
туткање	t u t k a ɲ e
припадне	p r i p a d n e
крвно	k r̩ v n ɔ
чудовишност	t͡ʃ u d ɔ v i ʃ n ɔ s t
канцероген	k a n t͡s e ɾ ɔ ɡ e n
неготинец	n e ɡ ɔ t i n e t͡s
телефони	t e l e f ɔ n i
хибридно	x i b r i d n ɔ
пластифициран	p ɫ a s t i f i t͡s i ɾ a n
’ркне	r̩ k n e
нафрлен	n a f r̩ l e n
картографиран	k a r t ɔ ɡ r a f i ɾ a n
портири	p ɔ r t i ɾ i
авантуристка	a v a n t u r i s t k a
масовно	m a s ɔ v n ɔ
незастанат	n e z a s t a n a t
негации	n e ɡ a t͡s i i
виничанче	v i n i t͡ʃ a n t͡ʃ e
обземе	ɔ b z e m e
сардисуван	s a r d i s u v a n
опнување	ɔ p n u v a ɲ e
геометриски	ɡ e ɔ m e t r i s k i
непроветрен	n e p r ɔ v e t r e n
пропржен	p r ɔ p r̩ ʒ e n
ереванец	e r e v a n e t͡s
додоманец	d ɔ d ɔ m a n e t͡s
штетење	ʃ t e t e ɲ e
лепеза	l e p e z a
подготвително	p ɔ d ɡ ɔ t v i t e ɫ n ɔ
крева	k r e v a
адмирали	a d m i r a l i
тирана	t i r a n a
раседлан	r a s e d ɫ a n
брчкајќи	b r̩ t͡ʃ k a j c i
истоштуван	i s t ɔ ʃ t u v a n
телефон	t e l e f ɔ n
удолу	u d ɔ ɫ u
мајски	m a j s k i
пинокио	p i n ɔ k i j ɔ
шишиња	ʃ i ʃ i ɲ a
ансамбл	a n s a m b ɫ̩
лектира	l e k t i ɾ a
обезвучување	ɔ b e z v u t͡ʃ u v a ɲ e
заклатување	z a k ɫ a t u v a ɲ e
дијаметрален	d i j a m e t r a l e n
интересирање	i n t e ɾ e s i ɾ a ɲ e
бунтовници	b u n t ɔ v n i t͡s i
субверзивен	s u b v e r z i v e n
фокусирање	f ɔ k u s i ɾ a ɲ e
зараснува	z a r a s n u v a
отпремнина	ɔ t p r e m n i n a
узакони	u z a k ɔ n i
боцичка	b ɔ t͡s i t͡ʃ k a
панел	p a n e ɫ
неиздржан	n e i z d r̩ ʒ a n
дудинка	d u d i ŋ k a
вкусуван	f k u s u v a n
забарски	z a b a r s k i
незаверен	n e z a v e ɾ e n
идолопоклоник	i d ɔ ɫ ɔ p ɔ k ɫ ɔ n i k
крикне	k r i k n e
мрзне	m r̩ z n e
фрустрира	f r u s t r i ɾ a
прифаќање	p r i f a c a ɲ e
надваси	n a d v a s i
отрови	ɔ t r ɔ v i
гросистички	ɡ r ɔ s i s t i t͡ʃ k i
чекалници	t͡ʃ e k a ɫ n i t͡s i
повеќејазичен	p ɔ v e c e j a z i t͡ʃ e n
колови	k ɔ ɫ ɔ v i
атлас	a t ɫ a s
ранчер	r a n t͡ʃ e r
сопартиец	s ɔ p a r t i j e t͡s
плешка	p l e ʃ k a
трошач	t r ɔ ʃ a t͡ʃ
поистоветуван	p ɔ i s t ɔ v e t u v a n
чепкалка	t͡ʃ e p k a ɫ k a
поготви	p ɔ ɡ ɔ t v i
отпадне	ɔ t p a d n e
плетка	p l e t k a
материјалист	m a t e ɾ i j a l i s t
љупи	ʎ u p i
вакцини	v a k t͡s i n i
верверичка	v e r v e ɾ i t͡ʃ k a
говетце	ɡ ɔ v e t t͡s e
евра	e v r a
империја	i m p e ɾ i j a
активист	a k t i v i s t
патешественик	p a t e ʃ e s t v e n i k
тест	t e s t
сурфериште	s u r f e ɾ i ʃ t e
балон	b a ɫ ɔ n
противвоспалителен	p r ɔ t i v v ɔ s p a l i t e l e n
мовлив	m ɔ v l i f
гризови	ɡ r i z ɔ v i
клукне	k ɫ u k n e
намрштува	n a m r̩ ʃ t u v a
довиткува	d ɔ v i t k u v a
барајќи	b a r a j c i
клеца	k l e t͡s a
растуран	r a s t u ɾ a n
шеснаес	ʃ e s n a e s
домесување	d ɔ m e s u v a ɲ e
актиниум	a k t i n i j u m
урниса	u r n i s a
творец	t v ɔ ɾ e t͡s
велибор	v e l i b ɔ r
угостителство	u ɡ ɔ s t i t e ɫ s t v ɔ
шкрга	ʃ k r̩ ɡ a
репортерка	r e p ɔ r t e r k a
огон	ɔ ɡ ɔ n
маврициец	m a v r i t͡s i j e t͡s
глупаво	ɡ ɫ u p a v ɔ
поднесување	p ɔ d n e s u v a ɲ e
ќерки	c e r k i
развојно	r a z v ɔ j n ɔ
шутовски	ʃ u t ɔ f s k i
заљубено	z a ʎ u b e n ɔ
очерупан	ɔ t͡ʃ e r u p a n
гуши	ɡ u ʃ i
закрпен	z a k r̩ p e n
претекнуван	p r e t e k n u v a n
прабаби	p r a b a b i
прекласифицира	p r e k ɫ a s i f i t͡s i ɾ a
трети	t r e t i
стокмување	s t ɔ k m u v a ɲ e
копенхашки	k ɔ p e ŋ x a ʃ k i
пребоен	p r e b ɔ e n
муслиман	m u s l i m a n
’рмбање	r̩ m b a ɲ e
отпорно	ɔ t p ɔ r n ɔ
димници	d i m n i t͡s i
оптужи	ɔ p t u ʒ i
мена	m e n a
циганштина	t͡s i ɡ a n ʃ t i n a
фронтално	f r ɔ n t a ɫ n ɔ
соединетост	s ɔ e d i n e t ɔ s t
калуѓерство	k a ɫ u ɟ e r s t v ɔ
итрина	i t r i n a
желудник	ʒ e ɫ u d n i k
фенирање	f e n i ɾ a ɲ e
кркнува	k r̩ k n u v a
библиофил	b i b l i j ɔ f i ɫ
неодвојување	n e ɔ d v ɔ j u v a ɲ e
дотрошуван	d ɔ t r ɔ ʃ u v a n
близост	b l i z ɔ s t
раскршува	r a s k r̩ ʃ u v a
пленство	p l e n s t v ɔ
маѓепсница	m a ɟ e p s n i t͡s a
дијадема	d i j a d e m a
геронтолошки	ɡ e ɾ ɔ n t ɔ ɫ ɔ ʃ k i
посветување	p ɔ s v e t u v a ɲ e
предобро	p r e d ɔ b r ɔ
бар	b a r
кришум	k r i ʃ u m
леичка	l e i t͡ʃ k a
расположено	r a s p ɔ ɫ ɔ ʒ e n ɔ
нераскревање	n e ɾ a s k r e v a ɲ e
завршно	z a v r̩ ʃ n ɔ
ве	v e
фетишист	f e t i ʃ i s t
нанадвор	n a n a d v ɔ r
ако	a k ɔ
шарки	ʃ a r k i
намачкување	n a m a t͡ʃ k u v a ɲ e
налупан	n a ɫ u p a n
инхибирање	i ŋ x i b i ɾ a ɲ e
непропустлив	n e p r ɔ p u s t l i f
трисобен	t r i s ɔ b e n
ѓонови	ɟ ɔ n ɔ v i
стопли	s t ɔ p l i
комитент	k ɔ m i t e n t
произведе	p r ɔ i z v e d e
пораснува	p ɔ r a s n u v a
апартманче	a p a r t m a n t͡ʃ e
онеспособување	ɔ n e s p ɔ s ɔ b u v a ɲ e
дни	d n i
бенин	b e n i n
феминацист	f e m i n a t͡s i s t
домери	d ɔ m e ɾ i
аранжиран	a ɾ a n ʒ i ɾ a n
нефилтрирање	n e f i ɫ t r i ɾ a ɲ e
зборовно	z b ɔ ɾ ɔ v n ɔ
јунци	j u n t͡s i
вежбовен	v e ʒ b ɔ v e n
зјапне	z j a p n e
вразуми	v r a z u m i
притворува	p r i t v ɔ ɾ u v a
муцки	m u t͡s k i
прелест	p r e l e s t
стрпливо	s t r̩ p l i v ɔ
наведнат	n a v e d n a t
обучување	ɔ b u t͡ʃ u v a ɲ e
арамбаша	a r a m b a ʃ a
хартиен	x a r t i j e n
елеганција	e l e ɡ a n t͡s i j a
летувалец	l e t u v a l e t͡s
зјае	z j a e
џилит	d͡ʒ i l i t
бушилка	b u ʃ i ɫ k a
војвотски	v ɔ j v ɔ t s k i
седумдести	s e d u m d e s t i
егоистка	e ɡ ɔ i s t k a
содржина	s ɔ d r̩ ʒ i n a
плех	p l e x
бледило	b l e d i ɫ ɔ
разжестување	r a ʒ ʒ e s t u v a ɲ e
ревматологија	r e v m a t ɔ ɫ ɔ ɡ i j a
непотенцирање	n e p ɔ t e n t͡s i ɾ a ɲ e
исламистички	i s ɫ a m i s t i t͡ʃ k i
доминирање	d ɔ m i n i ɾ a ɲ e
кружно	k r u ʒ n ɔ
одбирање	ɔ d b i ɾ a ɲ e
ѓаволче	ɟ a v ɔ ɫ t͡ʃ e
богатство	b ɔ ɡ a t s t v ɔ
крошничка	k r ɔ ʃ n i t͡ʃ k a
погано	p ɔ ɡ a n ɔ
комбенце	k ɔ m b e n t͡s e
поофка	p ɔ ɔ f k a
преврзување	p r e v r̩ z u v a ɲ e
угостување	u ɡ ɔ s t u v a ɲ e
убацува	u b a t͡s u v a
осакати	ɔ s a k a t i
опатица	ɔ p a t i t͡s a
воспоставување	v ɔ s p ɔ s t a v u v a ɲ e
сврзе	s v r̩ z e
простичок	p r ɔ s t i t͡ʃ ɔ k
доспреми	d ɔ s p r e m i
вошливост	v ɔ ʃ l i v ɔ s t
таинствен	t a i n s t v e n
смачкување	s m a t͡ʃ k u v a ɲ e
доличен	d ɔ l i t͡ʃ e n
омекнување	ɔ m e k n u v a ɲ e
сликовница	s l i k ɔ v n i t͡s a
бусени	b u s e n i
оддржува	ɔ d d r̩ ʒ u v a
прооден	p r ɔ ɔ d e n
изразување	i z r a z u v a ɲ e
пливање	p l i v a ɲ e
билатерален	b i ɫ a t e r a l e n
уф	u f
плацента	p ɫ a t͡s e n t a
ладникав	ɫ a d n i k a f
бамачанка	b a m a t͡ʃ a ŋ k a
незатоплување	n e z a t ɔ p ɫ u v a ɲ e
неостварен	n e ɔ s t v a ɾ e n
анонимизиран	a n ɔ n i m i z i ɾ a n
интригира	i n t r i ɡ i ɾ a
кметува	k m e t u v a
конфигуриран	k ɔ ɱ f i ɡ u r i ɾ a n
измиван	i z m i v a n
неусисан	n e u s i s a n
повртен	p ɔ v r̩ t e n
мотивираност	m ɔ t i v i ɾ a n ɔ s t
посипува	p ɔ s i p u v a
бакарисува	b a k a r i s u v a
шака	ʃ a k a
борч	b ɔ r t͡ʃ
повреди	p ɔ v r e d i
харковски	x a r k ɔ f s k i
дебрчанец	d e b r̩ t͡ʃ a n e t͡s
посолен	p ɔ s ɔ l e n
невлечење	n e v l e t͡ʃ e ɲ e
менѓуша	m e ɲ ɟ u ʃ a
буревесници	b u ɾ e v e s n i t͡s i
развеселен	r a z v e s e l e n
желудочен	ʒ e ɫ u d ɔ t͡ʃ e n
пушка	p u ʃ k a
прераскажан	p r e r a s k a ʒ a n
отсечоци	ɔ t s e t͡ʃ ɔ t͡s i
симбиоза	s i m b i ɔ z a
неполнење	n e p ɔ ɫ n e ɲ e
шкотски	ʃ k ɔ t s k i
трансакциски	t r a n s a k t͡s i s k i
разденување	r a z d e n u v a ɲ e
дисахарид	d i s a x a r i t
проклитичен	p r ɔ k l i t i t͡ʃ e n
вообразби	v ɔ ɔ b r a z b i
бодри	b ɔ d r i
ланчан	ɫ a n t͡ʃ a n
пригода	p r i ɡ ɔ d a
здодеан	z d ɔ d e a n
сали	s a l i
прекречен	p r e k r e t͡ʃ e n
координационен	k ɔ ɔ r d i n a t͡s i ɔ n e n
ќесиште	c e s i ʃ t e
несправедливост	n e s p r a v e d l i v ɔ s t
парафира	p a ɾ a f i ɾ a
нептун	n e p t u n
неодбивање	n e ɔ d b i v a ɲ e
беспричински	b e s p r i t͡ʃ i n s k i
бифокален	b i f ɔ k a l e n
несамостојност	n e s a m ɔ s t ɔ j n ɔ s t
калкирање	k a ɫ k i ɾ a ɲ e
тунгуски	t u ŋ ɡ u s k i
намигнува	n a m i ɡ n u v a
потиштување	p ɔ t i ʃ t u v a ɲ e
бригаден	b r i ɡ a d e n
калинка	k a l i ŋ k a
опиран	ɔ p i ɾ a n
воскосува	v ɔ s k ɔ s u v a
обвинителен	ɔ b v i n i t e l e n
печива	p e t͡ʃ i v a
скејтер	s k e j t e r
киселкаст	k i s e ɫ k a s t
разбремени	r a z b r e m e n i
бришен	b r i ʃ e n
рудари	r u d a ɾ i
намрси	n a m r̩ s i
гра	ɡ r a
варен	v a ɾ e n
распламтен	r a s p ɫ a m t e n
продаде	p r ɔ d a d e
сијалица	s i j a l i t͡s a
столици	s t ɔ l i t͡s i
ненадоместлив	n e n a d ɔ m e s t l i f
превртување	p r e v r̩ t u v a ɲ e
фиран	f i ɾ a n
опашки	ɔ p a ʃ k i
слободарски	s ɫ ɔ b ɔ d a r s k i
наесен	n a e s e n
гасометар	ɡ a s ɔ m e t a r
орјатка	ɔ r j a t k a
бројче	b r ɔ j t͡ʃ e
манамка	m a n a m k a
дамнешен	d a m n e ʃ e n
оживее	ɔ ʒ i v e e
цитоплазма	t͡s i t ɔ p ɫ a z m a
виори	v i j ɔ ɾ i
недугавост	n e d u ɡ a v ɔ s t
разнежи	r a z n e ʒ i
угнетување	u ɡ n e t u v a ɲ e
докачи	d ɔ k a t͡ʃ i
земјопосед	z e m j ɔ p ɔ s e t
видливост	v i d l i v ɔ s t
трубен	t r u b e n
колективизира	k ɔ l e k t i v i z i ɾ a
бирање	b i ɾ a ɲ e
издишка	i z d i ʃ k a
разжалостен	r a ʒ ʒ a ɫ ɔ s t e n
ксенофобично	k s e n ɔ f ɔ b i t͡ʃ n ɔ
завидливо	z a v i d l i v ɔ
илјадинка	i ʎ a d i ŋ k a
подрипнува	p ɔ d r i p n u v a
управители	u p r a v i t e l i
константно	k ɔ n s t a n t n ɔ
пиратство	p i ɾ a t s t v ɔ
североисточен	s e v e ɾ ɔ i s t ɔ t͡ʃ e n
аорта	a ɔ r t a
атаман	a t a m a n
побиен	p ɔ b i j e n
елениште	e l e n i ʃ t e
предострожност	p r e d ɔ s t r ɔ ʒ n ɔ s t
обесцени	ɔ b e s t͡s e n i
декодирање	d e k ɔ d i ɾ a ɲ e
непоткупливо	n e p ɔ t k u p l i v ɔ
газиран	ɡ a z i ɾ a n
купе	k u p e
инкубатори	i ŋ k u b a t ɔ ɾ i
соблазни	s ɔ b ɫ a z n i
кофеин	k ɔ f e i n
аранжира	a ɾ a n ʒ i ɾ a
муабетче	m u a b e t t͡ʃ e
неустрашно	n e u s t r a ʃ n ɔ
згазнува	z ɡ a z n u v a
маскатски	m a s k a t s k i
продлабочен	p r ɔ d ɫ a b ɔ t͡ʃ e n
наместува	n a m e s t u v a
доистребен	d ɔ i s t r e b e n
пекинезери	p e k i n e z e ɾ i
разузнавачки	r a z u z n a v a t͡ʃ k i
смеа	s m e a
раштркува	r a ʃ t r̩ k u v a
изотермичен	i z ɔ t e r m i t͡ʃ e n
вжарен	v ʒ a ɾ e n
плагијатор	p ɫ a ɡ i j a t ɔ r
чоколадиште	t͡ʃ ɔ k ɔ ɫ a d i ʃ t e
дораби	d ɔ ɾ a b i
засенчи	z a s e n t͡ʃ i
ловор	ɫ ɔ v ɔ r
дувла	d u v ɫ a
слатко	s ɫ a t k ɔ
пченичен	p t͡ʃ e n i t͡ʃ e n
убивање	u b i v a ɲ e
нецитиран	n e t͡s i t i ɾ a n
забрадување	z a b r a d u v a ɲ e
масен	m a s e n
мариово	m a r i j ɔ v ɔ
савана	s a v a n a
разнежува	r a z n e ʒ u v a
зголемен	z ɡ ɔ l e m e n
расече	r a s e t͡ʃ e
управуван	u p r a v u v a n
предгорја	p r e d ɡ ɔ r j a
трнливост	t r̩ n l i v ɔ s t
рамнодушно	r a m n ɔ d u ʃ n ɔ
раја	r a j a
раменце	r a m e n t͡s e
санмаринец	s a n m a r i n e t͡s
чекалница	t͡ʃ e k a ɫ n i t͡s a
забрзува	z a b r̩ z u v a
раскашавуван	r a s k a ʃ a v u v a n
феуд	f e u t
омачување	ɔ m a t͡ʃ u v a ɲ e
ќут	c u t
наденува	n a d e n u v a
шанкери	ʃ a ŋ k e ɾ i
трпање	t r̩ p a ɲ e
неинтервенирање	n e i n t e r v e n i ɾ a ɲ e
прекинувач	p r e k i n u v a t͡ʃ
женољубец	ʒ e n ɔ ʎ u b e t͡s
пљукање	p ʎ u k a ɲ e
злочин	z ɫ ɔ t͡ʃ i n
книгишта	k n i ɡ i ʃ t a
шаманка	ʃ a m a ŋ k a
камилски	k a m i ɫ s k i
детергент	d e t e r ɡ e n t
прекоси	p r e k ɔ s i
влијателно	v l i j a t e ɫ n ɔ
беџови	b e d͡ʒ ɔ v i
дакански	d a k a n s k i
овчаров	ɔ f t͡ʃ a ɾ ɔ f
скаперници	s k a p e r n i t͡s i
потенцијално	p ɔ t e n t͡s i j a ɫ n ɔ
меритократија	m e ɾ i t ɔ k r a t i j a
заблудува	z a b ɫ u d u v a
корумпиран	k ɔ ɾ u m p i ɾ a n
испохефта	i s p ɔ x e f t a
леопард	l e ɔ p a r t
неудобен	n e u d ɔ b e n
славољубивост	s ɫ a v ɔ ʎ u b i v ɔ s t
вонбрачно	v ɔ m b r a t͡ʃ n ɔ
сопственост	s ɔ p s t v e n ɔ s t
кујна	k u j n a
немирисање	n e m i r i s a ɲ e
стрв	s t r̩ f
неизбањат	n e i z b a ɲ a t
незабранет	n e z a b r a n e t
прилошки	p r i ɫ ɔ ʃ k i
квартет	k v a r t e t
џумка	d͡ʒ u m k a
конго	k ɔ ŋ ɡ ɔ
обвие	ɔ b v i j e
прогноза	p r ɔ ɡ n ɔ z a
кумин	k u m i n
вајари	v a j a ɾ i
метафизички	m e t a f i z i t͡ʃ k i
оттука	ɔ t t u k a
заболувања	z a b ɔ ɫ u v a ɲ a
матеа	m a t e a
толчник	t ɔ ɫ t͡ʃ n i k
јазолче	j a z ɔ ɫ t͡ʃ e
ознака	ɔ z n a k a
пијанка	p i j a ŋ k a
недавање	n e d a v a ɲ e
агресивност	a ɡ r e s i v n ɔ s t
родилен	r ɔ d i l e n
јавачиште	j a v a t͡ʃ i ʃ t e
прошверца	p r ɔ ʃ v e r t͡s a
харков	x a r k ɔ f
изнаправи	i z n a p r a v i
сонча	s ɔ n t͡ʃ a
аце	a t͡s e
унапреден	u n a p r e d e n
нутриционист	n u t r i t͡s i j ɔ n i s t
обвивка	ɔ b v i f k a
тротоарче	t r ɔ t ɔ a r t͡ʃ e
мило	m i ɫ ɔ
стока	s t ɔ k a
позеленува	p ɔ z e l e n u v a
штурче	ʃ t u r t͡ʃ e
корпорациски	k ɔ r p ɔ r a t͡s i s k i
триста	t r i s t a
внуков	v n u k ɔ f
засукување	z a s u k u v a ɲ e
сомнителност	s ɔ m n i t e ɫ n ɔ s t
непростен	n e p r ɔ s t e n
маникерски	m a n i k e r s k i
раслојување	r a s ɫ ɔ j u v a ɲ e
кораб	k ɔ ɾ a p
грбче	ɡ r̩ p t͡ʃ e
триаголно	t r i a ɡ ɔ ɫ n ɔ
славно	s ɫ a v n ɔ
неготвење	n e ɡ ɔ t v e ɲ e
паузира	p a u z i ɾ a
насобира	n a s ɔ b i ɾ a
ѕенѕајќи	d͡z e n d͡z a j c i
пипа	p i p a
канаѓанка	k a n a ɟ a ŋ k a
колан	k ɔ ɫ a n
наводен	n a v ɔ d e n
батали	b a t a l i
свидетелство	s v i d e t e ɫ s t v ɔ
заврши	z a v r̩ ʃ i
подизлижан	p ɔ d i z l i ʒ a n
курвање	k u r v a ɲ e
потурчува	p ɔ t u r t͡ʃ u v a
крофне	k r ɔ f n e
прекрстување	p r e k r̩ s t u v a ɲ e
срушување	s r u ʃ u v a ɲ e
макроекономија	m a k r ɔ e k ɔ n ɔ m i j a
македонка	m a k e d ɔ ŋ k a
навидум	n a v i d u m
преклопува	p r e k ɫ ɔ p u v a
безропотен	b e z r ɔ p ɔ t e n
заглавен	z a ɡ ɫ a v e n
сезнаечки	s e z n a e t͡ʃ k i
епентеза	e p e n t e z a
забарикадира	z a b a ɾ i k a d i ɾ a
андорка	a n d ɔ r k a
изграден	i z ɡ r a d e n
качествен	k a t͡ʃ e s t v e n
забучи	z a b u t͡ʃ i
дуалистка	d u a l i s t k a
полјак	p ɔ ʎ a k
семенски	s e m e n s k i
битност	b i t n ɔ s t
комарци	k ɔ m a r t͡s i
отсуство	ɔ t s u s t v ɔ
шалтер	ʃ a ɫ t e r
неиздлабен	n e i z d ɫ a b e n
доделкување	d ɔ d e ɫ k u v a ɲ e
потсопне	p ɔ t s ɔ p n e
холдинг	x ɔ ɫ d i ŋ k
индијче	i n d i j t͡ʃ e
анализира	a n a l i z i ɾ a
дневно	d n e v n ɔ
словенски	s ɫ ɔ v e n s k i
модернист	m ɔ d e r n i s t
зол	z ɔ ɫ
праматари	p r a m a t a ɾ i
роеви	r ɔ e v i
дереџе	d e ɾ e d͡ʒ e
партал	p a r t a ɫ
опаднат	ɔ p a d n a t
несовесност	n e s ɔ v e s n ɔ s t
тровче	t r ɔ f t͡ʃ e
наследно	n a s l e d n ɔ
рогоз	r ɔ ɡ ɔ s
акушерство	a k u ʃ e r s t v ɔ
педериште	p e d e ɾ i ʃ t e
колективност	k ɔ l e k t i v n ɔ s t
бесшеќерен	b e ʃ ʃ e c e ɾ e n
скандинавски	s k a n d i n a f s k i
истакнуван	i s t a k n u v a n
маторици	m a t ɔ ɾ i t͡s i
ќунк	c u ŋ k
немец	n e m e t͡s
преместуван	p r e m e s t u v a n
полза	p ɔ ɫ z a
небрежно	n e b r e ʒ n ɔ
евентуално	e v e n t u a ɫ n ɔ
оформуван	ɔ f ɔ r m u v a n
антибиотички	a n t i b i ɔ t i t͡ʃ k i
двосмислен	d v ɔ s m i s l e n
делчевски	d e ɫ t͡ʃ e f s k i
тиња	t i ɲ a
шарски	ʃ a r s k i
преправање	p r e p r a v a ɲ e
заситеност	z a s i t e n ɔ s t
морожданец	m ɔ r ɔ ʒ d a n e t͡s
заврзува	z a v r̩ z u v a
стотче	s t ɔ t t͡ʃ e
превезен	p r e v e z e n
драг	d r a k
везејќи	v e z e j c i
бакнува	b a k n u v a
селидба	s e l i d b a
дамаски	d a m a s k i
клава	k ɫ a v a
кисели	k i s e l i
осакатува	ɔ s a k a t u v a
раширен	r a ʃ i ɾ e n
мапутоанка	m a p u t ɔ a ŋ k a
лепотан	l e p ɔ t a n
нето	n e t ɔ
оптегнува	ɔ p t e ɡ n u v a
инвеститор	i ɱ v e s t i t ɔ r
тритомен	t r i t ɔ m e n
електричарка	e l e k t r i t͡ʃ a r k a
раскалуѓерува	r a s k a ɫ u ɟ e ɾ u v a
тригодишен	t r i ɡ ɔ d i ʃ e n
прајазик	p r a j a z i k
петка	p e t k a
ќупови	c u p ɔ v i
преморува	p r e m ɔ ɾ u v a
современ	s ɔ v r e m e n
кокос	k ɔ k ɔ s
квалитетен	k v a l i t e t e n
мелнички	m e ɫ n i t͡ʃ k i
доле	d ɔ l e
оптимален	ɔ p t i m a l e n
јавувајќи	j a v u v a j c i
неопоравување	n e ɔ p ɔ ɾ a v u v a ɲ e
резистентно	r e z i s t e n t n ɔ
пламеница	p ɫ a m e n i t͡s a
изумуван	i z u m u v a n
перничка	p e r n i t͡ʃ k a
отфрла	ɔ t f r̩ ɫ a
зграпчен	z ɡ r a p t͡ʃ e n
иселеништво	i s e l e n i ʃ t v ɔ
непримен	n e p r i m e n
импониран	i m p ɔ n i ɾ a n
јажар	j a ʒ a r
раштркан	r a ʃ t r̩ k a n
разглоби	r a z ɡ ɫ ɔ b i
кореографски	k ɔ ɾ e ɔ ɡ r a f s k i
закачко	z a k a t͡ʃ k ɔ
пасинок	p a s i n ɔ k
акварел	a k v a r e ɫ
услов	u s ɫ ɔ f
бленење	b l e n e ɲ e
церче	t͡s e r t͡ʃ e
постепен	p ɔ s t e p e n
вкуси	f k u s i
нагрден	n a ɡ r̩ d e n
егзотичност	e ɡ z ɔ t i t͡ʃ n ɔ s t
соговорник	s ɔ ɡ ɔ v ɔ r n i k
заемање	z a e m a ɲ e
соопштение	s ɔ ɔ p ʃ t e n i j e
подучување	p ɔ d u t͡ʃ u v a ɲ e
растечен	r a s t e t͡ʃ e n
заофка	z a ɔ f k a
боготски	b ɔ ɡ ɔ t s k i
машкоданка	m a ʃ k ɔ d a ŋ k a
патарини	p a t a ɾ i n i
долготрајно	d ɔ ɫ ɡ ɔ t r a j n ɔ
обол	ɔ b ɔ ɫ
љубителски	ʎ u b i t e ɫ s k i
однародува	ɔ d n a r ɔ d u v a
продекански	p r ɔ d e k a n s k i
докажлив	d ɔ k a ʒ l i f
фактури	f a k t u ɾ a
доловливо	d ɔ ɫ ɔ v l i v ɔ
техерански	t e x e ɾ a n s k i
мнт	m a n a t a
калци	k a ɫ t͡s i
плаштаница	p ɫ a ʃ t a n i t͡s a
вдлабне	v d ɫ a b n e
кукушанец	k u k u ʃ a n e t͡s
вниманија	v n i m a n i j a
коралски	k ɔ ɾ a ɫ s k i
бодибилдер	b ɔ d i b i ɫ d e r
професориште	p r ɔ f e s ɔ ɾ i ʃ t e
пипање	p i p a ɲ e
миловиден	m i ɫ ɔ v i d e n
п	p a
одвраќање	ɔ d v r a c a ɲ e
сонцуле	s ɔ n t͡s u l e
душкало	d u ʃ k a ɫ ɔ
подвлечен	p ɔ d v l e t͡ʃ e n
еревански	e r e v a n s k i
потковуван	p ɔ t k ɔ v u v a n
збирштина	z b i r ʃ t i n a
подмладува	p ɔ d m ɫ a d u v a
рекиште	r e k i ʃ t e
отровница	ɔ t r ɔ v n i t͡s a
лиљак	l i ʎ a k
прагови	p r a ɡ ɔ v i
снижи	s n i ʒ i
пилана	p i ɫ a n a
аха	a x a
идилично	i d i l i t͡ʃ n ɔ
циник	t͡s i n i k
кениски	k e n i s k i
повампирен	p ɔ v a m p i ɾ e n
сугерирање	s u ɡ e r i ɾ a ɲ e
врвеж	v r̩ v e ʃ
првоодделенски	p r̩ v ɔ ɔ d d e l e n s k i
определи	ɔ p r e d e l i
далечност	d a l e t͡ʃ n ɔ s t
неконсумирање	n e k ɔ n s u m i ɾ a ɲ e
препаратор	p r e p a r a t ɔ r
дрнка	d r̩ ŋ k a
запиран	z a p i ɾ a n
избрука	i z b r u k a
компонирање	k ɔ m p ɔ n i ɾ a ɲ e
лук	ɫ u k
тамошен	t a m ɔ ʃ e n
гарнирање	ɡ a r n i ɾ a ɲ e
нагаѓа	n a ɡ a ɟ a
стажантка	s t a ʒ a n t k a
ендокринологија	e n d ɔ k r i n ɔ ɫ ɔ ɡ i j a
жеднеење	ʒ e d n e e ɲ e
ашхабатка	a ʃ x a b a t k a
катмандски	k a t m a n t s k i
чести	t͡ʃ e s t i
менарха	m e n a r x a
лансиран	ɫ a n s i ɾ a n
безусловно	b e z u s ɫ ɔ v n ɔ
келнерка	k e ɫ n e r k a
астрономски	a s t r ɔ n ɔ m s k i
дијабетес	d i j a b e t e s
гана	ɡ a n a
исчупан	i ʃ t͡ʃ u p a n
необлекување	n e ɔ b l e k u v a ɲ e
помнење	p ɔ m n e ɲ e
закрила	z a k r i ɫ a
неделегиран	n e d e l e ɡ i ɾ a n
лазар	ɫ a z a r
злосторство	z ɫ ɔ s t ɔ r s t v ɔ
саксофонист	s a k s ɔ f ɔ n i s t
неиспасиран	n e i s p a s i ɾ a n
формат	f ɔ r m a t
подзачешла	p ɔ d z a t͡ʃ e ʃ ɫ a
живинарски	ʒ i v i n a r s k i
специфицирање	s p e t͡s i f i t͡s i ɾ a ɲ e
натумпани	n a t u m p a n i
остине	ɔ s t i n e
мажественост	m a ʒ e s t v e n ɔ s t
столарница	s t ɔ ɫ a r n i t͡s a
искалкулира	i s k a ɫ k u l i ɾ a
лекувачки	l e k u v a t͡ʃ k i
танзаниски	t a n z a n i s k i
џамиште	d͡ʒ a m i ʃ t e
одмрзне	ɔ d m r̩ z n e
накострешува	n a k ɔ s t r e ʃ u v a
гневови	ɡ n e v ɔ v i
вицепремиерка	v i t͡s e p r e m i e r k a
наврапит	n a v r a p i t
африкански	a f r i k a n s k i
замазнуван	z a m a z n u v a n
невакцинирање	n e v a k t͡s i n i ɾ a ɲ e
фасцинантен	f a s t͡s i n a n t e n
топонимија	t ɔ p ɔ n i m i j a
доразгледување	d ɔ ɾ a z ɡ l e d u v a ɲ e
исчеша	i ʃ t͡ʃ e ʃ a
изнаварен	i z n a v a ɾ e n
кичевчанец	k i t͡ʃ e f t͡ʃ a n e t͡s
богољубиво	b ɔ ɡ ɔ ʎ u b i v ɔ
привезочиште	p r i v e z ɔ t͡ʃ i ʃ t e
лајк	ɫ a j k
пајажина	p a j a ʒ i n a
сватен	s v a t e n
отрезнување	ɔ t r e z n u v a ɲ e
проветруван	p r ɔ v e t r u v a n
ожеднува	ɔ ʒ e d n u v a
утрапува	u t r a p u v a
необјаснување	n e ɔ b j a s n u v a ɲ e
киселини	k i s e l i n i
пазува	p a z u v a
содржење	s ɔ d r̩ ʒ e ɲ e
цирокумулус	t͡s i ɾ ɔ k u m u ɫ u s
кувајќанка	k u v a j c a ŋ k a
подосвестен	p ɔ d ɔ s v e s t e n
трауматичен	t r a u m a t i t͡ʃ e n
школува	ʃ k ɔ ɫ u v a
подоен	p ɔ d ɔ e n
неискреност	n e i s k r e n ɔ s t
тупотење	t u p ɔ t e ɲ e
охрабрување	ɔ x r a b r u v a ɲ e
релаксирање	r e ɫ a k s i ɾ a ɲ e
незначаен	n e z n a t͡ʃ a e n
вдахнат	v d a x n a t
отпишува	ɔ t p i ʃ u v a
непопустливо	n e p ɔ p u s t l i v ɔ
гени	ɡ e n i
гркинка	ɡ r̩ k i ŋ k a
самариум	s a m a ɾ i j u m
меродавно	m e r ɔ d a v n ɔ
откупи	ɔ t k u p i
фала	f a ɫ a
вајмарски	v a j m a r s k i
дојранчанки	d ɔ j r a n t͡ʃ a ŋ k i
тиранин	t i ɾ a n i n
могадишанки	m ɔ ɡ a d i ʃ a ŋ k i
хагиографија	x a ɡ i j ɔ ɡ r a f i j a
алчно	a ɫ t͡ʃ n ɔ
ангажман	a ŋ ɡ a ʒ m a n
секташтво	s e k t a ʃ t v ɔ
санхосеанец	s a ŋ x ɔ s e a n e t͡s
книжен	k n i ʒ e n
козметичарка	k ɔ z m e t i t͡ʃ a r k a
бескарактерен	b e s k a r a k t e ɾ e n
ергативен	e r ɡ a t i v e n
несогласност	n e s ɔ ɡ ɫ a s n ɔ s t
отпара	ɔ t p a ɾ a
поднебја	p ɔ d n e b j a
расчетка	r a ʃ t͡ʃ e t k a
заквичува	z a k v i t͡ʃ u v a
арубиски	a r u b i s k i
неоткован	n e ɔ t k ɔ v a n
образуван	ɔ b r a z u v a n
алармен	a ɫ a r m e n
непрецизен	n e p r e t͡s i z e n
личење	l i t͡ʃ e ɲ e
хероин	x e ɾ ɔ i n
есцајг	e s t͡s a j k
комитетлија	k ɔ m i t e t l i j a
добротворен	d ɔ b r ɔ t v ɔ ɾ e n
постење	p ɔ s t e ɲ e
композиции	k ɔ m p ɔ z i t͡s i i
латиноамерикански	ɫ a t i n ɔ a m e r i k a n s k i
неприменување	n e p r i m e n u v a ɲ e
потекнување	p ɔ t e k n u v a ɲ e
скијање	s k i j a ɲ e
индустријализира	i n d u s t r i j a l i z i ɾ a
пржелика	p r̩ ʒ e l i k a
литосфера	l i t ɔ s f e ɾ a
изгазен	i z ɡ a z e n
неопашан	n e ɔ p a ʃ a n
релативизиран	r e ɫ a t i v i z i ɾ a n
полуготов	p ɔ ɫ u ɡ ɔ t ɔ f
сметки	s m e t k i
специјалец	s p e t͡s i j a l e t͡s
расрди	r a s r̩ d i
поцрнува	p ɔ t͡s r̩ n u v a
суетност	s u e t n ɔ s t
оксидиран	ɔ k s i d i ɾ a n
бессончев	b e s s ɔ n t͡ʃ e f
затворан	z a t v ɔ ɾ a n
нагрдување	n a ɡ r̩ d u v a ɲ e
исцелува	i s t͡s e ɫ u v a
исцртување	i s t͡s r̩ t u v a ɲ e
пневматика	p n e v m a t i k a
неполиен	n e p ɔ l i j e n
разбоксиран	r a z b ɔ k s i ɾ a n
неиселен	n e i s e l e n
’ргање	r̩ ɡ a ɲ e
бадемов	b a d e m ɔ f
налудничав	n a ɫ u d n i t͡ʃ a f
куфери	k u f e ɾ i
ѓеврек	ɟ e v r e k
букира	b u k i ɾ a
неќарење	n e c a ɾ e ɲ e
возвеличување	v ɔ z v e l i t͡ʃ u v a ɲ e
перен	p e ɾ e n
беспрекорен	b e s p r e k ɔ ɾ e n
меми	m e m i
неспастрен	n e s p a s t r e n
побратими	p ɔ b r a t i m i
исползи	i s p ɔ ɫ z i
неотварање	n e ɔ t v a ɾ a ɲ e
протолкуван	p r ɔ t ɔ ɫ k u v a n
заштедува	z a ʃ t e d u v a
урнатина	u r n a t i n a
кити	k i t i
капитализиран	k a p i t a l i z i ɾ a n
заледува	z a l e d u v a
подгорчување	p ɔ d ɡ ɔ r t͡ʃ u v a ɲ e
сестриче	s e s t r i t͡ʃ e
неподмитливост	n e p ɔ d m i t l i v ɔ s t
уважуван	u v a ʒ u v a n
неблокиран	n e b ɫ ɔ k i ɾ a n
врвка	v r̩ f k a
преоптеретеност	p r e ɔ p t e r e t e n ɔ s t
неиспупчен	n e i s p u p t͡ʃ e n
овчи	ɔ f t͡ʃ i
конфети	k ɔ ɱ f e t i
балкан	b a ɫ k a n
подразвесели	p ɔ d r a z v e s e l i
кучуле	k u t͡ʃ u l e
осетлив	ɔ s e t l i f
кингстон	k i ŋ k s t ɔ n
часовниче	t͡ʃ a s ɔ v n i t͡ʃ e
поднамокри	p ɔ d n a m ɔ k r i
скинува	s k i n u v a
засмевање	z a s m e v a ɲ e
разлутување	r a z ɫ u t u v a ɲ e
бокалче	b ɔ k a ɫ t͡ʃ e
сузбиен	s u z b i j e n
ламја	ɫ a m j a
синтетизирање	s i n t e t i z i ɾ a ɲ e
брборка	b r̩ b ɔ r k a
сталеж	s t a l e ʃ
инспекторка	i n s p e k t ɔ r k a
крило	k r i ɫ ɔ
бескарактерност	b e s k a r a k t e r n ɔ s t
лексикограф	l e k s i k ɔ ɡ r a f
поплочи	p ɔ p ɫ ɔ t͡ʃ i
чамец	t͡ʃ a m e t͡s
намоткан	n a m ɔ t k a n
неутешно	n e u t e ʃ n ɔ
као	k a ɔ
низина	n i z i n a
дијалошки	d i j a ɫ ɔ ʃ k i
обичаи	ɔ b i t͡ʃ a i
сипаници	s i p a n i t͡s i
карета	k a r e t a
претсобја	p r e t s ɔ b j a
незакочен	n e z a k ɔ t͡ʃ e n
вати	v a t i
задоволуван	z a d ɔ v ɔ ɫ u v a n
патоводен	p a t ɔ v ɔ d e n
потиснување	p ɔ t i s n u v a ɲ e
спечалуван	s p e t͡ʃ a ɫ u v a n
разруши	r a z r u ʃ i
охридски	ɔ x r i t s k i
птичка	p t i t͡ʃ k a
рапсодија	r a p s ɔ d i j a
варвари	v a r v a ɾ i
поднаместен	p ɔ d n a m e s t e n
стружење	s t r u ʒ e ɲ e
сочувува	s ɔ t͡ʃ u v u v a
дневен	d n e v e n
ливадичка	l i v a d i t͡ʃ k a
лоботомија	ɫ ɔ b ɔ t ɔ m i j a
човечност	t͡ʃ ɔ v e t͡ʃ n ɔ s t
земјовладение	z e m j ɔ v ɫ a d e n i j e
казан	k a z a n
откочи	ɔ t k ɔ t͡ʃ i
врвно	v r̩ v n ɔ
ц	t͡s a
преиспита	p r e i s p i t a
сенф	s e ɱ f
шиљо	ʃ i ʎ ɔ
слушне	s ɫ u ʃ n e
женчуле	ʒ e n t͡ʃ u l e
зорт	z ɔ r t
идентификување	i d e n t i f i k u v a ɲ e
креда	k r e d a
згоден	z ɡ ɔ d e n
учебници	u t͡ʃ e b n i t͡s i
полувокален	p ɔ ɫ u v ɔ k a l e n
граничење	ɡ r a n i t͡ʃ e ɲ e
првенство	p r̩ v e n s t v ɔ
туженик	t u ʒ e n i k
разори	r a z ɔ ɾ i
лилаков	l i ɫ a k ɔ f
двоспратен	d v ɔ s p r a t e n
тежиште	t e ʒ i ʃ t e
привилегија	p r i v i l e ɡ i j a
урива	u ɾ i v a
строго	s t r ɔ ɡ ɔ
налутен	n a ɫ u t e n
историчарка	i s t ɔ r i t͡ʃ a r k a
адвокатски	a d v ɔ k a t s k i
фабрика	f a b r i k a
служење	s ɫ u ʒ e ɲ e
телиња	t e l i ɲ a
љ	ʎ a
ирена	i r e n a
неиспилен	n e i s p i l e n
цуцкање	t͡s u t͡s k a ɲ e
недигнат	n e d i ɡ n a t
еуфемизам	e u f e m i z a m
трезно	t r e z n ɔ
седум	s e d u m
доручек	d ɔ ɾ u t͡ʃ e k
вклучување	f k ɫ u t͡ʃ u v a ɲ e
хрват	x r̩ v a t
исфали	i s f a l i
лаф	ɫ a f
маѓарско	m a ɟ a r s k ɔ
лексикографски	l e k s i k ɔ ɡ r a f s k i
песочници	p e s ɔ t͡ʃ n i t͡s i
богобојазливост	b ɔ ɡ ɔ b ɔ j a z l i v ɔ s t
годи	ɡ ɔ d i
сенце	s e n t͡s e
рамнодушен	r a m n ɔ d u ʃ e n
манифест	m a n i f e s t
презвитер	p r e z v i t e r
црни	t͡s r̩ n i
класик	k ɫ a s i k
запленување	z a p l e n u v a ɲ e
вденуван	v d e n u v a n
издлабуван	i z d ɫ a b u v a n
топографија	t ɔ p ɔ ɡ r a f i j a
протекционистка	p r ɔ t e k t͡s i j ɔ n i s t k a
нематеријално	n e m a t e ɾ i j a ɫ n ɔ
брава	b r a v a
штипалки	ʃ t i p a ɫ k i
парцијален	p a r t͡s i j a l e n
амбуланти	a m b u ɫ a n t i
танчер	t a n t͡ʃ e r
натпревари	n a t p r e v a ɾ i
здогледа	z d ɔ ɡ l e d a
пијанчење	p i j a n t͡ʃ e ɲ e
критикуван	k r i t i k u v a n
спојува	s p ɔ j u v a
збуни	z b u n i
џадиња	d͡ʒ a d i ɲ a
меѓународно	m e ɟ u n a ɾ ɔ d n ɔ
прелудиум	p r e ɫ u d i j u m
флизер	f l i z e r
прекисне	p r e k i s n e
авиониште	a v i ɔ n i ʃ t e
аргентинка	a r ɡ e n t i ŋ k a
фрустрирање	f r u s t r i ɾ a ɲ e
подмолен	p ɔ d m ɔ l e n
боровинки	b ɔ r ɔ v i ŋ k i
масер	m a s e r
незадржување	n e z a d r̩ ʒ u v a ɲ e
пицерија	p i t͡s e ɾ i j a
нерепетиран	n e ɾ e p e t i ɾ a n
препевање	p r e p e v a ɲ e
папирологија	p a p i ɾ ɔ ɫ ɔ ɡ i j a
заплетка	z a p l e t k a
скренува	s k r e n u v a
гурабија	ɡ u r a b i j a
распознавање	r a s p ɔ z n a v a ɲ e
идиличен	i d i l i t͡ʃ e n
инвентивен	i ɱ v e n t i v e n
линчување	l i n t͡ʃ u v a ɲ e
недохранет	n e d ɔ x r a n e t
соучесница	s ɔ u t͡ʃ e s n i t͡s a
прекинување	p r e k i n u v a ɲ e
активација	a k t i v a t͡s i j a
чувство	t͡ʃ u f s t v ɔ
вжештен	v ʒ e ʃ t e n
преторијка	p r e t ɔ ɾ i j k a
заљубува	z a ʎ u b u v a
америциум	a m e r i t͡s i j u m
укор	u k ɔ r
алоцира	a ɫ ɔ t͡s i ɾ a
превртува	p r e v r̩ t u v a
дунав	d u n a f
досади	d ɔ s a d i
разонода	r a z ɔ n ɔ d a
информиран	i ɱ f ɔ r m i ɾ a n
теснински	t e s n i n s k i
вдомуван	v d ɔ m u v a n
водоскок	v ɔ d ɔ s k ɔ k
одвојување	ɔ d v ɔ j u v a ɲ e
доближуван	d ɔ b l i ʒ u v a n
ненајмување	n e n a j m u v a ɲ e
двоглав	d v ɔ ɡ ɫ a f
римјанин	r i m j a n i n
геодетски	ɡ e ɔ d e t s k i
зломислено	z ɫ ɔ m i s l e n ɔ
парченце	p a r t͡ʃ e n t͡s e
гугање	ɡ u ɡ a ɲ e
нерасхефтан	n e r a s x e f t a n
автомобилски	a f t ɔ m ɔ b i ɫ s k i
негалење	n e ɡ a l e ɲ e
домешува	d ɔ m e ʃ u v a
теслиште	t e s l i ʃ t e
пердув	p e r d u f
прочитан	p r ɔ t͡ʃ i t a n
паника	p a n i k a
штипјанки	ʃ t i p j a ŋ k i
излачен	i z ɫ a t͡ʃ e n
декоративен	d e k ɔ ɾ a t i v e n
дотекува	d ɔ t e k u v a
бордел	b ɔ r d e ɫ
натрапничка	n a t r a p n i t͡ʃ k a
срца	s r̩ t͡s a
ѓаолка	ɟ a ɔ ɫ k a
робје	r ɔ b j e
уличен	u l i t͡ʃ e n
затвореничка	z a t v ɔ r e n i t͡ʃ k a
невклопен	n e f k ɫ ɔ p e n
погледнување	p ɔ ɡ l e d n u v a ɲ e
рафиниран	r a f i n i ɾ a n
неовенат	n e ɔ v e n a t
жештина	ʒ e ʃ t i n a
норвешки	n ɔ r v e ʃ k i
авокада	a v ɔ k a d a
крекнување	k r e k n u v a ɲ e
шверца	ʃ v e r t͡s a
регионализам	r e ɡ i j ɔ n a l i z a m
мајче	m a j t͡ʃ e
подбуцне	p ɔ d b u t͡s n e
стандардизиран	s t a n d a r d i z i ɾ a n
закупец	z a k u p e t͡s
антиталент	a n t i t a l e n t
расади	r a s a d i
стокмува	s t ɔ k m u v a
непоминат	n e p ɔ m i n a t
премиериште	p r e m i e ɾ i ʃ t e
поларизиран	p ɔ ɫ a ɾ i z i ɾ a n
насмевнат	n a s m e v n a t
чуки	t͡ʃ u k i
стокми	s t ɔ k m i
онеми	ɔ n e m i
брцање	b r̩ t͡s a ɲ e
јаничарче	j a n i t͡ʃ a r t͡ʃ e
сетилно	s e t i ɫ n ɔ
сложувалки	s ɫ ɔ ʒ u v a ɫ k i
прабаба	p r a b a b a
никозијка	n i k ɔ z i j k a
фркне	f r̩ k n e
молер	m ɔ l e r
прослави	p r ɔ s ɫ a v i
криќанец	k r i c a n e t͡s
расадува	r a s a d u v a
послужавник	p ɔ s ɫ u ʒ a v n i k
громогласен	ɡ r ɔ m ɔ ɡ ɫ a s e n
вонсезонски	v ɔ n s e z ɔ n s k i
њујорчанец	ɲ u j ɔ r t͡ʃ a n e t͡s
суванка	s u v a ŋ k a
црево	t͡s r e v ɔ
вртоглав	v r̩ t ɔ ɡ ɫ a f
фоки	f ɔ k i
назначуван	n a z n a t͡ʃ u v a n
незаборавно	n e z a b ɔ ɾ a v n ɔ
претшколски	p r e t ʃ k ɔ ɫ s k i
усни	u s n i
насилнички	n a s i ɫ n i t͡ʃ k i
блузон	b ɫ u z ɔ n
дизелаш	d i z e ɫ a ʃ
духовнички	d u x ɔ v n i t͡ʃ k i
одличие	ɔ d l i t͡ʃ i j e
бунтувајќи	b u n t u v a j c i
одвртен	ɔ d v r̩ t e n
инцестуозно	i n t͡s e s t u ɔ z n ɔ
претресува	p r e t r e s u v a
собере	s ɔ b e ɾ e
загрозеност	z a ɡ r ɔ z e n ɔ s t
солзен	s ɔ ɫ z e n
лингвист	l i ŋ ɡ v i s t
востание	v ɔ s t a n i j e
сликнат	s l i k n a t
бездомници	b e z d ɔ m n i t͡s i
бибер	b i b e r
посетеност	p ɔ s e t e n ɔ s t
мизогинија	m i z ɔ ɡ i n i j a
екстремно	e k s t r e m n ɔ
делче	d e ɫ t͡ʃ e
срами	s r a m i
алергичност	a l e r ɡ i t͡ʃ n ɔ s t
бигоросување	b i ɡ ɔ ɾ ɔ s u v a ɲ e
деветсто	d e v e t s t ɔ
чворче	t͡ʃ v ɔ r t͡ʃ e
слепоочница	s l e p ɔ ɔ t͡ʃ n i t͡s a
бернец	b e r n e t͡s
цементира	t͡s e m e n t i ɾ a
овековечен	ɔ v e k ɔ v e t͡ʃ e n
ноќно	n ɔ c n ɔ
струготина	s t r u ɡ ɔ t i n a
колџија	k ɔ ɫ d͡ʒ i j a
хиерархиски	x i j e r a r x i s k i
ластиче	ɫ a s t i t͡ʃ e
дамка	d a m k a
мачкање	m a t͡ʃ k a ɲ e
пајачиште	p a j a t͡ʃ i ʃ t e
вентијага	v e n t i j a ɡ a
осуши	ɔ s u ʃ i
секад	s e k a t
неприспособливо	n e p r i s p ɔ s ɔ b l i v ɔ
хиероглиф	x i j e ɾ ɔ ɡ l i f
романтично	r ɔ m a n t i t͡ʃ n ɔ
испукува	i s p u k u v a
хигрометар	x i ɡ r ɔ m e t a r
тресе	t r e s e
богданци	b ɔ ɡ d a n t͡s i
здивне	z d i v n e
салон	s a ɫ ɔ n
должини	d ɔ ɫ ʒ i n i
безмалку	b e z m a ɫ k u
безвредно	b e z v r e d n ɔ
размазуван	r a z m a z u v a n
тримесечен	t r i m e s e t͡ʃ e n
загушен	z a ɡ u ʃ e n
распостеле	r a s p ɔ s t e l e
малтежанка	m a ɫ t e ʒ a ŋ k a
незаврзување	n e z a v r̩ z u v a ɲ e
накаже	n a k a ʒ e
вруќини	v r u c i n i
сврзувачки	s v r̩ z u v a t͡ʃ k i
пури	p u ɾ i
докачен	d ɔ k a t͡ʃ e n
газа	ɡ a z a
огранок	ɔ ɡ r a n ɔ k
тросед	t r ɔ s e t
вакуумиран	v a k u m i ɾ a n
непотполен	n e p ɔ t p ɔ l e n
непостење	n e p ɔ s t e ɲ e
противници	p r ɔ t i v n i t͡s i
долгосежно	d ɔ ɫ ɡ ɔ s e ʒ n ɔ
налетува	n a l e t u v a
довалка	d ɔ v a ɫ k a
образование	ɔ b r a z ɔ v a n i j e
млека	m l e k a
пајки	p a j k i
автобуска	a f t ɔ b u s k a
изживее	i ʒ ʒ i v e e
топорење	t ɔ p ɔ ɾ e ɲ e
бунарски	b u n a r s k i
гризнуван	ɡ r i z n u v a n
челист	t͡ʃ e l i s t
дораскажува	d ɔ ɾ a s k a ʒ u v a
непрекажан	n e p r e k a ʒ a n
комичарски	k ɔ m i t͡ʃ a r s k i
видрин	v i d r i n
нередуциран	n e ɾ e d u t͡s i ɾ a n
институт	i n s t i t u t
пираниште	p i r a n i ʃ t e
предуслов	p r e d u s ɫ ɔ f
конгоанец	k ɔ ŋ ɡ ɔ a n e t͡s
претчувствуван	p r e t t͡ʃ u f s t v u v a n
јазолен	j a z ɔ l e n
гулабов	ɡ u ɫ a b ɔ f
тектоника	t e k t ɔ n i k a
неизговорлив	n e i z ɡ ɔ v ɔ r l i f
номинирање	n ɔ m i n i ɾ a ɲ e
настојува	n a s t ɔ j u v a
опортунистка	ɔ p ɔ r t u n i s t k a
плеснат	p l e s n a t
кориснички	k ɔ r i s n i t͡ʃ k i
закономерен	z a k ɔ n ɔ m e ɾ e n
презентација	p r e z e n t a t͡s i j a
мајки	m a j k i
велингтонски	v e l i ŋ k t ɔ n s k i
малибу	m a l i b u
животинка	ʒ i v ɔ t i ŋ k a
ортак	ɔ r t a k
вкусувајќи	f k u s u v a j c i
растревожуван	r a s t r e v ɔ ʒ u v a n
блесок	b l e s ɔ k
вектор	v e k t ɔ r
ломе	ɫ ɔ m e
нетрпеливо	n e t r̩ p e l i v ɔ
автостоперка	a f t ɔ s t ɔ p e r k a
нелуфтирање	n e ɫ u f t i ɾ a ɲ e
слее	s l e e
трга	t r̩ ɡ a
извлекуван	i z v l e k u v a
препораки	p r e p ɔ ɾ a k i
пријателство	p r i j a t e ɫ s t v ɔ
уставно	u s t a v n ɔ
лажливци	ɫ a ʒ l i f t͡s i
небо	n e b ɔ
кошници	k ɔ ʃ n i t͡s i
дочитан	d ɔ t͡ʃ i t a n
ет	e t
полуосветлен	p ɔ ɫ u ɔ s v e t l e n
наблажување	n a b ɫ a ʒ u v a ɲ e
бесплодност	b e s p ɫ ɔ d n ɔ s t
протеран	p r ɔ t e ɾ a n
зрел	z r e ɫ
инквизиција	i ŋ k v i z i t͡s i j a
соединување	s ɔ e d i n u v a ɲ e
локализира	ɫ ɔ k a l i z i ɾ a
неозначен	n e ɔ z n a t͡ʃ e n
етиопјанка	e t i ɔ p j a ŋ k a
челичана	t͡ʃ e l i t͡ʃ a n a
пициште	p i t͡s i ʃ t e
мравја	m r a v j a
презакопуван	p r e z a k ɔ p u v a n
квиз	k v i s
легитимно	l e ɡ i t i m n ɔ
предлага	p r e d ɫ a ɡ a
главоболка	ɡ ɫ a v ɔ b ɔ ɫ k a
допразни	d ɔ p r a z n i
наградуван	n a ɡ r a d u v a n
тестер	t e s t e r
незастапен	n e z a s t a p e n
соба	s ɔ b a
морнари	m ɔ r n a ɾ i
четриесе	t͡ʃ e t r i j e s e
делкан	d e ɫ k a n
длапка	d ɫ a p k a
брадиче	b r a d i t͡ʃ e
вливајќи	v l i v a j c i
павкање	p a f k a ɲ e
платно	p ɫ a t n ɔ
годење	ɡ ɔ d e ɲ e
ненегирање	n e n e ɡ i ɾ a ɲ e
незакотвување	n e z a k ɔ t v u v a ɲ e
невлезен	n e v l e z e n
клункање	k ɫ u ŋ k a ɲ e
размерлив	r a z m e r l i f
туширање	t u ʃ i ɾ a ɲ e
другарски	d r u ɡ a r s k i
емигрантка	e m i ɡ r a n t k a
револуционизира	r e v ɔ ɫ u t͡s i j ɔ n i z i ɾ a
помислување	p ɔ m i s ɫ u v a ɲ e
пигмент	p i ɡ m e n t
нацеди	n a t͡s e d i
фундаментален	f u n d a m e n t a l e n
насмее	n a s m e e
ригански	r i ɡ a n s k i
богословие	b ɔ ɡ ɔ s ɫ ɔ v i j e
обиколи	ɔ b i k ɔ l i
шура	ʃ u ɾ a
аниматор	a n i m a t ɔ r
размрежува	r a z m r e ʒ u v a
актофка	a k t ɔ f k a
творен	t v ɔ ɾ e n
ѕвонливо	d͡z v ɔ n l i v ɔ
излапа	i z ɫ a p a
монархија	m ɔ n a r x i j a
портлуисанка	p ɔ r t ɫ u i s a ŋ k a
облие	ɔ b l i j e
простачиште	p r ɔ s t a t͡ʃ i ʃ t e
леснотија	l e s n ɔ t i j a
погерманчи	p ɔ ɡ e r m a n t͡ʃ i
потпевнување	p ɔ t p e v n u v a ɲ e
гледан	ɡ l e d a n
виц	v i t͡s
побиван	p ɔ b i v a n
убав	u b a f
собудува	s ɔ b u d u v a
стоногалка	s t ɔ n ɔ ɡ a ɫ k a
нецентрализирано	n e t͡s e n t r a l i z i ɾ a n ɔ
нумерира	n u m e r i ɾ a
транспониран	t r a n s p ɔ n i ɾ a n
оџаци	ɔ d͡ʒ a t͡s i
мажите	m a ʒ i t e
крастав	k r a s t a f
нефлексибилен	n e f l e k s i b i l e n
хашки	x a ʃ k i
раскокан	r a s k ɔ k a n
пристаништа	p r i s t a n i ʃ t a
неподмладен	n e p ɔ d m ɫ a d e n
младичок	m ɫ a d i t͡ʃ ɔ k
отсликан	ɔ t s l i k a n
пакистански	p a k i s t a n s k i
заврне	z a v r̩ n e
љубичица	ʎ u b i t͡ʃ i t͡s a
самонаплата	s a m ɔ n a p ɫ a t a
валандовчанец	v a ɫ a n d ɔ f t͡ʃ a n e t͡s
кларинет	k ɫ a ɾ i n e t
витези	v i t e z i
мудроштина	m u d r ɔ ʃ t i n a
копнежливо	k ɔ p n e ʒ l i v ɔ
рачуле	r a t͡ʃ u l e
шеријат	ʃ e ɾ i j a t
мугра	m u ɡ r a
штампа	ʃ t a m p a
антифашистички	a n t i f a ʃ i s t i t͡ʃ k i
тимар	t i m a r
нагол	n a ɡ ɔ ɫ
планктон	p ɫ a ŋ k t ɔ n
скакулец	s k a k u l e t͡s
баклавичка	b a k ɫ a v i t͡ʃ k a
доистребуван	d ɔ i s t r e b u v a n
наградиште	n a ɡ r a d i ʃ t e
стокхолмци	s t ɔ k x ɔ ɫ m t͡s i
пожарна	p ɔ ʒ a r n a
испокара	i s p ɔ k a ɾ a
нишање	n i ʃ a ɲ e
известува	i z v e s t u v a
одвлекува	ɔ d v l e k u v a
ладничок	ɫ a d n i t͡ʃ ɔ k
породилно	p ɔ r ɔ d i ɫ n ɔ
набеден	n a b e d e n
комесаријат	k ɔ m e s a ɾ i j a t
жалбено	ʒ a ɫ b e n ɔ
догнивање	d ɔ ɡ n i v a ɲ e
испогази	i s p ɔ ɡ a z i
продлабочуван	p r ɔ d ɫ a b ɔ t͡ʃ u v a n
изнамрчи	i z n a m r̩ t͡ʃ i
налози	n a ɫ ɔ z i
лупење	ɫ u p e ɲ e
лош	ɫ ɔ ʃ
нагласоци	n a ɡ ɫ a s ɔ t͡s i
напудрен	n a p u d r e n
поејќи	p ɔ e j c i
сешто	s e ʃ t ɔ
нагрби	n a ɡ r̩ b i
феноменологија	f e n ɔ m e n ɔ ɫ ɔ ɡ i j a
шкаф	ʃ k a f
жезло	ʒ e z ɫ ɔ
ненадејно	n e n a d e j n ɔ
неусогласено	n e u s ɔ ɡ ɫ a s e n ɔ
производителка	p r ɔ i z v ɔ d i t e ɫ k a
малави	m a ɫ a v i
здравка	z d r a f k a
бликнувајќи	b l i k n u v a j c i
обезименет	ɔ b e z i m e n e t
ненагостен	n e n a ɡ ɔ s t e n
одзади	ɔ d z a d i
тенисериште	t e n i s e ɾ i ʃ t e
ракуниште	r a k u n i ʃ t e
полжавски	p ɔ ɫ ʒ a f s k i
фалбаџика	f a ɫ b a d͡ʒ i k a
мирудија	m i r u d i j a
дораскажан	d ɔ r a s k a ʒ a n
информативност	i ɱ f ɔ r m a t i v n ɔ s t
различен	r a z l i t͡ʃ e n
инвалид	i ɱ v a l i t
немонтиран	n e m ɔ n t i ɾ a n
структуралистички	s t r u k t u ɾ a l i s t i t͡ʃ k i
преглуп	p r e ɡ ɫ u p
главатарски	ɡ ɫ a v a t a r s k i
лицитиран	l i t͡s i t i ɾ a n
стрви	s t r̩ v i
вмеша	v m e ʃ a
вообразено	v ɔ ɔ b r a z e n ɔ
домет	d ɔ m e t
подизрамни	p ɔ d i z r a m n i
полов	p ɔ ɫ ɔ f
стопуван	s t ɔ p u v a n
прегазуван	p r e ɡ a z u v a n
ободрувачки	ɔ b ɔ d r u v a t͡ʃ k i
делегитимира	d e l e ɡ i t i m i ɾ a
ломејски	ɫ ɔ m e j s k i
сантодомингоански	s a n t ɔ d ɔ m i ŋ ɡ ɔ a n s k i
догматизам	d ɔ ɡ m a t i z a m
географија	ɡ e ɔ ɡ r a f i j a
онанија	ɔ n a n i j a
еклер	e k l e r
пионерски	p i j ɔ n e r s k i
обусловуван	ɔ b u s ɫ ɔ v u v a n
поколение	p ɔ k ɔ l e n i j e
солена	s ɔ l e n a
либела	l i b e ɫ a
билатерално	b i ɫ a t e r a ɫ n ɔ
два	d v a
отсутно	ɔ t s u t n ɔ
трупци	t r u p t͡s i
мае	m a e
изигран	i z i ɡ r a n
корегирање	k ɔ ɾ e ɡ i ɾ a ɲ e
џорџтаунци	d͡ʒ ɔ r t͡ʃ t a u n t͡s i
подарување	p ɔ d a r u v a ɲ e
разочара	r a z ɔ t͡ʃ a ɾ a
вртка	v r̩ t k a
бански	b a n s k i
распишуван	r a s p i ʃ u v a n
исонча	i s ɔ n t͡ʃ a
судови	s u d ɔ v i
поштеди	p ɔ ʃ t e d i
рефлекс	r e f l e k s
сузбивање	s u z b i v a ɲ e
плуто	p ɫ u t ɔ
исправуван	i s p r a v u v a n
бормашина	b ɔ r m a ʃ i n a
манипулантка	m a n i p u ɫ a n t k a
наменет	n a m e n e t
рашмркан	r a ʃ m r̩ k a n
одоброволен	ɔ d ɔ b r ɔ v ɔ l e n
вомјази	v ɔ m j a z i
спермицид	s p e r m i t͡s i t
непамтење	n e p a m t e ɲ e
малаја	m a ɫ a j a
неизгладен	n e i z ɡ ɫ a d e n
освоена	ɔ s v ɔ e n a
дендрохронологија	d e n d r ɔ x r ɔ n ɔ ɫ ɔ ɡ i j a
лајка	ɫ a j k a
грешници	ɡ r e ʃ n i t͡s i
сеприсутен	s e p r i s u t e n
предодредување	p r e d ɔ d r e d u v a ɲ e
расфрла	r a s f r̩ ɫ a
несоблечен	n e s ɔ b l e t͡ʃ e n
лаен	ɫ a e n
англофил	a ŋ ɡ ɫ ɔ f i ɫ
комар	k ɔ m a r
антагонизам	a n t a ɡ ɔ n i z a m
збесне	z b e s n e
ѓубреџиски	ɟ u b r e d͡ʒ i s k i
лекторира	l e k t ɔ r i ɾ a
некриминализирање	n e k r i m i n a l i z i ɾ a ɲ e
ископување	i s k ɔ p u v a ɲ e
увозлив	u v ɔ z l i f
олабавен	ɔ ɫ a b a v e n
дилиски	d i l i s k i
косо	k ɔ s ɔ
генерално	ɡ e n e r a ɫ n ɔ
мизерен	m i z e ɾ e n
сфаќа	s f a c a
киселински	k i s e l i n s k i
хибискус	x i b i s k u s
прелетан	p r e l e t a n
преколнува	p r e k ɔ ɫ n u v a
бесцелен	b e s t͡s e l e n
палома	p a ɫ ɔ m a
повратен	p ɔ v r a t e n
терористка	t e ɾ ɔ r i s t k a
недохранетост	n e d ɔ x r a n e t ɔ s t
облекуван	ɔ b l e k u v a n
бодовен	b ɔ d ɔ v e n
синоќа	s i n ɔ c a
сталинистички	s t a l i n i s t i t͡ʃ k i
леринчани	l e r i n t͡ʃ a n i
облее	ɔ b l e e
предрасположуван	p r e d r a s p ɔ ɫ ɔ ʒ u v a n
допроверува	d ɔ p r ɔ v e ɾ u v a
давател	d a v a t e ɫ
заклопи	z a k ɫ ɔ p i
мрестилиште	m r e s t i l i ʃ t e
стапување	s t a p u v a ɲ e
управувачи	u p r a v u v a t͡ʃ i
небудење	n e b u d e ɲ e
ционистички	t͡s i j ɔ n i s t i t͡ʃ k i
издробен	i z d r ɔ b e n
појадување	p ɔ j a d u v a ɲ e
непридржување	n e p r i d r̩ ʒ u v a ɲ e
слепо	s l e p ɔ
националноослободителен	n a t͡s i j ɔ n a ɫ n ɔ ɔ s ɫ ɔ b ɔ d i t e l e n
засрамен	z a s r a m e n
ласици	ɫ a s i t͡s i
гибелен	ɡ i b e l e n
исчашен	i ʃ t͡ʃ a ʃ e n
птици	p t i t͡s i
незаокружен	n e z a ɔ k r u ʒ e n
миксер	m i k s e r
изнесуван	i z n e s u v a n
кариран	k a r i ɾ a n
неосуетен	n e ɔ s u e t e n
семиологија	s e m i j ɔ ɫ ɔ ɡ i j a
небендисување	n e b e n d i s u v a ɲ e
пожарникар	p ɔ ʒ a r n i k a r
отсекогаш	ɔ t s e k ɔ ɡ a ʃ
командување	k ɔ m a n d u v a ɲ e
кореспонденција	k ɔ ɾ e s p ɔ n d e n t͡s i j a
нашлакан	n a ʃ ɫ a k a n
шури	ʃ u ɾ i
сив	s i f
касне	k a s n e
неповратен	n e p ɔ v r a t e n
дегустаторски	d e ɡ u s t a t ɔ r s k i
рецептор	r e t͡s e p t ɔ r
изгине	i z ɡ i n e
негаснење	n e ɡ a s n e ɲ e
глаголивост	ɡ ɫ a ɡ ɔ l i v ɔ s t
страчкин	s t r a t͡ʃ k i n
анка	a ŋ k a
бавнорастечки	b a v n ɔ r a s t e t͡ʃ k i
неопременост	n e ɔ p r e m e n ɔ s t
разбранува	r a z b r a n u v a
интерактивност	i n t e r a k t i v n ɔ s t
експресионист	e k s p r e s i j ɔ n i s t
гасеничар	ɡ a s e n i t͡ʃ a r
замав	z a m a f
изнадаван	i z n a d a v a n
атински	a t i n s k i
рушевина	r u ʃ e v i n a
шпиун	ʃ p i j u n
вглобување	v ɡ ɫ ɔ b u v a ɲ e
рождество	r ɔ ʒ d e s t v ɔ
латентен	ɫ a t e n t e n
навечер	n a v e t͡ʃ e r
одраз	ɔ d r a s
геодезија	ɡ e ɔ d e z i j a
момичиња	m ɔ m i t͡ʃ i ɲ a
лоби	ɫ ɔ b i
кошаркар	k ɔ ʃ a r k a r
гусарство	ɡ u s a r s t v ɔ
генитивен	ɡ e n i t i v e n
опишува	ɔ p i ʃ u v a
бонтон	b ɔ n t ɔ n
французин	f r a n t͡s u z i n
иван	i v a n
неубеден	n e u b e d e n
давен	d a v e n
земјотрес	z e m j ɔ t r e s
впери	f p e ɾ i
повтарање	p ɔ f t a ɾ a ɲ e
наслика	n a s l i k a
радување	r a d u v a ɲ e
подотрезнет	p ɔ d ɔ t r e z n e t
окупира	ɔ k u p i ɾ a
анкарец	a ŋ k a ɾ e t͡s
штурмовик	ʃ t u r m ɔ v i k
демонтажа	d e m ɔ n t a ʒ a
мртвопроверител	m r̩ t v ɔ p r ɔ v e ɾ i t e ɫ
тиранизира	t i ɾ a n i z i ɾ a
вероисповеди	v e ɾ ɔ i s p ɔ v e d i
сонцобран	s ɔ n t͡s ɔ b r a n
подложен	p ɔ d ɫ ɔ ʒ e n
потир	p ɔ t i r
гулаш	ɡ u ɫ a ʃ
забушува	z a b u ʃ u v a
надразнетост	n a d r a z n e t ɔ s t
смока	s m ɔ k a
жнеење	ʒ n e e ɲ e
непопустливост	n e p ɔ p u s t l i v ɔ s t
пушач	p u ʃ a t͡ʃ
пренесува	p r e n e s u v a
дождовници	d ɔ ʒ d ɔ v n i t͡s i
морнар	m ɔ r n a r
коскен	k ɔ s k e n
видин	v i d i n
топови	t ɔ p ɔ v i
преграден	p r e ɡ r a d e n
искорне	i s k ɔ r n e
веѓа	v e ɟ a
неред	n e ɾ e t
киевјанец	k i e v j a n e t͡s
меанџика	m e a n d͡ʒ i k a
злотворен	z ɫ ɔ t v ɔ ɾ e n
сјај	s j a j
имиграција	i m i ɡ r a t͡s i j a
прпелкање	p r̩ p e ɫ k a ɲ e
носорози	n ɔ s ɔ ɾ ɔ z i
внедрувајќи	v n e d r u v a j c i
избавен	i z b a v e n
лулан	ɫ u ɫ a n
квинтесенција	k v i n t e s e n t͡s i j a
чачкање	t͡ʃ a t͡ʃ k a ɲ e
шашлив	ʃ a ʃ l i f
диган	d i ɡ a n
маврициус	m a v r i t͡s i j u s
шилец	ʃ i l e t͡s
домарски	d ɔ m a r s k i
ф’стак	f a s t a k
дињи	d i ɲ i
сожителка	s ɔ ʒ i t e ɫ k a
дошепнуван	d ɔ ʃ e p n u v a n
кодоши	k ɔ d ɔ ʃ i
течнокристален	t e t͡ʃ n ɔ k r i s t a l e n
девери	d e v e ɾ i
лимонче	l i m ɔ n t͡ʃ e
континенти	k ɔ n t i n e n t i
станче	s t a n t͡ʃ e
превид	p r e v i t
пребира	p r e b i ɾ a
биен	b i j e n
ледникав	l e d n i k a f
вруќина	v r u c i n a
неоколонијалистички	n e ɔ k ɔ ɫ ɔ n i j a l i s t i t͡ʃ k i
мачно	m a t͡ʃ n ɔ
прегрнат	p r e ɡ r̩ n a t
бакардисувајќи	b a k a r d i s u v a j c i
багра	b a ɡ r a
сметачки	s m e t a t͡ʃ k i
сонародник	s ɔ n a ɾ ɔ d n i k
истумба	i s t u m b a
источкан	i s t ɔ t͡ʃ k a n
менувачница	m e n u v a t͡ʃ n i t͡s a
литератури	l i t e ɾ a t u ɾ i
посмртница	p ɔ s m r̩ t n i t͡s a
њујорк	ɲ u j ɔ r k
аматерче	a m a t e r t͡ʃ e
венецуелка	v e n e t͡s u e ɫ k a
ротор	r ɔ t ɔ r
океан	ɔ k e a n
демантиран	d e m a n t i ɾ a n
преформулира	p r e f ɔ r m u l i ɾ a
пронаоѓање	p r ɔ n a ɔ ɟ a ɲ e
изнуден	i z n u d e n
мангупиште	m a ŋ ɡ u p i ʃ t e
поткажан	p ɔ t k a ʒ a n
србинка	s r̩ b i ŋ k a
неудавен	n e u d a v e n
ѕвечкаво	d͡z v e t͡ʃ k a v ɔ
меше	m e ʃ e
хартивче	x a r t i f t͡ʃ e
непокорност	n e p ɔ k ɔ r n ɔ s t
отплеткување	ɔ t p l e t k u v a ɲ e
неискастрен	n e i s k a s t r e n
давеник	d a v e n i k
трогателно	t r ɔ ɡ a t e ɫ n ɔ
пребричуван	p r e b r i t͡ʃ u v a n
лем	l e m
одбутнува	ɔ d b u t n u v a
правилник	p r a v i ɫ n i k
нелегализирање	n e l e ɡ a l i z i ɾ a ɲ e
пишман	p i ʃ m a n
симона	s i m ɔ n a
апсолутен	a p s ɔ ɫ u t e n
изваден	i z v a d e n
насечен	n a s e t͡ʃ e n
расплеска	r a s p l e s k a
развратен	r a z v r a t e n
шасија	ʃ a s i j a
клими	k l i m i
ископан	i s k ɔ p a n
паганки	p a ɡ a ŋ k i
суштественост	s u ʃ t e s t v e n ɔ s t
закрилник	z a k r i ɫ n i k
сеница	s e n i t͡s a
меритократски	m e ɾ i t ɔ k r a t s k i
подробност	p ɔ d r ɔ b n ɔ s t
итрец	i t r e t͡s
цртежи	t͡s r̩ t e ʒ i
италијанец	i t a l i j a n e t͡s
кас	k a s
битка	b i t k a
фразеологија	f r a z e ɔ ɫ ɔ ɡ i j a
расчепка	r a ʃ t͡ʃ e p k a
пожарни	p ɔ ʒ a r n i
причува	p r i t͡ʃ u v a
ќуркин	c u r k i n
вртипоп	v r̩ t i p ɔ p
катиљ	k a t i ʎ
проверува	p r ɔ v e ɾ u v a
камионче	k a m i ɔ n t͡ʃ e
досушува	d ɔ s u ʃ u v a
разнебитен	r a z n e b i t i
обожавателски	ɔ b ɔ ʒ a v a t e ɫ s k i
пустец	p u s t e t͡s
дволичност	d v ɔ l i t͡ʃ n ɔ s t
анонимизира	a n ɔ n i m i z i ɾ a
хиндуист	x i n d u i s t
тироиден	t i ɾ ɔ i d e n
плико	p l i k ɔ
синџирче	s i n d͡ʒ i r t͡ʃ e
предучилиштен	p r e d u t͡ʃ i l i ʃ t e n
љубење	ʎ u b e ɲ e
испремести	i s p r e m e s t i
ерген	e r ɡ e n
плик	p l i k
неисечен	n e i s e t͡ʃ e n
мешанци	m e ʃ a n t͡s i
изнуди	i z n u d i
оклопник	ɔ k ɫ ɔ p n i k
бароници	b a r ɔ n i t͡s i
дочистување	d ɔ t͡ʃ i s t u v a ɲ e
покачува	p ɔ k a t͡ʃ u v a
вистинит	v i s t i n i t
јаворишта	j a v ɔ ɾ i ʃ t a
уназаден	u n a z a d e n
колосален	k ɔ ɫ ɔ s a l e n
легенда	l e ɡ e n d a
стефан	s t e f a n
неизделување	n e i z d e ɫ u v a ɲ e
игроорка	i ɡ r ɔ ɔ r k a
гадурија	ɡ a d u ɾ i j a
партизанче	p a r t i z a n t͡ʃ e
ха	x a
корка	k ɔ r k a
лавини	ɫ a v i n i
аври	a v r i
клоца	k ɫ ɔ t͡s a
прерипан	p r e ɾ i p a n
фиде	f i d e
несебично	n e s e b i t͡ʃ n ɔ
купен	k u p e n
царистка	t͡s a r i s t k a
негушанки	n e ɡ u ʃ a ŋ k i
затвора	z a t v ɔ ɾ a
вообичајување	v ɔ ɔ b i t͡ʃ a j u v a ɲ e
печатиште	p e t͡ʃ a t i ʃ t e
пресостави	p r e s ɔ s t a v i
плускав	p ɫ u s k a f
замолкнува	z a m ɔ ɫ k n u v a
мразулче	m r a z u ɫ t͡ʃ e
разљуби	r a z ʎ u b i
заматување	z a m a t u v a ɲ e
придружуван	p r i d r u ʒ u v a n
сакраментален	s a k r a m e n t a l e n
рекетиран	r e k e t i ɾ a n
кинезинче	k i n e z i n t͡ʃ e
промеша	p r ɔ m e ʃ a
калуѓерки	k a ɫ u ɟ e r k i
пореметуван	p ɔ ɾ e m e t u v a n
пролетер	p r ɔ l e t e r
дозатвори	d ɔ z a t v ɔ ɾ i
кога	k ɔ ɡ a
доткае	d ɔ t k a e
човекоубиство	t͡ʃ ɔ v e k ɔ u b i s t v ɔ
притајува	p r i t a j u v a
прередување	p r e ɾ e d u v a ɲ e
исполни	i s p ɔ ɫ n i
квалификација	k v a l i f i k a t͡s i j a
незалепен	n e z a l e p e n
скротуван	s k r ɔ t u v a n
цер	t͡s e r
педерство	p e d e r s t v ɔ
класика	k ɫ a s i k a
заѕидува	z a d͡z i d u v a
покраински	p ɔ k r a i n s k i
неофашизам	n e ɔ f a ʃ i z a m
бадмингтон	b a d m i ŋ k t ɔ n
науки	n a u k i
репариран	r e p a r i ɾ a n
срциња	s r̩ t͡s i ɲ a
соучесништво	s ɔ u t͡ʃ e s n i ʃ t v ɔ
зашеметеност	z a ʃ e m e t e n ɔ s t
режимиште	r e ʒ i m i ʃ t e
превземе	p r e v z e m e
непрепречен	n e p r e p r e t͡ʃ e n
бушав	b u ʃ a f
успаниченост	u s p a n i t͡ʃ e n ɔ s t
несмасен	n e s m a s e n
мандарински	m a n d a r i n s k i
отрезнуван	ɔ t r e z n u v a n
конзистентен	k ɔ n z i s t e n t e n
скијач	s k i j a t͡ʃ
изумира	i z u m i ɾ a
шеј	ʃ e j
нераководен	n e ɾ a k ɔ v ɔ d e n
пропушта	p r ɔ p u ʃ t a
автоматизација	a f t ɔ m a t i z a t͡s i j a
павка	p a f k a
предвесница	p r e d v e s n i t͡s a
своеглавост	s v ɔ e ɡ ɫ a v ɔ s t
наковална	n a k ɔ v a ɫ n a
разбистрување	r a z b i s t r u v a ɲ e
етикети	e t i k e t i
електризира	e l e k t r i z i ɾ a
свикува	s v i k u v a
конфигурира	k ɔ ɱ f i ɡ u r i ɾ a
незачувување	n e z a t͡ʃ u v u v a ɲ e
черупа	t͡ʃ e r u p a
пречкртување	p r e t͡ʃ k r̩ t u v a ɲ e
сом	s ɔ m
штеден	ʃ t e d e n
одвиткан	ɔ d v i t k a n
доминикански	d ɔ m i n i k a n s k i
триумфално	t r i j u ɱ f a ɫ n ɔ
кавадарчанка	k a v a d a r t͡ʃ a ŋ k a
манијачен	m a n i j a t͡ʃ e n
скројување	s k r ɔ j u v a ɲ e
пивнува	p i v n u v a
куќичка	k u c i t͡ʃ k a
хакирање	x a k i ɾ a ɲ e
забен	z a b e n
марјана	m a r j a n a
продавница	p r ɔ d a v n i t͡s a
импонирање	i m p ɔ n i ɾ a ɲ e
просторно	p r ɔ s t ɔ r n ɔ
карамани	k a r a m a n i
недовршен	n e d ɔ v r̩ ʃ e n
килимарски	k i l i m a r s k i
преживан	p r e ʒ i v a n
баталува	b a t a ɫ u v a
полумесец	p ɔ ɫ u m e s e t͡s
ветрулиња	v e t r u l i ɲ a
испипан	i s p i p a n
урне	u r n e
трепери	t r e p e ɾ i
земјотресение	z e m j ɔ t r e s e n i j e
гламниче	ɡ ɫ a m n i t͡ʃ e
фактурира	f a k t u r i ɾ a
изебе	i z e b e
стрес	s t r e s
препраќање	p r e p r a c a ɲ e
писмоносец	p i s m ɔ n ɔ s e t͡s
контрабасист	k ɔ n t r a b a s i s t
потпора	p ɔ t p ɔ ɾ a
столица	s t ɔ l i t͡s a
соја	s ɔ j a
сендвичиште	s e n d v i t͡ʃ i ʃ t e
зацрцори	z a t͡s r̩ t͡s ɔ ɾ i
облекува	ɔ b l e k u v a
раселување	r a s e ɫ u v a ɲ e
матурирање	m a t u r i ɾ a ɲ e
зевс	z e f s
прежален	p r e ʒ a l e n
мариовски	m a r i j ɔ f s k i
џавкајќи	d͡ʒ a f k a j c i
неконтролиран	n e k ɔ n t r ɔ l i ɾ a n
боциче	b ɔ t͡s i t͡ʃ e
кавалер	k a v a l e r
ибриче	i b r i t͡ʃ e
бармен	b a r m e n
дотресен	d ɔ t r e s e n
писател	p i s a t e ɫ
режира	r e ʒ i ɾ a
фунта	f u n t a
злодела	z ɫ ɔ d e ɫ a
обезвластување	ɔ b e z v ɫ a s t u v a ɲ e
нефенирање	n e f e n i ɾ a ɲ e
кигалиски	k i ɡ a l i s k i
скалило	s k a l i ɫ ɔ
ќесиња	c e s i ɲ a
здружено	z d r u ʒ e n ɔ
пороби	p ɔ ɾ ɔ b i
небегање	n e b e ɡ a ɲ e
фамилииште	f a m i l i i ʃ t e
подбивно	p ɔ d b i v n ɔ
експлицитно	e k s p l i t͡s i t n ɔ
калкулира	k a ɫ k u l i ɾ a
казнен	k a z n e n
магионичарка	m a ɡ i j ɔ n i t͡ʃ a r k a
растоваруван	r a s t ɔ v a ɾ u v a n
напакостува	n a p a k ɔ s t u v a
доучува	d ɔ u t͡ʃ u v a
транзитен	t r a n z i t e n
теолог	t e ɔ ɫ ɔ k
полјоделство	p ɔ ʎ ɔ d e ɫ s t v ɔ
појача	p ɔ j a t͡ʃ a
портирски	p ɔ r t i r s k i
кремови	k r e m ɔ v i
хонијарски	x ɔ n i j a r s k i
натнува	n a t n u v a
опуси	ɔ p u s i
непрекинлив	n e p r e k i n l i f
термостат	t e r m ɔ s t a t
хараре	x a r a ɾ e
натпатници	n a t p a t n i t͡s i
стипендија	s t i p e n d i j a
разгален	r a z ɡ a l e n
ветерница	v e t e r n i t͡s a
буцкајќи	b u t͡s k a j c i
масеруански	m a s e r u a n s k i
експеримент	e k s p e ɾ i m e n t
престига	p r e s t i ɡ a
комитски	k ɔ m i t s k i
јонизиран	j ɔ n i z i ɾ a n
бладајќи	b ɫ a d a j c i
ратови	r a t ɔ v i
контрола	k ɔ n t r ɔ ɫ a
мутациски	m u t a t͡s i s k i
промашува	p r ɔ m a ʃ u v a
отстои	ɔ t s t ɔ i
бекнува	b e k n u v a
затреба	z a t r e b a
шуми	ʃ u m i
густо	ɡ u s t ɔ
цепен	t͡s e p e n
основ	ɔ s n ɔ f
дрвце	d r̩ f t͡s e
мотан	m ɔ t a n
скокотнат	s k ɔ k ɔ t n a t
прилагодливо	p r i ɫ a ɡ ɔ d l i v ɔ
