خیال	x a j ɑː l
رابط	ɾ ɑː b i t
اجتماعی	e d͡ʒ t e m ɑː ʔ iː
تقوا	t a ɢ v ɑː
کم	k a m
منازل	m a n ɑː z i l
کنفرانس	k o n f e ɾ ɑː n s
حرب	h a ɾ b
ختنه	x a t n e
روز	ɾ oː z
ژولیدن	ʒ uː l iː d a n
کثیف	k a s i f
مند	m a n d
باغبان	b ɑː ɢ b ɑː n
بازرگان	b ɑː z a ɾ ɡ ɑː n
ثروتمند	s a ɾ v a t m a n d
پروسه	p e ɾ o s e
بی‌معنی	b e m a ʔ n iː
ننه	n a n e
ذره	z a r r a
آسیا	ɑː s i j ɑː
مخمل	m a x m a l
ایمان	i m ɑː n
تفسیدن	t a f s i d a n
ققنوس	ɢ u ɢ n u s
پنجه	p a n d͡ʒ a
شاید	ʃ ɑː j a d
ژرف‌تر	ʒ a ɾ f t a ɾ
گو	ɡ o v
آینده	ɑː j a n d a
ناشنوا	n ɑː ʃ i n a v ɑː
روحانی	r o o h ɑː n iː
دروغ‌ها	d o ɾ uː ɢ h ɑː
گنجور	ɡ a n d͡ʒ u ɾ
لجن	l a d͡ʒ a n
کوهستان	k oː h i s t ɑː n
وجود	v o d͡ʒ uː d
گذاشتن	ɡ o z ɑː ʃ t a n
رازی	ɾ ɑː z iː
یاساء	j ɑː s ɑː ʔ
سرپوش	s a ɾ p oː ʃ
ختم	x a t m
شاهین	ʃ ɑː h iː n
زورق	z o v ɾ a ɢ
بوسه	b oː s a
مثل	m a s a l
آدرس	ɑː d ɾ e s
مارمولک	m ɑː ɾ m uː l a k
شیدا	ʃ e j d ɑː
معدنی	m a ʔ d a n iː
قابل	ɢ ɑː b i l
نمودن	n a m u d a n
جوره	d͡ʒ oː ɾ a
طوفان	t u f ɑː n
گشودن	ɡ o ʃ uː d a n
کلید	k a l i d
یزد	j a z d
گنم	ɡ e n o m
لقب	l a ɢ a b
وکیل	v a k i l
غمگینی	ɢ a m ɡ iː n iː
پرشور	p o ɾ ʃ uː ɾ
صنم	s a n a m
جوانی	d͡ʒ a v ɑː n iː
محمد	m o h a m m a d
ژرفا	ʒ a ɾ f ɑː
گواه	ɡ o v ɑː h
مقدماتی	m o ɢ a d d a m ɑː t iː
پیروزی	p e ɾ s z iː
وفات	v a f ɑː t
نوک	n v a k
کرامت	k a ɾ ɑː m a t
کالیفرنیا	k ɑː l iː f o r n i j ɑː
گونه	ɡ oː n a
ساده‌تر	s ɑː d e t a ɾ
تسخیر	t a s x i ɾ
دهیار	d e h j ɑː ɾ
لک	l a k
کوچک‌تر	k uː t ʃ e k t a ɾ
پا	p ɑː
گائیدن	ɡ ɑː j iː d a n
شوکران	ʃ a v k a ɾ ɑː n
بام	b ɑː m
منع	m a n ʔ
بانو	b ɑː n uː
پس	p a s
گستردن	ɡ o s t a ɾ d a n
مومیایی	m oː m i j ɑː j iː
غریب	ɢ a ɾ iː b
پور	p u ɾ
خواهش	x ɑː h e ʃ
خزان	x a z ɑː n
حافظ	h ɑː f e z
تک	t a k
حج	h a d d͡ʒ
مفتی	m o f t iː
بزرگ‌امید	b o z o ɾ ɡ ʔ o m iː d
ژوژ	ʒ oː ʒ
ایرانیان	iː ɾ ɑː n i j ɑː n
گا	ɡ ɑː
برنز	b o ɾ o n z
مالی	m ɑː l iː
بز	b o z
زیر	z e ɾ
مهارت	m a h ɑː ɾ a t
تو	t o
خشم	x i ʃ m
سوداگر	s a v d ɑː ɡ a ɾ
گذراندن	ɡ o z a ɾ ɑː n d a n
خشونت	x o ʃ uː n a t
کو	k oː
سوسمار	s uː s m ɑː r
یشم	j a ʃ m
عصبانی	a s a b ɑː n iː
بعد	b a ʔ d
منتقد	m o n t a ɢ e d
کمزور	k a m z oː ɾ
انگاشتن	a n ɡ ɑː ʃ t a n
باهوش	b ɑː h uː ʃ
قصد	ɢ a s d
منتظر	m o n t a z e ɾ
خبری	x a b a ɾ j a
چهارده	t͡ʃ a h ɑː ɾ d a h
مشرک	m o ʃ ɾ e k
گزاف	ɡ a z ɑː f
فارغ	f ɑː ɾ i ɢ
دلگیر	d e l ɡ iː ɾ
اتفاق	e t t e f ɑː ɢ
لوبیا	l oː b i i ɑː
تودری	t u d a ɾ iː
ام	e m
آلاله	ɑː l ɑː l a
راجستان	ɾ ɑː d͡ʒ a s t a n
بیان	b a j ɑː n
خرگوش	x a ɾ ɡ oː ʃ
نارسنگ	n ɑː ɾ s a n ɡ
تهران	t a h ɾ ɑː n
می‌گم	m iː ɡ a m
نیرو	n e ɾ s
اکثر	a k s a ɾ
مازوج	m ɑː z uː d͡ʒ
نشور	n o ʃ uː ɾ
زنجبیل	z a n d͡ʒ a b iː l
داد	d ɑː d
سمند	s a m a n d
میرزاخانی	m i ɾ z ɑː x ɑː n iː
انجامیدن	a n d͡ʒ ɑː m iː d a n
خربزه	x a ɾ b u z a
رب	ɾ a b
گیتا	ɡ iː t ɑː
چهارشنبه	t͡ʃ a h ɑː ɾ ʃ a n b a
قلبی	ɢ a l b iː
هامون	h ɑː m uː n
یونانی	j u n ɑː n iː
قرن	ɢ a ɾ n
آستانه‌ای	ɑː s t ɑː n a iː
بزرگ	b o z o ɾ ɡ
صورتی	s uː ɾ a t iː
خوشه	x oː ʃ a
دس	d a s
مردم‌شناس	m a ɾ d u m ʃ i n ɑː s
نهر	n a h ɾ
افسر	a f s a ɾ
نظر	n a z a ɾ
دیگر	d i ɡ a ɾ
شترگاوپلنگ	ʃ o t o ɾ ɡ ɑː v p a l a n ɡ
دریدن	d a ɾ i d a n
می‌دوم	m i d a v a m
شخصیت	ʃ a x s i j a t
تصویر	t a s v i ɾ
غره	ɢ a ɾ ɾ e
مرغ	m o ɾ ɢ
ییلاق	j a j l ɑː ɢ
سرمایه	s a ɾ m ɑː j a
شرک	ʃ e ɾ e k
فراموش	f a ɾ ɑː m oː ʃ
ورد	v a ɾ d
نانوائی	n ɑː n v ɑː j e
خواهر	x ɑː h a ɾ
گی	a ɡ iː
جامعه‌شناسی	d͡ʒ ɑː m i ʔ a ʃ i n ɑː s iː
خبره	x e b ɾ e
طور	t a v ɾ
خدشه	x a d ʃ a
رهبر	ɾ a h b a ɾ
اندیشیدن	a n d e ʃ i d a n
رخ	r o x
تاجور	t ɑː d ʒ v a ɾ
چل	t ʃ e l
گوش	ɡ oː ʃ
انگبین	a n ɡ a b i n
چنبره	t͡ʃ a m b a ɾ a
میدان	m a j d ɑː n
سرحد	s a ɾ h a d
جبار	d ʒ a b ɑː ɾ
هند	h e n d
اسلیمی	e s l iː m iː
دور	d a v ɾ
نیروگاه	n i ɾ u ɡ ɑː h
قرمزی	ɢ i ɾ m i z iː
قاتل	ɢ ɑː t i l
جستجو	d͡ʒ o s t o d͡ʒ uː j
دستمال	d a s t m ɑː l
گون	ɡ oː n
قدومه	ɢ u d u m a
مفعول	m a f ʔ u l
کسی	k a s e
پناهنده	p a n ɑː h a n d e
لعل	l a ʔ l
نعناع	n a ʔ n ɑː ʔ
غاز	ɢ ɑː z
تکیدن	t a k i d a n
بهمن	b a h m a n
بغداد	b a ɢ d ɑː d
نمایان	n e m ɑː j ɑː n
ائتلاف	e ʔ t e l ɑː f
سقوط	s o ɢ uː t
پیادگان	p iː j ɑː d e ɡ ɑː n
شکافتن	ʃ e k ɑː f t a n
مترجم	m o t a ɾ d͡ʒ e m
سعید	s a ʔ i d
محسن	m o h s e n
کونی	k u n iː
اسکدار	a s k u d ɑː ɾ
بدن	b a d a n
خوردن	x o ɾ d a n
فشار	f e ʃ ɑː ɾ
خندان	x a n d ɑ n
شماره	ʃ o m ɑː ɾ e
گناه	ɡ o n ɑː h
ببر	b a b ɾ
بی‌هوش	b e h s ʃ
ناپاز	n ɑː p ɑː z
ویژگی‌ها	v iː ʒ e ɡ iː h ɑː
آبدست	ɑː b d a s t
خراسان	x o ɾ ɑː s ɑː n
هشتن	h e ʃ t a n
ادبیات	a d a b i j ɑː t
ماوراءالنهر	m ɑː v a ɾ ɑː ʔ u n n a h ɾ
شیطانی	ʃ a j t ɑː n iː
البرز	ʔ a l b o ɾ z
ممنون	m a m n u n
قطع	ɢ a t ʔ
سهم	s a h m
ژکفر	ʒ a k f a ɾ
بیدار	b e d ɑː ɾ
سیلو	s i l u
نقشه	n a ɢ ʃ a
آوا	ɑː v ɑː
اصطبل	e s t a b l
گجرات	ɡ o d͡ʒ a ɾ ɑː t
مربا	m o r a b b ɑ
چکش	t͡ʃ a k u ʃ
حساب	h e s ɑː b
شوریدن	ʃ oː ɾ iː d a n
هوتن	h uː t a n
شجر	ʃ a d ʒ a r
گربه	ɡ o ɾ b e
تقویت	t a ɢ v i j a t
سیاه‌گوش	s i j ɑː h ɡ oː ʃ
اسپهسالار	ʔ e s p a h s ɑː l ɑː ɾ
سوخ	s oː x
آلایش	ɑː l ɑː j i ʃ
آژیر	ɑː ʔ ʒ iː ɾ
سرب	s o ɾ b
شورا	ʃ o o ɾ ɑː
شال	ʃ ɑː l
تهیه	t a h i j j a
مملکت	m a m l a k a t
واژه	v ɑː ʒ e
اصلاح	e s l ɑː h
گیک	ɡ iː k
ساز	s ɑː z
ادغام	e d ɢ ɑː m
ژیرش	ʒ i ɾ i ʃ
تمیز	t a m i z
سپر	s e p a ɾ
کوشک	k oː ʃ k
کوچک‌ترین	k uː t ʃ e k t a ɾ iː n
کلنگ	k o l o n ɡ
کلاس	k e l ɑː s
صفت	s e f a t
کشتی‌گیر	k o ʃ t iː ɡ iː ɾ
شهادت	ʃ a h ɑː d a t
روشنگری	ɾ a v ʃ a n ɡ a ɾ iː
خشک	x o ʃ k
وصل	v a s l
سبد	s a b a d
آویختن	ɑː v e x t a n
لیوان	l iː v ɑː n
چرخ	t͡ʃ a ɾ x
پوشیدن	p oː ʃ iː d a n
سخنگو	s o x a n ɡ uː
فرستادن	f e ɾ e s t ɑː d a n
کارواژگان	k ɑː r v ɑː ʒ e ɡ ɑː n
سر	s a ɾ
رباعی	ɾ o b ɑː ʔ iː
بامداد	b ɑː m d ɑː n
خیلی	x a j l e
تاجیکستان	t ɑː d͡ʒ iː k i s t ɑː n
وارث	v ɑː ɾ e s
بادبانی	b ɑː d b ɑː n iː
تلف	t a l a f
آرایش	ɑː ɾ ɑː j i ʃ
گرفتن	ɡ e ɾ e f t a n
حلقه	h a l ɢ a
چهل	t͡ʃ e h e l
خراسانی	x o ɾ ɑː s ɑː n iː
کتاب	k e t ɑː b
گاومیش	ɡ ɑː v m e ʃ
گوسفند	ɡ oː s f a n d
داخل	d ɑː x i l i
پانزده	p uː n z d a h
شکست	ʃ e k a s t
شمال	ʃ o m ɑː l
قرآن	ɢ u ɾ ʔ ɑː n
خودرو	x o d ɾ o v
گرمابه	ɡ a ɾ m ɑː b a
ته	t a h
هرات	h a ɾ ɑː t
بخور	b o x uː ɾ
درباره	d a ɾ b ɑː ɾ a j i
پناهگاه	p a n ɑː h ɡ ɑː h
کیهانی	k a j h ɑː n iː
شهد	ʃ a h d
لاف	l ɑː f
سفید	s a f e d
نمکدان	n a m a k d ɑː n
باقلوا	b ɑː ɢ l a v ɑː
گهواره	ɡ a h v ɑː ɾ a
بوزه	b oː z a
آشفته	ɑː ʃ u f t a
هرچه	h a ɾ t͡ʃ i
اوگاندا	u ɡ ɑː n d ɑː
مقاومت	m o ɢ ɑː v e m a t
اجاق	o d͡ʒ ɑː ɢ
سیل	s a j l
دودمان	d u d m ɑː n
درها	d a ɾ h ɑː
نیوشا	n i j oː ʃ ɑː
سنبل	s o m b o l
ارض	a ɾ z
اردیبهشت	o ɾ d iː b e h e ʃ t
سپندان	s e p a n d ɑː n
چایدان	t͡ʃ ɑː j d ɑː n
دگرجنس‌گرا	d e ɡ a ɾ d͡ʒ e n s ɡ a ɾ ɑː
غالب	ɢ ɑː l e b
بازنشستگی	b ɑː z n i ʃ a s t a ɡ iː
اردو	o ɾ d uː
هیس	s
باران	b ɑː ɾ ɑː n
فسیل	f o s iː l
طرح	t a ɾ h
پوزخند	p uː z x a n d
خوف	x a v f
ابلیس	e b l iː s
رتیل	ɾ o t e j l
ژرف‌ترین	ʒ a ɾ f t a ɾ iː n
آسمان	ɑː s i m ɑː n
تخریب	t a x ɾ i b
هرکس	h a r k a s
گزینش	ɡ o z iː n e ʃ
امامقلی	e m ɑː m ɢ o l iː
شرط	ʃ a ɾ t
اشترغار	o ʃ t o ɾ ɢ ɑː ɾ
اجازه	e d͡ʒ ɑː z e
مطلب	m a t l a b
افطار	e f t ɑː ɾ
چکیدن	t͡ʃ a k i d a n
شاهدخت	ʃ ɑː h d u x t
خباز	x a b b ɑː z
بازدید	b ɑː z d iː d
آذربایجان	ɑː z a ɾ b ɑː j d͡ʒ ɑː n
گسستن	ɡ o s a s t a n
توپچى	t oː p t͡ʃ iː
روزها	ɾ oː z h ɑː
زرناپا	z u r n ɑː p ɑː
دانشکده	d ɑː n i ʃ k a d a
ارتعاش	e ɾ t e ʔ ɑː ʃ
نفرین	n e f ɾ iː n
اشتر	ʔ o ʃ t o ɾ
بی‌سواد	b e s a v ɑː d
سورپریز	s u r p i ɾ i z
چه	t͡ʃ a
جزیره	d͡ʒ a z i ɾ a
خزینه	x a z i n a
دنیدن	d a n iː d a n
خر	x a ɾ
فهمیدن	f a h m i d a n
آرد	ɑː ɾ d
مختار	m o x t ɑː ɾ
جستن	d͡ʒ a s t a n
فصل	f a s l
زمی	z m iː
شمردن	ʃ e m o ɾ d a n
ران	ɾ ɑː n
هرمز	h o ɾ m o z
آهسته	ɑː h i s t a
چرخیدن	t ʃ e ɾ x i d a n
میلاد	m e l ɑː d
خزاعی	x a z ɑː ʔ iː
شدن	ʃ o d a n
ناهید	n ɑː h iː d
آب	ɑː b
خال	x ɑː l
برداشتن	b a ɾ d ɑː ʃ t a n
قطره	ɢ a t ɾ a
میز	m e z
تقسیم	t a ɢ s i m
اعنی	a ʔ n iː
دما	d a m ɑː
صهیونیسم	s a h j u n i s m
کافر	k ɑː f e r
سیمرغ	s i m u ɾ ɢ
گرا	ɡ a ɾ ɑː
درنده	d a ɾ a n d a
یاسا	j ɑː s ɑː
کجا	k o d͡ʒ ɑː
سخن	s o x a n
پشیمان	p a ʃ iː m ɑː n
فلاخن	f a l ɑː x a n
پالایش	p ɑː l ɑː j i ʃ
گوجه	ɡ a v d͡ʒ a
هواپیما	h a v ɑː p a j m ɑː
بابک	b ɑː b a k
لاغر	l ɑː ɢ a ɾ
قطر	ɢ a t a ɾ
آباد	ɑː b ɑː d
ضعف	z a ʔ f
دیسک	d iː s k
شخص	ʃ a x s
چوب	t͡ʃ oː b
دنیا	d o n j ɑː
اسفناج	e s f e n ɑː d͡ʒ
نخیر	n a x a j ɾ
ین	e n
پله	p e l l e
گلچه	ɡ o l t͡ʃ e
مخرج	m a x ɾ a d͡ʒ
خوب	x u b
پاستا	p ɑː s t ɑː
پیکر	p a j k a ɾ
گیس	ɡ e s
ناخواسته	n ɑː x ɑː s t a
هجران	h i d͡ʒ ɾ ɑː n
نجس‌تر	n a d ʒ a s t a ɾ
ثروت	s a ɾ v a t
ضلع	z e l ʔ
ایالت	i j ɑː l a t
گذشتن	ɡ o z a ʃ t a n
سرفراز	s a ɾ f a ɾ ɑː z
زنبور	z a m b u ɾ
خاطر	x ɑː t i ɾ
رابطه	ɾ ɑː b i t a
بچگی	b a t t͡ʃ a ɡ iː
مردن	m o ɾ d a n
مادربزرگ	m ɑː d a ɾ b u z u ɾ ɡ
اذان	a z ɑː n
موم	m uː m
مازندرانی	m ɑː z a n d a ɾ ɑː n iː
بسنده	b a s a n d e
مسجدها	m a s d ʒ e d h ɑː
نوروزی	n a v ɾ s z iː
گور	ɡ oː ɾ
لنگر	l a n ɡ a ɾ
شگفت	ʃ e ɡ e f t
اخیرا	a x i ɾ a n
گورخر	ɡ oː ɾ x a ɾ
غرق	ɢ a ɾ ɢ
وظیفه	v a z i f a
وعده	v a ʔ d a
آجیل	ɑː d͡ʒ iː l
ژنو	ʒ e n e v
درد	d a ɾ d
غارت	ɢ ɑː ɾ a t
قونیه	ɢ u n i j a
زاده	z ɑː d a
دیر	d a j ɾ
عالی	ɑː l iː
فرمودن	f a ɾ m u d a n
کارمند	k ɑː ɾ m a n d
دوست	d oː s t
زیباتر	z iː b ɑː t a ɾ
تنیدن	t a n iː d a n
کبوتر	k a b oː t a ɾ
قیچی	ɢ a j t͡ʃ iː
بنیاد	b o n j ɑː d
نام	n ɑː m
استراحت	e s t e ɾ ɑː h a t
اعتقاد	e ʔ t e ɢ ɑː d
اریحا	a ɾ i h ɑː
مرغان	m o ɾ ɢ ɑː n
کمند	k a m a n d
کمان	k a m ɑː n
خرید	h a ɾ i d
برنامه	b a ɾ n ɑː m a
جمعه	d͡ʒ o m e
ویستا	v i s t ɑ
شمسی	ʃ a m s iː
بادام	b ɑː d ɑː m
نارنجک	n ɑː ɾ a n d͡ʒ a k
اشترخار	o ʃ t o ɾ x ɑː ɾ
مادر	m ɑː d a ɾ
خود	x o d
آزموده	ɑː z m uː d a
مناسبت	m o n ɑː s e b a t
بابا	b ɑː b ɑː
دلگیری	d e l ɡ iː ɾ iː
واکسن	v ɑ k s a n
گذشته	ɡ o z a ʃ t e
مد	m o d
چکمه	t͡ʃ a k m a
یاد	j ɑː d
صیغه	s iː ɢ a
استان	o s t ɑː n
مورچه	m oː ɾ t͡ʃ a
اسپست	a s p i s t
سبزی	s a b z iː
جیب	d͡ʒ e b
اسب	a s b
قدیمی	ɢ a d i m iː
مهر	m a h ɾ
باحال‌تر	b ɑː h ɑː l t a ɾ
متوسط	m o t a v a s s e t
شیک	ʃ iː k
گواشتن	ɡ o v ɑː ʃ t a n
چغندر	t͡ʃ o ɢ o n d a ɾ
رعایت	ɾ e ʔ ɑː j a t
گنجشک	ɡ o n d͡ʒ e ʃ k
کنده	k a n d a
رختن	r e x t a n
محکمه	m a h k a m a
ملکه	m a l i k a
نستعلیق	n a s t a ʔ l i ɢ
دوره	d a v ɾ a
حمایت	h e m ɑː j a t
آسمانخراش	ɑː s m ɑː n x a ɾ ɑː ʃ
افزودن	a f z u d a n
ضخیم	z a x iː m
خواستن	x ɑː s t a n
محافظه‌کار	m o h ɑː f e z e k ɑː ɾ
اژدها	a ʒ d a h ɑː
ناوخدا	n ɑː v x o d ɑː
کنجکاو	k o n d͡ʒ k ɑː v
آزمایشگاه	ɑː z m ɑː j i ʃ ɡ ɑː h
گوشه	ɡ oː ʃ a
بلاگ	b l ɑː ɡ
طعم	t a ʔ m
جاذبه	d͡ʒ ɑː z i b a
الموت	ʔ a l a m uː t
یم	j a m
سرطان	s a ɾ a t ɑː n
قسطنطنیه	ɢ u s t a n t a n i j a
قندهار	ɢ a n d a h ɑː ɾ
جواری	d͡ʒ o v ɑː ɾ iː
زیست‌شناس	z iː s t ʃ e n ɑː s
آسیاب	ɑː s i j ɑː b
مالک	m ɑː l i k
کوتاه‌ترین	k uː t ɑː h t a ɾ iː n
ترش	t o ɾ ʃ
صرع	s a ɾ ʔ
گره	ɡ e r e h
رواج	r a v ɑː d͡ʒ
گستاخ	ɡ o s t ɑː x
تیمارستان	t i m ɑː ɾ i s t ɑː n
نشلیدن	n e ʃ e l iː d a n
فحش	f o h ʃ
ربع	ɾ o b ʔ
چشم	t͡ʃ a ʃ m
ذاتی	z ɑː t iː
امر	a m ɾ
کهر	k a h a ɾ
گندم	ɡ a n d u m
نماز	n a m ɑː z
اتحاد	e t t e h ɑː d
مرو	m a ɾ v
آموزگار	ɑː m oː z ɡ ɑː ɾ
لثه	l a s e
بهشت	b e h e ʃ t
شکلاتی	ʃ o k o l ɑ t i
ثبت	s a b t
خامه	x ɑː m a
مصدر	m a s d a ɾ
محیط	m o h iː t
داشتن	d ɑː ʃ t a n
معادل	m o ʔ ɑː d e l
ساختمان	s ɑː x t i m ɑː n
دجله	d e d͡ʒ l e
اله	e l ɑː h
روزنامه	ɾ oː z n ɑː m a
درشت	d o ɾ o ʃ t
خواجه	x ɑː d͡ʒ a
افتخار	e f t e x ɑː ɾ
سگالیدن	s e ɡ ɑː l iː d a n
ابزار	a b z ɑː ɾ
تاریک‌تر	t ɑː ɾ iː k t a ɾ
حقیقی	h a ɢ i ɢ iː
مرمی	m a r m iː
گزاف‌تر	ɡ a z ɑː f t a ɾ
مردم	m a ɾ d u m
الحاق	e l h ɑː ɢ
جدایی	d͡ʒ o d ɑː j iː
اظهار	e z h ɑː ɾ
فراموشیدن	f a ɾ ɑː m uː ʃ iː d a n
کنسرت	k o n s e ɾ t
مغ	m a ɢ
پنج	p a n d͡ʒ
وحی	v a h j
بودن	b u d a n
ناخن	n ɑː x u n
قهوه	ɢ a h v a
پسر	p a s a ɾ
مثلا	m a s a l a n
رسانیدن	ɾ a s ɑː n iː d a n
خودنویس	x o d n e v iː s
بەت	b ɑː t
نزدیک	n a z d i k
همچنین	h a m t͡ʃ a n i n
رقص	ɾ a ɢ s
بلوط	b a l u t
نسرین	n a s ɾ iː n
ریشه‌شناسی	ɾ e ʃ a ʃ i n ɑː s iː
سالگرد	s ɑː l ɡ a ɾ d
موتر	m oː t a ɾ
باور	b ɑː v a ɾ
متخلف	m o t a x a l l e f
تور	t o v a ɾ
الماس‌ها	a l m ɑː s h ɑː
نجس	n a d ʒ e s
توصیه	t a v s i j a
خنداندن	x a n d ɑː n d a n
عصر	ʔ a s ɾ
سنگسار	s a n ɡ s ɑː ɾ
سلیمانی	s o l e j m ɑː n iː
تکفور	t a k f uː ɾ
كنج	k o n d͡ʒ
مسیح	m a s e h
پیشتاز	p e ʃ t ɑː z
آفند	ɑː f a n d
انگشتر	a n ɡ u ʃ t a ɾ
سهراب	s o h ɾ ɑː b
گزاردن	ɡ o z ɑː ɾ d a n
آیا	ɑː j ɑː
تحویل	t a h v i l
گنبد	ɡ o m b a d
مارس	m ɑː ɾ s
کنشت	k e n e ʃ t
الهام	e l h ɑː m
دانشگاه	d ɑː n i ʃ ɡ ɑː h
پوست‌شناسی	p oː s t ʃ i n ɑː s iː
سنجاب	s a n d͡ʒ ɑː b
سنبه	s o m b e
شهریور	ʃ a h ɾ iː v a ɾ
یلدا	j a l d ɑ
چقدر	t͡ʃ e ɢ a d a ɾ
جایگاه	d͡ʒ ɑː j ɡ ɑː h
صاعقه	s ɑː ʔ i ɢ a
بینی	b i n iː
سلماس	s a l m ɑː s
ترجمه	t a ɾ d͡ʒ u m a
بیمار	b e m ɑː ɾ
نماینده	n a m ɑː j a n d e
جودر	d͡ʒ a v d a ɾ
ابرو	a b ɾ u
عادی	ʔ ɑː d iː
توسی	t uː s iː
صحیح	s a h e h
شهنشاه	ʃ a h a n ʃ ɑː h
گل	ɡ e l
بنابراین	b e n ɑː b a ɾ iː n
پاپ	p ɑː p
قربک	ɢ o ɾ b a k
خوشبخت	x o ʃ b a x t
ویر	v i ɾ
حمله	h a m l a
اتمام	e t m ɑː m
مؤدب	m o ʔ a d d e b
مشکی	m e ʃ k iː
شکیفتن	ʃ e k iː f t a n
آرامگاه	ɑː ɾ ɑː m ɡ ɑː h
دریا	d a ɾ j ɑː
سرهنگ	s a ɾ h a n ɡ
فر	f o ɾ
اسپندان	e s p a n d ɑː n
مسلمان	m o s a l m ɑː n
پیاده	p i j ɑː d a
آجر	ɑː d͡ʒ u ɾ
مادیان	m ɑː d i i ɑː n
دادن	d ɑː d a n
خرامیدن	x e ɾ ɑː m iː d a n
کهف	k a h f
زوجیت	z a v d͡ʒ i j a t
موزه	m oː z a
شهرت	ʃ o h ɾ a t
مغازه	m a ɢ ɑː z a
رفدن	ɾ a f d a n
بهاءالله	b a h ɑː ʔ u l l ɑː h
قاصدک	ɢ ɑː s i d a k
شامل	ʃ ɑː m i l
خطر	x a t a ɾ
طلایی	t a l ɑː j iː
وسط	v a s a t
زوبین	z oː b iː n
زلیخا	z o l e j x ɑː
حجاب	h e d͡ʒ ɑː b
شلوغ‌ترین	ʃ o l uː ɢ t a ɾ iː n
مؤثر	m o ʔ a s s e ɾ
ـیسم	i s m
ماهی	m ɑː h iː
امضاء	e m z ɑː
پشه	p a ʃ e
مژده	m o ʒ d e
زورخانه	z oː ɾ x ɑː n a
کلمه	k a l a m a
هزار	h a z ɑː ɾ
مردانه	m a ɾ d ɑː n a
کارخانه	k ɑː ɾ x ɑː n a
ژاله	ʒ ɑː l a
برهنه	b a ɾ a h n a
دلفین	d o l f iː n
متوجه	m o t a v a d d͡ʒ e h
بهمان	b a h m ɑː n
سبک	s a b k
گوهر	ɡ a v h a ɾ
سوخته	s uː x t e
تیله	t e l a
بسد	b e s a d
افسردگی	a f s u ɾ d i ɡ iː
آخور	ʔ ɑː x a ɾ
نمایه	n a m ɑː j e
فرق	f a ɾ ɢ
فعلا	f e ʔ l a n
خباره	x a b ɑː ɾ a
یاکند	j ɑː k a n d
شکستنی	ʃ i k a s t a n iː
شکسته	ʃ e k a s t e
مسلمون	m o s a l m uː n
نازک	n ɑː z u k
پاشنه	p ɑː ʃ n a
زوش	z u ʃ
سرو	s a ɾ v
سمفونی	s a m f oː n iː
کالبد	k ɑː l b u d
سرکار	s a ɾ k ɑː ɾ
روند	ɾ a v a n d
ازاله	e z ɑː l e
خوشنویسی	x o ʃ n e v iː s iː
خاستن	x ɑː s t a n
آسانی	ɑː s ɑː n iː
فضایی	f a z ɑː j iː
اصلی	a s l iː
اهواز	a h v ɑː z
عربستان	a ɾ a b i s t ɑː n
دانشمند	d ɑː n i ʃ m a n d
جنون	d ʒ o n uː n
بایستی	b ɑː j a s t iː
آمیختن	ɑː m e x t a n
نزد	n a z d
مروزی	m a ɾ v e z iː
پیغامبر	p a j ɢ ɑː m b a ɾ
نسخه	n o s x e
شب‌بوی	ʃ a b b oː j
کمانچه	k a m ɑː n t͡ʃ a
درمان	d a ɾ m ɑː n
ایام	ʔ a j j ɑː m
قلاوز	ɢ u l ɑː v u z
پایه	p ɑː j a
تختخواب	t a x t i x ɑː b
دستکند	d a s t k a n d
بی‌پروا	b e p a ɾ v ɑː
به	b a
چتر	t͡ʃ a t ɾ
امروز	e m ɾ uː z
مشاور	m o ʃ ɑː v e ɾ
هنر	h o n a ɾ
حلال	h a l ɑː l
گان	ɡ ɑː n
ایران	e ɾ ɑː n
فایده	f ɑː j i d a
حیوان	h a j v ɑː n
هندو	h e n d uː
بکارت	b a k ɑː ɾ a t
انسان	e n s ɑː n
محنت	m e h n a t
بخش	b a x ʃ
موقع	m a v ɢ e ʔ
پرندوش	p a ɾ a n d oː ʃ
سهل	s a h l
آتش	ɑː t a ʃ
پرتوقع	p o ɾ t a v a ɢ ɢ o ʔ
بامزه‌تر	b ɑː m a z e t a ɾ
پالایشگاه	p ɑː l ɑː j i ʃ ɡ ɑː h
صحبت	s o h b a t
دیسال	d i s ɑː l
اقلیم‌شناسی	e ɢ l iː m ʃ e n ɑː s iː
شیطان	ʃ a j t ɑː n
گزاف‌ترین	ɡ a z ɑː f t a ɾ iː n
گرزه	ɡ o ɾ z e
موافق	m o v ɑː f e ɢ
مسلحانه	m o s a l l a h ɑː n e
تقریبا	t a ɢ ɾ iː b a n
راهب	ɾ ɑː h i b
شترمرغ	ʃ o t o ɾ m o ɾ ɢ
افتادن	o f t ɑː d a n
پیشوند	p e ʃ v a n d
تیزاب	t e z ɑː b
شات	ʃ ɑː t
گویش	ɡ oː j i ʃ
جنوب	d͡ʒ a n u b
کتی	k a t iː
ذهن	z e h n
مجبور	m a d͡ʒ b u ɾ
ترشی	t o ɾ ʃ iː
چطور	t͡ʃ e t o v ɾ
تمام	t a m ɑː m
بی‌میل	b e m a j l
آلمان	ɑː l m ɑː n
دنب	d o n b
فریفتن	f a ɾ e f t a n
مهم	m o h e m m
شاذ	ʃ ɑː z
میان	m i j ɑː n
روسیه	ɾ u s i j a
عرض	a ɾ a z
قاچاقچی	ɢ ɑː t͡ʃ ɑː ɢ t͡ʃ iː
موجود	m a v d͡ʒ u d
استاد	o s t ɑː d
سرباز	s a ɾ b ɑː z
هندی	h e n d iː
صبور	s a b u ɾ
هول	h a v l
بار	b ɑː ɾ
یاساق	j ɑː s ɑː ɢ
معشوق	m a ʔ ʃ u ɢ
اندیشه	a n d e ʃ a
درست	d o ɾ o s
آشپز	ɑː ʃ p a z
سرد	s a ɾ d
وشم	v a ʃ m
تشکر	t a ʃ a k k u ɾ
آشپزخانه	ɑː ʃ p a z x ɑː n a
دندان	d a n d ɑː n
پارسه	p ɑː ɾ s e
خاطب	x ɑː t i b
دیوشناسی	d e v ʃ i n ɑː s iː
امید	o m iː d
که	k e
اولی	a v v a l iː
آسان	ɑː s ɑː n
یی	j iː
نیک	n e k
هدیه	h a d i j a
دزد	d o z d
سینه	s i n a
شپش‌ها	ʃ e p e ʃ h ɑː
قید	ɢ e j d
جنگ	d͡ʒ a n ɡ
تازه‌تر	t ɑː z e t a ɾ
روس	ɾ u s
گراز	ɡ o ɾ ɑː z
لبخند	l a b x a n d
سفر	s a f a ɾ
خاندان	x ɑː n d ɑː n
زود	z u d
ابرش	a b ɾ a ʃ
سرچشمه	s a ɾ t͡ʃ a ʃ m a
الان	ʔ a l ʔ ɑː n
بریدن	b o ɾ iː d a n
بازیچه	b ɑː z iː t ʃ e
قلیان	ɢ a l j ɑː n
پاکستان	p ɑː k i s t ɑː n
تولد	t a v a l l u d
شعب	ʃ o ʔ a b
سلیمان	s o l e j m ɑː n
ارزان	a ɾ z ɑː n
سیزده	s e n z d a h
گوشواره	ɡ oː ʃ v ɑː ɾ a
بیل	b e l
سیلاب	s a j l ɑː b
حرفه	h e ɾ f e
لی	l iː
نااهل	n ɑː ʔ a h l
گلابی	ɡ o l ɑː b iː
شستن	ʃ o s t a n
بگران	b a ɡ ɾ ɑː n
رعنا	ɾ a ʔ n ɑː
جاری	d͡ʒ ɑː ɾ i
مکتب	m a k t a b
مینو	m i n s
شگرد	ʃ e ɡ e ɾ d
پروگرام	p e ɾ o ɡ e ɾ ɑː m
بلی	b a l e
سعادت	s a ʔ ɑː d a t
ریش	ɾ e ʃ
تدریس	t a d ɾ i s
دهان	d a h ɑː n
سوسن	s oː s a n
نواختن	n a v ɑː x t a n
شاهد	ʃ ɑː h i d
بتکده	b o t k a d e
تجربی	t a d ʒ ɾ o b iː
آبنوس	ɑː b n uː s
اشتباه	e ʃ t e b ɑː h
فصح	f e s h
واژگان	v ɑː ʒ e ɡ ɑː n
رنگارنگ	ɾ a n ɡ ɑː ɾ a n ɡ
احترام	e h t e ɾ ɑː m
ژامبون	ʒ ɑː m b o n
نامه	n ɑː m a
قلمدان	ɢ a l a m d ɑː n
پری	p a ɾ iː
خز	x a z
موز	m a v z
ایستادن	i s t ɑː d a n
بیشتر	b e ʃ t a ɾ
هیزم	h e z u m
چین	t͡ʃ i n
دیوان	d e v ɑː n
حدادی	h a d ɑː d iː
معاون	m o ʔ ɑː v e n
ارده	a ɾ d a
تقریباً	t a ɢ ɾ i b a n
نافرمان	n ɑː f a ɾ m ɑː n
ندا	n e d ɑː
کادو	k ɑː d u
شانه	ʃ ɑː n a
بی‌ستاره	b e s i t ɑː ɾ a
ستون	s o t uː n
ریختن	ɾ e x t a n
آواز	ɑː v ɑː z
مشکل‌تر	m o ʃ k e l t a ɾ
بخصوص	b a x u s u s
گز	ɡ a z
قطار	ɢ a t ɑː ɾ
پل	p o l
امیدیار	ʔ o m iː d j ɑː ɾ
محمدقلی	m o h a m m a d ɢ o l iː
مسافر	m o s ɑː f e ɾ
دفاع	d e f ɑː ʔ
ناک	n ɑː k
تقدیر	t a ɢ d i ɾ
پوشاک	p oː ʃ ɑː k
سلاح	s e l ɑː h
آزمایش	ɑː z m ɑː j i ʃ
قبرستان	ɢ a b ɾ i s t ɑː n
هندوانه	h e n d e v ɑː n e
ظهر	z o h ɾ
خواب	x ɑː b
شاریدن	ʃ ɑː ɾ iː d a n
افغانستان	a f ɢ ɑː n i s t ɑː n
می	m a j
فرمایش	f a ɾ m ɑː j i ʃ
کاسب	k ɑː s i b
قدرت	ɢ u d ɾ a t
عفت	ʔ e f f a t
آرایشگاه	ɑː ɾ ɑː j i ʃ ɡ ɑː h
مکانیک	m e k ɑː n iː k
خزندگان	x a z a n d e ɡ ɑː n
لو	l o v
احتیاج	e h t i j ɑː d͡ʒ
هرتز	h e ɾ t z
وای	v ɑː j
رودابه	ɾ uː d ɑː b e
خصم	x a s m
نیست	n e s t
قشنگی	ɢ a ʃ a n ɡ iː
نویسه‌گردانی	n e v iː s e ɡ a ɾ d ɑː n iː
شترخار	ʃ o t o ɾ x ɑː ɾ
خبر	x a b a ɾ
دادار	d ɑː d ɑː r
کمک	k o m a k
فائده	f ɑː ʔ e d e
سرداب	s a ɾ d ɑː b
جبران	d͡ʒ o b ɾ ɑː n
ژاژ	ʒ ɑː ʒ
حمام	h a m m ɑː m
وزغ	v a z a ɢ
دراییدن	d a ɾ ɑː j iː d a n
بلور	b i l oː ɾ
خدا	x o d ɑː
عشق‌آباد	e ʃ ɢ ɑː b ɑː d
اذیت	a z i j a t
یونجه	j oː n d͡ʒ a
دستاویز	d a s t ɑː v e z
صادق	s ɑː d i ɢ
بوران	b uː ɾ ɑ n
بال	b ɑː l
گشادی	ɡ o ʃ ɑː d iː
شب	ʃ a b
بهتر	b e h t a ɾ
کنگره	k o n ɡ r e
حدیث	h a d i s
مشتق	m o ʃ t a ɢ
گدازه	ɡ o d ɑː z e
مالیات	m ɑː l iː j ɑː t
شوره	ʃ oː ɾ e
فاک	f ɑː k
چوکی	t ʃ a v k iː
هفته‌ها	h a f t e h ɑː
قاطر	ɢ ɑː t i ɾ
اضافه	e z ɑː f e
منبع	m a n b a ʔ
آغا	ɑː ɢ ɑː
صهیونی	s a h j u n iː
اً	t a n v i n
معلم	m o ʔ a l l e m
فردوس	f e ɾ d o v s
حکایت	h e k ɑː j a t
مشعل	m a ʃ ʔ a l
موفق	m o v a f a ɢ
هم	h a m
شلوار	ʃ a l v ɑː ɾ
انتحار	e n t e h ɑː ɾ
کتب	k o t o b
خلوت	x a l v a t
خان	x ɑː n
سیاست	s i j ɑː s a t
خاطره	x ɑː t i ɾ a
لهذا	l e h ɑː z ɑː
تشکیل	t a ʃ k i l
زنبق	z a m b a ɢ
افغانی	a f ɢ ɑː n iː
چوپان	t͡ʃ u p ɑː n
نگهداری	n e ɡ a h d ɑː ɾ iː
مضحک	m o z h e k
دلاور	d e l ɑː v a ɾ
ارغوانی	a ɾ ɢ a v ɑː n iː
تاکنون	t ɑː k u n uː n
سحر	s a h a ɾ
دل	d e l
فرارود	f a ɾ ɑː ɾ uː d
خسروانی	x o s ɾ a v ɑː n iː
فرودگاه	f o ɾ uː d ɡ ɑː h
ملت	m e l l a t
لازم	l ɑː z i m
شترغار	ʃ o t o ɾ ɢ ɑː ɾ
رده	ɾ a d a
سند	s e n d
اهریمن	ʔ a h ɾ iː m a n
سوغات	s a v ɢ ɑː t
شعبه	ʃ o ʔ b e
خرما	x o ɾ m ɑː
خانواده	x ɑː n a v ɑː d a
گچ	ɡ a t͡ʃ
قالب	ɢ ɑː l i b
یاسمن	j ɑː s a m a n
پشت	p o ʃ t e
نسیم	n a s i m
الهه	e l ɑː h e
آیت‌الله	ɑː j a t u l l ɑː h
سرنشین	s a ɾ n i ʃ i n
اغوا	e ɢ v ɑː
خسیس	x a s i s
استقلال	e s t e ɢ l ɑː l
خردل	x a ɾ d a l
خوش	x o ʃ
علاوه	a l ɑː v a
پیرترین	p iː ɾ t a ɾ iː n
زرین	z a ɾ ɾ i n
قند	ɢ a n d
آرزو	ɑː ɾ i z uː
پریستان	p a ɾ i j i s t ɑː n
گودر	ɡ oː d a ɾ
پاره	p ɑː ɾ a
قلم	ɢ a l a m
وضوح	v o z uː h
خاژغان	x ɑː ʒ ɢ ɑː n
برگزیدن	b a ɾ ɡ u z i d a n
کوچه	k oː t͡ʃ a
ازبکستان	o z b a k e s t ɑː n
ارگ	o ɾ ɡ
شپش	ʃ e p e ʃ
باغ‌ها	b ɑː ɢ h ɑː
زان	z ɑː n
فردا	f a ɾ d ɑː
اتفاقاً	e t t e f ɑː ɢ a n
ترگمان	t a ɾ ɡ u m ɑː n
سریدن	s o ɾ iː d a n
صمیمی	s a m i m iː
خوانندگان	x ɑː n a n d e ɡ ɑː n
پژوهش	p a ʒ u h i ʃ
ستبر	s e t a b ɾ
دقیقه	d a ɢ i ɢ a
زیرک	z i ɾ a k
درزی	d a ɾ z iː
پیشمرگه	p e ʃ m a ɾ ɡ e
سورپرایز	s u r p e ɾ ɑ j z
لابد	l ɑː b u d
جنسی	d͡ʒ e n s iː
خروشیدن	x o ɾ uː ʃ iː d a n
طلاق	t a l ɑː ɢ
آخ	ɑː x
ماست	m ɑː s t
گریستن	ɡ e ɾ iː s t a n
بچه	b a t t͡ʃ a
استیون	e s t iː v e n
مرغ‌ها	m o ɾ ɢ h ɑː
اسلام	ʔ e s l ɑː m
پی	p e j
شفقت	ʃ a f a ɢ a t
کبریت	k e b ɾ iː t
ناژو	n ɑː ʒ uː
الماس	a l m ɑː s
شدنی	ʃ o d a n iː
آشوب	ɑː ʃ oː b
ملا	m o l ɑː
قبض	ɢ a b z
پیسه	p a j s a
حضور	h o z uː ɾ
موفقیت	m o v a f f a ɢ iː j a t
سید	s a j j i d
سینا	s iː n ɑː
عموما	o m uː m a n
شکایت	ʃ e k ɑː j a t
خدای	x o d ɑː j
مجلس	m a d͡ʒ l i s
مرداد	m o ɾ d ɑː d
بلال	b a l ɑː l
لهجه	l a h d͡ʒ a
مجموعه	m a d͡ʒ m u ʔ a
خسته	x a s t a
تاج	t ɑː d͡ʒ
فریدون	f e ɾ e i d uː n
رندیدن	ɾ a n d i d a n
هنی	h a n iː
ایمان‌دار	i m ɑː n d ɑː ɾ
تلخ	t a l x
دیو	d e v
قصه	ɢ i s s a
حماس	h a m ɑː s
ترنج	t o ɾ o n d͡ʒ
بیش	b e ʃ
هی	h e j
پرنگ	p e ɾ e n ɡ
میهن‌پرست	m i h a n p a ɾ a s t
پیکار	p a j k ɑː ɾ
ماجرا	m ɑː d͡ʒ a ɾ ɑː
ابد	a b a d
گنجینه	ɡ a n d͡ʒ i n a
حادثه	h ɑː d i s a
باریک‌ترین	b ɑː ɾ iː k t a ɾ iː n
انرژی	a n a ɾ ʒ iː
نو	n a v
دیگ	d e ɡ
میزان	m i z ɑ n
سایه	s ɑː j a
دیم	d e m
چرخه	t͡ʃ a ɾ x a
روغن	ɾ a v ɢ a n
فروغ	f o ɾ uː ɢ
تلاش	t a l ɑː ʃ
غلام	ɢ o l ɑː m
منشار	m e n ʃ ɑː ɾ
حیران	h a i ɾ ɑː n
پیشوا	p e ʃ v ɑ
دیروز	d i ɾ s z
نمایندگان	n a m ɑː j a n d e ɡ ɑː n
شروع	ʃ o r uː ʔ
زره	z e ɾ e h
البته	a l b a t t a
قانون	ɢ ɑː n uː n
مجازات‌ها	m o d ʒ ɑː z ɑː t h ɑː
زاوش	z ɑː v u ʃ
رأی	ɾ a ʔ j
سخنرانی	s o x a n ɾ ɑː n iː
خط	x a t
بردن	b o ɾ d a n
چاپگر	t͡ʃ ɑː p ɡ a ɾ
دماسنج	d a m ɑː s a n d͡ʒ
غافث	ɢ ɑː f e s
ترشک	t o ɾ ʃ a k
فروردین	f a ɾ v a ɾ d iː n
مبهم	m o b h a m
رکورد	ɾ e k o v ɾ d
قشنگ	ɢ e ʃ a n ɡ
حتی	h a t t ɑː
حکم	h o k m
شمعدان	ʃ a m ʔ d ɑː n
نارگیله	n ɑː ɾ ɡ iː l a
تازگی	t ɑː z a ɡ iː
عضوها	o z v h ɑ
مواظب	m o v ɑː z e b
تکواژ	t a k v a ʒ
قبلا	ɢ a b l a n
روسی	ɾ u s iː
جلو	d͡ʒ e l o v
دارو	d ɑː ɾ uː
نتیجه	n a t i d͡ʒ a
خیار	x i j ɑː ɾ
گلی	ɡ o l iː
خربز	x a ɾ b u z
آدم‌ها	ɑː d a m h ɑː
فقط	f a ɢ a t
ثابت‌ها	s ɑː b e t h ɑː
باید	b ɑː j a d
پرتو	p a ɾ t a v
تعریف	t a ʔ ɾ i f
سازش	s ɑː z i ʃ
صندوق	s a n d u ɢ
کلیچه	k o l iː t͡ʃ e
دیس	d e s
قاره	ɢ ɑː ɾ a
پوهنتون	p oː h a n t uː n
مهره	m o h ɾ e
شایعه	ʃ ɑː j i ʔ a
گسترده	ɡ o s t a ɾ d e
نادان	n ɑː d ɑː n
خلیفه	x a l i f a
شیردال	ʃ e ɾ d ɑː l
دستار	d a s t ɑː ɾ
سیاح	s a j j ɑː h
اراده	e ɾ ɑː d e
عروس	ʔ a ɾ u s
معجزه	m o ʔ d͡ʒ e z e
هر	h a ɾ
پراکندگی	p a ɾ ɑː k a n d a ɡ iː
عمر	o m a ɾ
چریک	t͡ʃ a ɾ i k
مادرانه	m ɑː d a ɾ ɑː n a
تشکیلات	t a ʃ k i l ɑː t
کاکوتی	k ɑː k uː t iː
خاتم	x ɑː t a m
نامیدن	n ɑː m iː d a n
آغیل	ɑː ɢ iː l
خصومت	x o s uː m a t
بی‌صدا	b e s a d ɑː
قدر	ɢ a d a ɾ
اقلیم	e ɢ l iː m
شمع	ʃ a m ʔ
مشهور	m a ʃ h u ɾ
رشد	ɾ o ʃ d
طرفدار	t a ɾ a f d ɑː ɾ
حفاظت	h e f ɑː z a t
رژیمان	ɾ e ʒ i m ɑ n
نواختر	n a v a x t a ɾ
بی‌وفا	b e v a f ɑː
وهم	v a h m
خواه	x ɑː h
گاش	ɡ ɑː ʃ
وضع	v a z ʔ
مانند	m ɑː n a n d i
شبنم	ʃ a b n a m
نمکین	n a m a k i n
شاهنشاه	ʃ ɑː h a n ʃ ɑː h
پایتخت	p ɑː j t a x t
لات	l ɑː t
پروژه	p e ɾ o ʒ e
سرخ	s o ɾ x
سری	s a ɾ iː
مغرب	m a ɢ ɾ i b
بوقلمون	b u ɢ a l a m u n
کیهان	k a j h ɑː n
خدمت	x e d m a t
مرشدقلی	m o ɾ ʃ e d ɢ o l iː
داروسازی	d ɑː ɾ uː s ɑː z iː
ساده	s ɑː d a
زیبا	z e b ɑː
ان	ɑː n
سلام	s a l ɑː m
ان‌شاءالله	e n ʃ ɑː ʔ a l l ɑː h
آهار	ɑː h ɑː ɾ
یائسگی	j ɑː ʔ i s a ɡ iː
کشتگی	k o ʃ t a ɡ iː
بعل	b a ʔ l
شوق	ʃ a v ɢ
کوره	k oː ɾ a
گیان	ɡ o j ɑː n
امین‌ها	a m iː n h ɑː
کنونی	k o n uː n iː
انگشت	a n ɡ i ʃ t
غصه	ɢ o s s e
جاهل	d͡ʒ ɑː h i l
فرازمینی	f a ɾ ɑː z a m iː n iː
جشن	d͡ʒ a ʃ n
حرص	h e ɾ s
عیب	a j b
گردنبند	ɡ a ɾ d a n b a n d
نوشتن	n a v i ʃ t a n
دارفلفل	d ɑː ɾ f i l f i l
مامانی	m ɑː m ɑː n iː
مثال	m e s ɑː l
رام	ɾ ɑː m
انفجار	e n f e d͡ʒ ɑː ɾ
کی	k a j
جنگل	d ʒ a n ɡ a l
رضا	ɾ e z ɑː
گاه	ɡ ɑː h
قسم	ɢ a s a m
عاصی	ʔ ɑː s iː
افلاطون	a f l ɑː t uː n
یتیم	j a t i m
مسافت	m a s ɑː f a t
عجب	ʔ a d͡ʒ a b
کفش	k a f ʃ
گاراژ	ɡ ɑː ɾ ɑː ʒ
بیمارتر	b iː m ɑː ɾ t a ɾ
پزشک	p e z e ʃ k
گاز	ɡ ɑː z
هرزگی	h a ɾ z a ɡ iː
قفسه	ɢ a f a s e
درخت	d a ɾ a x t
سلجوق	s a l d͡ʒ u ɢ
انقلاب	e n ɢ e l ɑː b
آموزش	ɑː m oː z i ʃ
بحریه	b a h ɾ i j a
زیویدن	z iː v iː d a n
هزینه	h a z e n a
سلسله	s e l s e l e
جمشید	d͡ʒ a m ʃ e d
سازمان	s ɑː z i m ɑː n
ناتمام	n ɑː t a m ɑː m
بهبود	b e h b uː d
فرهنگ	f a ɾ h a n ɡ
کلپ	k l a p
غیر	ɢ e j ɾ
قلع	ɢ a l ʔ
متعلق	m o t a ʔ a l l e ɢ
عطر	ʔ e t ɾ
دهستان	d e h e s t ɑː n
آفرینش	ɑː f a ɾ iː n i ʃ
ستاره‌شناس	s e t ɑː ɾ e ʃ e n ɑː s
خجالتی	x e d͡ʒ ɑː l a t iː
مرگ	m a ɾ ɡ
بیمارترین	b iː m ɑː ɾ t a ɾ iː n
خداحافظ	x o d ɑː h ɑː f e z
آموختن	ɑː m oː x t a n
سرندیپ	s a r a n d iː p
شکستن	ʃ e k a s t a n
واش	v ɑ ʃ
برخوردار	b a ɾ x o ɾ d ɑː ɾ
نژادی	n e ʒ ɑː d iː
خار	x ɑː ɾ
معنوی	m a ʔ n a v iː
رواق	ɾ e v ɑː ɢ
نشدنی	n a ʃ o d a n i
مسئول	m a s ʔ u l
رستوران	r e s t o ɾ ɑː n
عنابی	a n ɑː b iː
بیرق	b a j ɾ a ɢ
پدرام	p a d ɾ ɑː m
خونریزی	x u n ɾ e z iː
زبان	z a b ɑː n
مزنه	m o z n e
خرد	x e ɾ a d
قهوه‌ای	ɢ a h v a ʔ iː
شلوغ	ʃ o l uː ɢ
پرداختن	p a ɾ d ɑː x t a n
ظاهر	z ɑː h i ɾ
خطا	x a t ɑː
قول	ɢ a v l
مؤمن	m o ʔ m e n
جرم	d͡ʒ e ɾ m
عالم	ɑː l a m
بیمناک	b i n m ɑː k
نیزه	n e i z e
پودینه	p u d i n a
آهنین	ɑː h a n iː n
گاهی	ɡ ɑː h iː
بیچاره	b e t͡ʃ ɑː ɾ a
سرنوشت	s a ɾ n a v i ʃ t
باجی	b ɑː d ʒ iː
افرنگ	a f ɾ a n ɡ
مدرنیزه	m o d e ɾ n iː z e
دیسک‌ها	d iː s k h ɑː
پیشه	p e ʃ a
قفل	ɢ u f l
فاحش	f ɑː h e ʃ
مار	m ɑː ɾ
سرگیجه	s a ɾ ɡ i d͡ʒ a
کاهش	k ɑː h i ʃ
گین	ɡ i n
خرس	x e ɾ s
ژکفری	ʒ a k f a ɾ iː
شکال	ʃ e k ɑː l
پرستار	p a ɾ a s t ɑː ɾ
جمال	d͡ʒ a m ɑː l
چیدن	t͡ʃ i d a n
متن	m a t n
صنعتی	s a n ʔ a t iː
شیرین	ʃ i ɾ i n
اهمیت	a h a m i j a t
چپ	t ʃ a p
مرغاب	m o ɾ ɢ ɑː b
شلوغ‌تر	ʃ o l uː ɢ t a ɾ
دوزخ	d oː z a x
عسل	a s a l
بون	b uː n
زنده	z e n d e
تصمیم	t a s m i m
سوگند	s a v ɡ a n d
خانه	x ɑː n a
پیرتر	p iː ɾ t a ɾ
درودن	d o ɾ uː d a n
بنگ	b a n ɡ
سه‌شنبه	s e ʃ a n b e
دقت	d e ɢ ɢ a t
شاهکار	ʃ ɑː h k ɑː ɾ
لاعلاج	l ɑː ʔ i l ɑː d͡ʒ
گلو	ɡ a l oː
رفتار	ɾ a f t ɑː ɾ
پرهیز	p a ɾ h e z
ذات	z ɑː t
کنشگر	k o n e ʃ ɡ a ɾ
تاجیک	t ɑː d͡ʒ i k
فرشته	f a ɾ i ʃ t a
بحران	b o h ɾ ɑː n
منزل	m a n z i l
جعبه	d͡ʒ a ʔ b a
شهرزاد	ʃ a h ɾ z ɑː d
خشاب	x e ʃ ɑː b
ارادت	e ɾ ɑː d a t
گودرز	ɡ oː d a ɾ z
تخته	t a x t a
انتشار	e n t e ʃ ɑː ɾ
مهرداد	m e h ɾ d ɑː d
دریافت	d a ɾ j ɑː f t
عاشق	ɑː ʃ i ɢ
ماله	m ɑː l a
ملاقات	m o l ɑː ɢ ɑː t
نارون	n ɑː ɾ v a n
دشوار	d o ʃ v ɑː ɾ
مسیحی	m a s i h iː
نغمه	n a ɢ m a
پلاستیک	p e l ɑː s t iː k
فکر	f e k
انگلستان	e n ɡ e l e s t ɑː n
اشتباهی	e ʃ t e b ɑː h iː
سامان	s ɑː m ɑː n
آنجا	ɑː n d͡ʒ ɑː
معلوم	m a ʔ l u m
جدول	d͡ʒ a d v a l
آبشار	ɑː b ʃ ɑː ɾ
ابتدا	e b t e d ɑː
مدرسه	m a d ɾ a s a
لب	l a b
آغوش	ɑː ɢ oː ʃ
گیسو	ɡ e s u
عنصر	o n s o ɾ
ابوبکر	a b u b a k ɾ
طیاره	t a j j ɑː ɾ a
نیاز	n i j ɑː z
حیات	h a j ɑː t
جویدن	d͡ʒ a v i d a n
ذرت	z o r a t
زشت	z e ʃ t
گلپر	ɡ o l p a ɾ
ناف	n ɑː f
روزگار	ɾ oː z i ɡ ɑː ɾ
نشستن	n e ʃ a s t a n
گریختن	ɡ o ɾ iː x t a n
چند	t͡ʃ a n d
شانزده	ʃ uː n z d a h
شطرنج‌باز	ʃ a t ɾ a n d͡ʒ b ɑː z
یاقوت	j ɑː ɢ u t
فشردن	f e ʃ o ɾ d a n
صحرا	s a h ɾ ɑː
حاجت	h ɑː d͡ʒ a t
جور	d͡ʒ u ɾ
آلفته	ɑː l u f t a
اسطوره	o s t uː ɾ e
خاکستری	x ɑː k i s t a ɾ iː
تبر	t a b a ɾ
خصوصا	x o s uː s a n
چنگال	t͡ʃ a n ɡ ɑː l
باد	b ɑː d
خواستار	x ɑː s t ɑː ɾ
غیور	ɢ a j u ɾ
طاووس	t ɑː v uː s
سیاره‌ها	s a j ɑː ɾ e h ɑː
ویه	uː j e
بامزه‌ترین	b ɑː m a z e t a ɾ iː n
منگنه	m a n ɡ a n a
خف	x o f
خانگی	x ɑː n a ʔ ɡ iː
موحش	m u h i ʃ
شراب	ʃ a ɾ ɑː b
اتم	a t o m
ادیان	a d j ɑː n
کابل	k ɑː b u l
ده	d a h
نعوظ	n o ʔ uː z
هنوز	h a n oː z
کون	k u n
قسمت	ɢ i s m a t
متحد	m o t t a h e d
مؤسسه	m o ʔ a s s a s e
مناسب	m o n ɑː s e b
زرشکی	z e ɾ e ʃ k iː
بی‌شمار	b e ʃ u m ɑː ɾ
بیابان	b i j ɑː b ɑː n
زال	z ɑː l
زندانی	z e n d ɑː n iː
زیست‌شناسی	z iː s t ʃ e n ɑː s iː
رستم	ɾ o s t a m
آدم	ɑː d a m
پناهندگان	p a n ɑː h a n d e ɡ ɑː n
رنده	ɾ a n d a
قوم	ɢ a v m
ندارد	n a d ɑː ɾ a d
نوم	n oː m
مبارزه	m o b ɑː ɾ a z e
میلادی	m iː l ɑː d iː
شاهزادگان	ʃ ɑː h z ɑː d e ɡ ɑː n
دربار	d a ɾ b ɑː ɾ
مستعمره	m o s t a ʔ m a ɾ e
بیخودی	b i x u d iː
مختلط	m o x t a l e t
شنبلیله	ʃ a m b a l iː l e
چو	t ʃ o v
آتنا	ɑː t i n ɑː
خوک	x uː k
پر	p o ɾ
اورنگ	a v ɾ a n ɡ
حکومت	h o k uː m a t
خارج	x ɑː ɾ i d͡ʒ
تفریح	t a f ɾ e h
پرنده	p a ɾ a n d a
رد	ɾ a d d
پوست	p oː s t
زوو	z v oː
خارجی	x ɑː ɾ i d͡ʒ iː
لنگرگاه	l a n ɡ a ɾ ɡ ɑː h
سنگین	s a n ɡ i n
کشیدن	k a ʃ i d a n
کم‌کم	k a m k a m
غایب	ɢ ɑː j e b
پرویز	p a ɾ v iː z
سقرلات	s a ɢ i ɾ l ɑː t
بدرود	b e d ɾ uː d
وسیع	v a s e ʔ
بلد	b a l a d
ضربان	z a ɾ a b ɑː n
درآمد	d a ɾ ɑː m a d
کم‌مایه	k a m m ɑː j a
غژب	ɢ o ʒ b
کردی	k o ɾ d iː
چلنگر	t͡ʃ e l e n ɡ a ɾ
دیشب	d i ʃ a b
پستان	p e s t ɑː n
فیض	f a j z
طاقت	t ɑː ɢ a t
جبر	d͡ʒ a b ɾ
وکالت	v e k ɑː l a t
ول	v e l
اقتصادی	e ɢ t e s ɑː d iː
علت	e l l a t
شنگار	ʃ a n ɡ ɑː ɾ
وضعیت	v a z ʔ i j j a t
هفده	h a b d a h
فقرا	f o ɢ a ɾ ɑː
چا	t ʃ ɑː
دوش	d oː ʃ
گردیدن	ɡ a ɾ d i d a n
دختر	d o x d e ɾ
جگر	d ʒ e ɡ a ɾ
بارود	b ɑː ɾ uː d
ترک	t a ɾ k
کاغذها	k ɑː ɢ a z h ɑː
قاچاق	ɢ ɑː t͡ʃ ɑː ɢ
عجان	ʔ e d ʒ ɑː n
سوز	s oː z
قیصر	ɢ a j s a ɾ
خالی	x ɑː l iː
ثانیه	s ɑː n i j a
شاهقلی	ʃ ɑː h ɢ u l iː
جفت	d͡ʒ o f t
استقبال	e s t e ɢ b ɑː l
جو	d͡ʒ a v
واقعا	v ɑː ɢ e ʔ a n
باب	b ɑː b
وروجک	v o ɾ uː d͡ʒ a k
جام	d͡ʒ ɑː m
گوساله	ɡ uː s ɑː l e
پلخته	p a l a x t a
زور	z a v ɾ
تأکید	t a ʔ k i d
بعدا	b a ʔ d a n
عکس	a k s
ماه	m ɑː h
عادل	ɑː d i l
چینی	t͡ʃ i n iː
عادت	ʔ ɑː d a t
بیضه	b a j z a
ژم	ʒ a m
کوتاه‌تر	k uː t ɑː h t a ɾ
آسام	ɑː s ɑː m
چیزی	t͡ʃ i z e
نر	n a ɾ
بهاری	b a h ɑː ɾ iː
کلاغ	k a l ɑː ɢ
طب	t e b
صهیون	s a h j u n
آراستن	ɑː ɾ ɑː s t a n
صحنه	s a h n e
کاروان	k ɑː ɾ v ɑː n
رمضان	ɾ a m a z ɑː n
عمیق	a m iː ɢ
دارد	d ɑː ɾ a d
سنان	s e n ɑː n
چای	t͡ʃ ɑː j
ویرایش	v i ɾ ɑː j i ʃ
باردار	b ɑː ɾ d ɑː ɾ
احساس	e h s ɑː s
فانی	f ɑː n iː
آشوب‌ها	ɑː ʃ uː b h ɑː
گنده	ɡ a n d a
مروارید	m o ɾ v ɑː ɾ iː d
خروس	x o ɾ uː s
فوق‌العاده	f a v ɢ o l ʔ ɑ d a
تقصیر	t a ɢ s iː ɾ
ایستگاه	i s t ɡ ɑː h
مستقیم	m o s t a ɢ iː m
باژ	b ɑː ʒ
کره	k a ɾ a
رودخانه	ɾ oː d x ɑː n a
خوشبو	x o ʃ b uː j
یزدان	j a z d ɑː n
فامیل	f ɑː m iː l
یاب	j ɑː b
غم	ɢ a m
بختر	b e x t a ɾ
سرانجام	s a ɾ a n d͡ʒ ɑː m
دلسوز	d i l s oː z
شعر	ʃ e ʔ ɾ
ترساندن	t a ɾ s ɑː n d a n
بی‌مغز	b e m a ɢ z
بالاخره	b e l a x a ɾ e
ارزیدن	a ɾ z i d a n
تاریک‌ترین	t ɑː ɾ iː k t a ɾ iː n
فریب	f a ɾ e b
انگیختن	a n ɡ iː x t a n
خام	x ɑː m
تمرین	t a m ɾ i n
کباب	k a b ɑː b
کاغذ	k ɑː ɢ a z
پوپک	p oː p a k
جوراب	d ʒ oː ɾ ɑː b
اعدام	e ʔ d ɑː m
قاموس	ɢ ɑː m uː s
مختل	m o x t a l
آغاز	ɑː ɢ ɑː z
روشنی	ɾ a v ʃ a n iː
چهره	t͡ʃ e h ɾ a
خشمگین	x a ʃ m ɡ i n
درمنه	d e ɾ m a n e
ترکیدن	t a ɾ a k iː d a n
تعظیم	t a ʔ z i m
لیمو	l i m u
زمستان	z e m e s t ɑː n
مختلف	m o x t a l e f
دنیوی	d o n j a v e
نکاح	n e k ɑː h
ادا	a d ɑː
خوراندن	x o ɾ ɑː n d a n
غافت	ɢ ɑː f e t
بخارا	b o x ɑː ɾ ɑː
کماشیر	k a m ɑː ʃ e ɾ
آگاه	ɑː ɡ ɑː h
مربوط	m a ɾ b u t
استخوان	o s t o x ɑː n
قبر	ɢ a b ɾ
حاصل	h ɑː s i l
ناقص	n ɑː ɢ i s
غار	ɢ ɑː ɾ
مرحله	m a ɾ h a l a
غمناک	ɢ a m n ɑː k
تزیین	t a z j i n
منیژه	m a n iː ʒ a
گلف	ɡ o l f
کریمه	k e ɾ iː m e
سرور	s a ɾ v a ɾ
نانوشته	n ɑː n i v i ʃ t a
سیاه	s i j ɑː h
طبق	t a b a ɢ
اشتراک	e ʃ t e ɾ ɑː k
بازنشسته	b ɑː z n i ʃ a s t a
آفرین	ɑː f a ɾ iː n
نور	n u ɾ
خاموش	x ɑː m oː ʃ
کفگیر	k a f ɡ i ɾ
خسته‌خانه	x a s t a x ɑː n a
واژه‌ها	v ɑː ʒ e h ɑː
نهج	n a h a d͡ʒ
مرمر	m a ɾ m a ɾ
شهوت	ʃ a h v a t
تنها	t a n h ɑː
عنوان	o n v ɑː n
صرف	s e ɾ f
اقلیت	a ɢ a l l i j a t
بوم	b u m
طول	t u l
میهن	m e h a n
دلال	d a l l ɑː l
گروه	ɡ o ɾ uː h
جمله	d͡ʒ o m l e
مقعدی	m a ɢ ʔ a d iː
سنگواره	s a n ɡ v ɑː ɾ a
زین	z i n
فیلیپ	f i l i p
خربوزه	x a ɾ b u z a
تصحیح	t a s h e h
فغفور	f a ɢ f uː ɾ
رخام	ɾ o x ɑː m
قفس	ɢ a f a s
زر	z a ɾ
همه	h a m e
نشان	n e ʃ ɑː n
سخت	s a x t
بیشه	b e ʃ a
هخامنش	h a x ɑː m a n i ʃ
آزردن	ɑː z o ɾ d a n
نکونام	n e k uː n ɑː m
سفینه	s a f i n a
تفلیس	t e f l iː s
شاهنامه	ʃ ɑː h n ɑː m a
کهکشان‌ها	k a h k a ʃ ɑː n h ɑː
بارداری	b ɑː ɾ d ɑː ɾ iː
زیره	z iː ɾ e
برابر	b a ɾ ɑː b a ɾ
یه	j e
شیر	ʃ e ɾ
تیز	t e z
مشکل‌ترین	m o ʃ k e l t a ɾ iː n
کوتاه	k oː t ɑː h
پذیرفتن	p a z i ɾ u f t a n
خاله	x ɑː l a
قو	ɢ u
نیرومند	n iː ɾ uː m a n d
انجام	a n d͡ʒ ɑː m
خیم	x iː m
تعجب	t a ʔ a d d͡ʒ u b
تعلق	t a ʔ a l l u ɢ
نده	a n d a
جماعت	d͡ʒ a m ɑː ʔ a t
سنبوسه	s a m b oː s a
ناراحت	n ɑː ɾ ɑː h a t
بهار	b a h ɑː ɾ
هوش	h oː ʃ
شیرین‌تر	ʃ iː ɾ iː n t a ɾ
آلت	ɑː l a t
دیوانه	d e v ɑː n a
خاتون	x ɑː t uː n
سکه	s e k e
خاموشی	x ɑː m oː ʃ iː
خانوادگی	x ɑː n a v ɑː d a ɡ iː
شغل	ʃ o ɢ l
علم	a l a m
درس	d a ɾ s
آرامی	ɑː ɾ ɑː m iː
مومیا	m oː m i j ɑː
زیاد	z i j ɑː d
وزن	v a z n
درآوردن	d a ɾ ɑː v a ɾ d a n
سرمه	s a ɾ m a
تحصیل	t a h s i l
وقتی	v a ɢ t e
سفیر	s a f i ɾ
خوابگاه	x ɑː b ɡ ɑː h
پادشاه	p ɑː d i ʃ ɑː h
زهر	z a h ɾ
مرکب	m o ɾ a k k a b
شناختن	ʃ e n ɑː x t a n
کرس	k e ɾ s
فرمان	f a ɾ m ɑː n
دردمند	d a ɾ d m a n d
شاد	ʃ ɑː d
برهنگی	b a ɾ a h n a ɡ iː
شهری	ʃ a h ɾ iː
فن	f a n
اخترمار	a x t a ɾ m ɑː ɾ
انزال	e n z ɑː l
صلح	s u l h
مراسم	m a ɾ ɑː s i m
با	b ɑː
تمثیل	t a m s i l
مردانگی	m a ɾ d ɑː n a ɡ iː
موسیقی	m u s i ɢ iː
درفش	d a ɾ a f ʃ
نفر	n a f a ɾ
تولید	t a v l i d
ـی	e
پشمین	p a ʃ m iː n
توریستی	t u ɾ i s t
امین	a m iː n
فاس	f ɑː s
معبد	m a ʔ b a d
شلغم	ʃ a l ɢ a m
خنده	x a n d a
خطه	x a t t a
کنکور	k o n k uː r
پختن	p o x t a n
سالم	s ɑː l i m
ستور	s o t uː ɾ
افشردن	a f ʃ o ɾ d a n
سیستم	s iː s t e m
ای	e j
نوین	n a v i n
مریض	m a ɾ i z
شماریدن	ʃ o m ɑː ɾ iː d a n
باستانی	b ɑː s t ɑː n iː
نار	n ɑː ɾ
نزدیک‌تر	n a z d iː k t a ɾ
شبیه	ʃ a b e h
ثنویت	s a n a v i j j a t
پیشنهاد	p e ʃ n i h ɑː d
جدید	d͡ʒ a d i d
نمودار	n e m u d ɑː ɾ
سقراط	s o ɢ ɾ ɑː t
سیلابی	s a j l ɑː b e
تنبان	t o m b ɑ n
خندیدن	x a n d i d a n
ژرفی	ʒ a ɾ f iː
گوگرد	ɡ oː ɡ i ɾ d
اسپرزه	e s p a ɾ z e
بیمارستان	b e m ɑː ɾ i s t ɑː n
افزایش	a f z ɑː j i ʃ
برخی	b a r x iː
اصفهان	e s f a h ɑː n
تکرار	t a k ɾ ɑː ɾ
گردن	ɡ a ɾ d a n
نارنج	n ɑː ɾ a n d͡ʒ
خجالت	x e d͡ʒ ɑː l a t
میخانه	m a j x ɑː n a
نان	n ɑː n
پرندگان	p a ɾ a n d a ɡ ɑː n
موسم	m a v s i m
ما	m ɑː
مرد	m a ɾ d
شدید	ʃ a d i d
بم	b e m
عباسی	ʔ a b b ɑː s iː
خوشگل‌تر	x o ʃ ɡ e l t a ɾ
سیلاس	s iː l ɑː s
غلط	ɢ a l a t
به‌آفرید	b e h ɑː f a ɾ iː d
اخراج	e x ɾ ɑː d͡ʒ
بزاق	b o z ɑː ɢ
احتمال	e h t e m ɑː l
عمق	o m ɢ
نالون	n ɑː l uː n
دوران	d a v a ɾ ɑː n
اثبات	e s b ɑː t
کمتر	k a m t a ɾ
کشکول	k a ʃ k uː l
خرم	x o ɾ a m
رومی	ɾ oː m iː
خایه	x a j a
خوار	x ɑː ɾ
محبت	m a h a b b a t
ملیت	m e l l i j a t
رخت	ɾ a x t
آش	ʔ ɑː ʃ
والله	v a l l ɑː h
بحر	b a h ɾ
الله‌قلی	a l l ɑː h ɢ u l iː
مرجان	m a ɾ d͡ʒ ɑː n
برازیدن	b a ɾ ɑː z iː d a n
بخاطر	b a x ɑː t i ɾ i
نیفه	n e f a
شیوا	ʃ e v ɑː
ظرف	z a ɾ f
احمق	a h m a ɢ
فیروزه	f i ɾ u z a
فهماندن	f a h m ɑː n d a n
شیمی	ʃ iː m iː
تصویب	t a s v i b
تشریح	t a ʃ ɾ e h
تنیس‌باز	t e n iː s b ɑː z
قندوز	ɢ o n d uː z
خوارزم	x ɑː ɾ a z m
مرز	m a ɾ z
انجمن	ʔ a n d͡ʒ o m a n
هنگ	h a n ɡ
انطاکیه	a n t ɑː k i j a
زوال	z a v ɑː l
برادر	b a ɾ ɑː d a ɾ
نهادی	n a h ɑː d iː
کوه	k oː h
خاص‌تر	x ɑː s t a ɾ
تمبر	t a m b ɾ
زندگی	z e n d e ɡ iː
خو	x o
مزه	m a z z a
همسده	h a m s e d a
اسبغول	e s b a ɢ uː l
ارزش	a ɾ z i ʃ
متضاد	m o t a z ɑː d
استراتژی	e s t ɾ ɑː t e ʒ iː
اسلوب	o s l uː b
نحو	n a h v
ریگستان	ɾ e ɡ i s t ɑː n
آنلاین	ɑː n l ɑː j n
مشق	m a ʃ ɢ
فارسی	f ɑː ɾ s iː
قدرتمند	ɢ u d ɾ a t m a n d
باستان	b ɑː s t ɑː n
قیمه	ɢ a j m a
ماساژ	m ɑː s ɑː ʒ
سه‌بعدی	s e b o ʔ d iː
نگار	n e ɡ ɑː ɾ
چاشت	t ʃ ɑː ʃ t
انقلابی	e n ɢ e l ɑː b iː
غسل	ɢ o s l
روح	ɾ uː h
تباه	t a b ɑː h
گمست	ɡ a m a s t
اسکندر	e s k a n d a ɾ
عشق	e ʃ ɢ
شنبه	ʃ a n b a
چرمه	t͡ʃ a ɾ m a
مشاهده	m o ʃ ɑː h a d e
پلان	p e l ɑː n
کرفس	k a ɾ a f s
نژادپرست	n e ʒ ɑː d p a ɾ a s t
زغال	z o ɢ ɑː l
خاور	x ɑː v a ɾ
حداکثر	h a d d i a k s a ɾ
همسایه	h a m s ɑː j a
نژادها	n e ʒ ɑː d h ɑː
سوت	s oː t
منفور	m a n f u ɾ
فوت	f a v t
پنیر	p a n i ɾ
داغ	d ɑː ɢ
تعداد	t e ʔ d ɑː d
بی‌نظیر	b e n a z i ɾ
لسان	l e s ɑː n
باغ	b ɑː ɢ
جنگجو	d͡ʒ a n ɡ d͡ʒ u
نورانی	n u ɾ ɑː n iː
فهم	f a h m
شوخی	ʃ oː x iː
اتصال	e t t e s ɑː l
برهنه‌گرا	b a ɾ a h n a ɡ a ɾ ɑː
تار	t ɑː ɾ
گفتن	ɡ o f t a n
مجروح	m a d͡ʒ ɾ uː h
آکندن	ʔ ɑː k a n d a n
رستن	ɾ o s t a n
اخبار	a x b ɑː ɾ
نظام	n e z ɑː m
شوروی	ʃ uː ɾ a v iː
تدریج	t a d ɾ i d͡ʒ
اهورامزدا	a h u ɾ ɑː m a z d ɑː
فریبا	f a ɾ e b ɑː
رایگان	ɾ ɑː j i ɡ ɑː n
ویدیو	v iː d iː j o
ظهور	z o h uː ɾ
جزدان	d͡ʒ o z d ɑː n
یافتن	j ɑː f t a n
اصیل	a s i l
جانباز	d͡ʒ ɑː m b ɑː z
بو	b oː
تغییرات	t a ɢ j iː ɾ ɑː t
عقرب	ʔ a ɢ ɾ a b
حرف	h a ɾ f
سپاه	s e p ɑː h
مسجد	m a s d͡ʒ i d
یگانه	j a ɡ ɑː n a
پولدار	p u l d ɑː ɾ
من	m a n
پایگاه	p ɑː j i ɡ ɑː h
پرسیدن	p o ɾ s iː d a n
عباء	a b ɑː
ارشد	a ɾ ʃ a d
برهمن	b a ɾ a h m a n
پیچ	p e t͡ʃ
جلوگیری	d͡ʒ e l o v ɡ iː ɾ iː
کنیسه	k a n i s a
نجومی	n o d͡ʒ uː m iː
ترازو	t a ɾ ɑː z uː
منوچهر	m a n u t͡ʃ e h ɾ
فوج	f a v d͡ʒ
بردار	b a ɾ d ɑː ɾ
پرسمان	p o r s e m ɑː n
شاخ	ʃ ɑ x
لهستان	l a h i s t ɑː n
مه	m a h
گرم	ɡ a ɾ m
پاک	p ɑː k
تخم	t o x m
جزیه	d͡ʒ e z j e
وارد	v ɑː ɾ e d
مس	m e s
گوز	ɡ a v z
ستان	e s t ɑː n
سوگ	s oː ɡ
نقره	n o ɢ ɾ e
یخچال	j a x t͡ʃ ɑː l
چنین	t ʃ o n iː n
باروت	b ɑː ɾ uː t
شور	ʃ oː ɾ
شک	ʃ ɑː k k
عربی	ʔ a ɾ a b iː
زراوند	z a ɾ ɑː v a n d
سطح	s a t h
زافه	z a f a
جهانگیر	d͡ʒ a h ɑː n ɡ iː ɾ
امکان	e m k ɑː n
میرزا	m e ɾ z ɑː
دفتر	d a f t a r
وطن‌پرست	v a t a n p a ɾ a s t
آلودن	ɑː l uː d a n
نفرت	n a f ɾ a t
مهربانی	m e h ɾ a b ɑː n iː
نقد	n a ɢ d
عجیب‌ترین	a d ʒ iː b t a ɾ iː n
زیستن	z i s t a n
تب	t a b
آرام	ɑː ɾ ɑː m
لشکر	l a ʃ k a ɾ
پاپوش	p ɑː p oː ʃ
زمین	z a m i n
داروشناس	d ɑː ɾ uː ʃ i n ɑː s
فرزندخوانده	f a ɾ z a n d x ɑː n d a
میغ	m e ɢ
ناچار	n ɑː t͡ʃ ɑː ɾ
زشتی	z e ʃ t iː
کیمیا	k iː m i j ɑː
حسینقلی	h o s e j n ɢ o l iː
مجسمه	m o d͡ʒ a s s a m e
مردان	m a ɾ d ɑː n
خلاف	x e l ɑː f
دو	d o
شیشه	ʃ i ʃ a
شباهت	ʃ a b ɑː h a t
صندلی	s a n d a l iː
زبان‌ها	z a b ɑː n h ɑː
گفتگو	ɡ o f t o ɡ uː j
آلرژی	ɑː l i ɾ ʒ iː
چمیدن	t͡ʃ a m i d a n
صنعت	s a n ʔ a t
مخصوص	m a x s u s
رسمی	ɾ a s m iː
برجسته	b a ɾ d͡ʒ a s t a
فرانسه	f a ɾ ɑː n s a
فاعل	f ɑː ʔ i l
آمیزش	ɑː m iː z e ʃ
لندن	l a n d a n
خویش	x e ʃ
کنار	k a n ɑː ɾ
پاکستانی	p ɑː k i s t ɑː n iː
کارورزی	k ɑː ɾ v a ɾ z iː
خور	x o ɾ
علف	ʔ a l a f
بوییدن	b uː j iː d a n
چون	t͡ʃ oː n
ابتکار	e b t e k ɑː ɾ
ابهام	e b h ɑː m
ارسطو	a ɾ a s t u
کینه	k iː n e
ارمنستان	a ɾ m a n i s t ɑː n
خالو	x ɑː l uː
نیایش	n i j ɑː j i ʃ
انگلیس	ʔ e n ɡ e l iː s
شجاعت	ʃ a d͡ʒ ɑ ʔ a t
شما	ʃ o m ɑː
رایانه	ɾ ɑː j ɑː n a
ستوان	s o t v ɑː n
چله	t ʃ e l e
پنهان	p e n h uː n
ختنه‌گاه	x a t n a ɡ ɑː h
اسفرزه	e s f a ɾ z e
توپولوژی	t o p o l o ʒ iː
اعتماد	e ʔ t e m ɑː d
خراب	x a ɾ ɑː b
شد	ʃ o d
خیس	x iː s
ذکر	z a k a ɾ
باره	b ɑː ɾ a
تعارف	t a ʔ ɑː ɾ u f
اختصار	e x t e s ɑː ɾ
گران	ɡ a ɾ ɑː n
مذهبی	m a z h a b iː
جواب‌ها	d ʒ a v ɑː b h ɑː
کود	k oː d
انداختن	a n d ɑː x t a n
یعنی	j a ʔ n iː
المزده	a l a m z a d e
آخر	ɑː x a ɾ
شو	ʃ o v
طبقه	t a b a ɢ a
قاضی	ɢ ɑː z iː
دویدن	d a v i d a n
میوه	m e v a
تسو	t a s u
سوزش	s oː z i ʃ
گماشتن	ɡ o m ɑː ʃ t a n
امتحان	e m t e h ɑː n
عنایت	ʔ e n ɑː j a t
فقیر	f a ɢ i ɾ
خودکار	x o d k ɑː ɾ
غیرت	ɢ e j ɾ a t
اتلاف	e t l ɑː f
بعث	b a ʔ s
تازه‌ترین	t ɑː z e t a ɾ iː n
دستور	d a s t u ɾ
ویرانه	v e ɾ ɑː n a
صابون	s ɑː b uː n
بیمه	b i m a
زوج	z a v d͡ʒ
حسن	h a s a n
ریشه	ɾ e ʃ a
خوشی	x o ʃ iː
رنگین	ɾ a n ɡ i n
خرداد	x o ɾ d ɑː d
نذل	n a z l
دول	d oː l
اسپغول	e s p a ɢ uː l
افسانه	a f s ɑː n a
ساعت	s ɑː ʔ a t
مشرقی	m a ʃ ɾ i ɢ iː
پاریس	p ɑː ɾ iː s
غزال	ɢ a z ɑː l
پرانتز	p a ɾ ɑː n t i z
خوفناک	x a v f n ɑː k
خاک	x ɑː k
قبول	ɢ a b u l
معنی	m a ʔ n iː
آنقدر	ɑː n ɢ a d ɾ
وحشی	v a h ʃ iː
ولایت	v e l ɑː j a t
ایران‌ویج	e ɾ ɑː n v e d͡ʒ
سیماب	s i m ɑː b
ارتش	a ɾ t i ʃ
تنبور	t a n b u ɾ
سمت	s a m t
ابری	ʔ a b ɾ iː
بری	b e ɾ e j
کهکشان	k a h k a ʃ ɑː n
نومد	n o v m a d
تمیزتر	t a m iː z t a ɾ
اشکال	a ʃ k ɑː l
پرسش	p o ɾ s e ʃ
نشاندن	n e ʃ ɑː n d a n
کوشش	k oː ʃ i ʃ
ایشان	e ʃ ɑː n
تعلیم	t a ʔ l i m
لله	l a l a
خریطه	x a ɾ i t a
دم	d a m
نمونه	n a m u n a
تخت	t a x t
بنگاه	b o n ɡ ɑː h
لبی	l a b iː
فضازمان	f a z ɑː z a m ɑː n
فاصله	f ɑː s i l a
سادگی	s ɑː d a ɡ iː
جمهوری	d͡ʒ o m h uː ɾ iː
ساحل	s ɑː h i l
تفاوت	t a f ɑː v u t
هلو	h o l uː
زئوس	z e uː s
خیریه	x a j ɾ i j j a
سفارش	s e f ɑː ɾ e ʃ
نیو	n e v
گاو	ɡ o o
باف	b ɑː f
خوشگل	x o ʃ ɡ e l
شرکت	ʃ e ɾ k a t
شنفتن	ʃ e n o f t a n
بفرمایید	b e f a ɾ m ɑː j iː d
مقاله	m a ɢ ɑː l a
استعداد	e s t e ʔ d ɑː d
آقا	ɑː ɢ ɑː
غمگین	ɢ a m ɡ iː n
درگاه	d a ɾ ɡ ɑː h
آزاد	ɑː z ɑː d
خوشحال	x o ʃ h ɑː l
درویش	d a ɾ v e ʃ
شکسته‌نستعلیق	ʃ e k a s t e n a s t a ʔ l iː ɢ
اجتماع	e d͡ʒ t e m ɑː ʔ
پیش	p e ʃ
کابلی	k ɑː b u l iː
مهمان	m e h m ɑː n
سقف	s a ɢ f
سختن	s o x t a n
سن	s e n
بیرونی	b e ɾ uː n iː
یمن	j a m a n
خوانش	x ɑː n e ʃ
دهقان	d e h ɢ ɑː n
شاهانشاه	ʃ ɑː h ɑː n ʃ ɑː h
گیتی	ɡ e t iː
وزارت	v a z ɑː ɾ a t
شریک	ʃ a ɾ i k
گرسنگی	ɡ o ɾ o s n e ɡ iː
نزدیک‌ترین	n a z d iː k t a ɾ iː n
ایدون	e d u n
دعوت	d a ʔ v a t
ابری‌ساز	ʔ a b ɾ iː s ɑː z
همنوع‌خواری	h a m n a v ʔ x ɑː ɾ iː
قلعه	ɢ a l ʔ a
کودکان	k uː d a k ɑː n
تا	t ɑː
اتم‌ها	a t o m h ɑː
زیبیدن	z e b i d a n
شبح	ʃ a b a h
جعفر	d͡ʒ a ʔ f a r
ژغار	ʒ a ɢ ɑː ɾ
بلبل	b o l b o l
سجستان	s a d͡ʒ a s t ɑː n
خیز	x e z
نجس‌ترین	n a d ʒ a s t a ɾ iː n
خیر	x a j ɾ
مایه	m ɑː j a
ناتوان	n ɑː t a v ɑː n
مقدس	m o ɢ a d d a s
مطبوعات	m a t b u ʔ ɑː t
خواننده	x ɑː n a n d a
تیهو	t i h s
اقلا	a ɢ a l l a n
چمن	t͡ʃ a m a n
ترشه	t o ɾ ʃ e
فضا	f a z ɑː
خاکستر	x ɑː k i s t a ɾ
انار	a n ɑː ɾ
آمارگر	ɑː m ɑː ɾ ɡ a ɾ
تصادف	t a s ɑː d u f
جلسه	d͡ʒ a l a s a
اندازه	a n d ɑː z a
درجه	d a ɾ a d͡ʒ a
نوع	n a v ʔ
ماهواره	m ɑː h v ɑː ɾ a
باز	b ɑː z
انتقام	e n t e ɢ ɑː m
بر	b a ɾ
پرورش	p a ɾ v a ɾ i ʃ
پنجشیر	p a n d͡ʒ ʃ e ɾ
خاقان	x ɑː ɢ ɑː n
غور	ɢ o v ɾ
چامه	t͡ʃ ɑː m a
دودل	d o d e l
خانقاه	x ɑː n ɢ ɑː h
جهاد	d͡ʒ e h ɑː d
گلاب	ɡ o l ɑː b
ارزشمند	a ɾ z i ʃ m a n d
ریز	ɾ e z
بارش	b ɑː ɾ i ʃ
هرگز	h a ɾ ɡ i z
خاکروبه	x ɑː k ɾ oː b a
فانوس	f ɑː n uː s
قلاووز	ɢ u l ɑː v uː z
امشب	e m ʃ a b
کر	k a ɾ
فروهر	f o ɾ uː h a ɾ
خوان	x ɑː n
خیابان	x i j ɑː b ɑː n
زمین‌شناسی	z a m i n ʃ i n ɑː s iː
اختیار	e x t i j ɑː ɾ
مهندسی	m o h a n d e s iː
فهرست	f e h ɾ e s t
برپا	b a ɾ p ɑː
شش	ʃ a ʃ
اطمینان	e t m iː n ɑː n
رشت	r o ʃ t
قدمت	ɢ i d m a t
توسعه	t a v s i ʔ a
قهوه‌خانه	ɢ a h v a x ɑː n a
رستوران‌ها	r e s t o ɾ ɑː n h ɑː
حاشیه	h ɑː ʃ i j a
شکم	ʃ e k a m
خوراک	x o ɾ ɑː k
ژرف	ʒ a ɾ f
مشغول	m a ʃ ɢ u l
قایق	ɢ ɑː j e ɢ
موج	m a v d͡ʒ
جانورشناسی	d͡ʒ ɑː n v a ɾ ʃ i n ɑː s iː
ماندن	m ɑː n d a n
چندین	t͡ʃ a n d i n
رونق	ɾ a v n a ɢ
هیچ‌وقت	e t͡ʃ v a ɢ t
صفحه	s a f h a
خات	x ɑː t
قزاق	ɢ a z z ɑː ɢ
طرف	t a ɾ a f
عراقچی	a ɾ ɑː ɢ t͡ʃ iː
شوهر	ʃ a v h a ɾ
جادو	d͡ʒ ɑː d uː
راحت	ɾ ɑː h a t
تابع	t ɑː b i ʔ
تمر	t a m u ɾ
تکوک	t a k oː k
فقر	f a ɢ ɾ
حلوا	h a l v ɑː
ژوپیتر	ʒ u p i t e ɾ
معالجه	m o ʔ ɑː l e d͡ʒ e
پرطرفدار	p o ɾ t a ɾ a f d ɑː ɾ
پنبه	p a m b e
شوید	ʃ e v iː d
کس	k a s
گلستان	ɡ o l e s t ɑː n
کفاش	k a f f ɑ ʃ
ناپدید	n ɑː p a d iː d
لزوماً	l o z uː m a n
آمدن	ɑː m a d a n
جامه‌دان	d͡ʒ ɑː m i d ɑː n
شیراز	ʃ e ɾ ɑː z
دستگاه	d a s t ɡ ɑː h
امت	o m m a t
خون	x u n
فاخره	f ɑː x i ɾ a
ذبح	z e b h
پیامک	p a j ɑː m a k
خزیدن	x a z i d a n
نصف	n e s f
معروف	m a ʔ ɾ u f
بین‌المللی	b a j n a l m i l a l iː
شادمان	ʃ ɑː d m ɑː n
منفی	m a n f iː
پنگان	p e n ɡ ɑː n
چاق	t͡ʃ ɑː ɢ
شاخه	ʃ ɑː x e
آزمودن	ɑː z m uː d a n
بنین	b e n iː n
حرکت	h a ɾ a k a t
دماغ	d a m ɑː ɢ
فراموشی	f a ɾ ɑː m oː ʃ iː
مرند	m a ɾ a n d
بعید	b a ʔ i d
خواندن	x ɑː n d a n
ضمیر	z a m i ɾ
اساتید	a s ɑː t iː d
بد	b a d
افسوس	a f s oː s
طاس	t ɑː s
سفارشی	s e f ɑː ɾ e ʃ iː
یاور	j ɑː v a ɾ
مدت	m o d d a t
باستان‌شناس	b ɑː s t ɑː n ʃ i n ɑː s
مخالف	m o x ɑː l e f
ضعیف	z a ʔ i f
بی‌صراط	b e s i ɾ ɑː t
شوربا	ʃ oː ɾ b ɑː
فرمانده	f a ɾ m ɑː n d i h
بابل	b ɑː b i l
حالا	h ɑː l ɑː
آمرزیدن	ɑː m u ɾ z iː d a n
منابع	m a n ɑː b i ʔ
زیباترین	z iː b ɑː t a ɾ iː n
بان	b ɑː n
بی‌عرضه	b e u ɾ z a
هوشیار	h oː ʃ j ɑː ɾ
بازوبند	b ɑː z uː b a n d
لوخن	l oː x a n
سالن	s ɑː l o n
گوناگون	ɡ u n ɑː ɡ u n
چی	t͡ʃ e
مصنوعی	m a s n u ʔ iː
اصل	a s l
چاه‌کور	t͡ʃ ɑː h k a v ɾ
باعث	b ɑː ʔ i s
پاداش	p ɑː d ɑː ʃ
پشتون	p a ʃ t uː n
صورتى	s u ɾ a t iː
خاص‌ترین	x ɑː s t a ɾ iː n
نغز	n a ɢ z
زحمت	z a h m a t
طمطراق	t o m t o ɾ ɑː ɢ
اسپریس	ʔ e s p a ɾ e s
تمساح	t e m s ɑː h
حاکم	h ɑː k i m
دولت	d a v l a t
ارس	a ɾ a s
کشیش	k a ʃ i ʃ
جسور	d͡ʒ a s u ɾ
قانونی	ɢ ɑː n uː n iː
چرا	t ʃ a ɾ ɑː
مسکه	m a s k a
انعکاس	e n ʔ e k ɑː s
نه	n o h
کردن	k a d a n
تازه	t ɑː z a
زیرسیگاری	z iː ɾ s iː ɡ ɑː ɾ iː
دین‌داری	d i n d ɑː ɾ iː
محبوب	m a h b u b
مغز	m a ɢ z
افیون	ʔ a f j uː n
دچار	d o t͡ʃ ɑː ɾ
قمر	ɢ a m a ɾ
هم‌جنس‌گرا	h a m d͡ʒ i n s ɡ a ɾ ɑː
آمیتیست	ɑː m iː t iː s t
لوترا	l u t a ɾ ɑː
زقاق	z o ɢ ɑː ɢ
چامه‌سرایی	t͡ʃ ɑː m a s a ɾ ɑː j iː
دوغ	d oː ɢ
بیرون	b e ɾ u n
گرختن	ɡ o ɾ e x t a n
چم	t͡ʃ a m
تابستان	t ɑː b i s t ɑː n
بازار	b ɑː z ɑː ɾ
گربسن	ɡ e r b e s a n
ماهور	m ɑː h uː ɾ
مشکل	m u ʃ k i l
توسط	t a v a s u t i
هجده	h a d͡ʒ d a h
بی‌سیم	b e s i m
گزیدن	ɡ a z i d a n
سیبویه	s i b u j a
نمایش	n a m ɑː j i ʃ
