etika	ˈʔ e t i k a
dagusdos	d a ɡ u s ˈd o s
pating	p a ˈt i ŋ
negro	ˈn e ɡ ɾ o
Ortea	ʔ o ɾ ˈt e a
Jara	ˈh a ɾ a
tangay	t a ˈŋ a j
obserbatoryo	ʔ o b s e ɾ b a ˈt o ɾ j o
ipagmayabang	ʔ i p a ɡ m a j a ˈb a ŋ
kilig	k i ˈl i ɡ
peyneta	p e j ˈn e t a
letmaku	ˈl e t m a k u
tagiktik	t a ɡ i k ˈt i k
Bernal	b e ɾ ˈn a l
Maristela	m a ɾ i s ˈt e l a
gulat	ˈɡ u l a t
anino	ʔ a ˈn i n o
lanunab	l a ˈn u n a b
santol	s a n ˈt o l
ene	ˈʔ e n e
kunat	ˈk u n a t
sangkatutak	s a ŋ k a ˈt u t a k
inam	ˈʔ i n a m
bilang	ˈb i l a ŋ
kisig	ˈk i s i ɡ
matiyaga	m a t j a ˈɡ a ʔ
rehente	ɾ e ˈh e n t e
agwahas	ʔ a ɡ ˈw a h a s
magatas	m a ˈɡ a t a s
Emma	ˈʔ e m a
Macalalad	m a k a ˈl a l a d
oryente	ʔ o ɾ ˈj e n t e
iset	ʔ i ˈs e t
estandarte	ʔ e s t a n ˈd a ɾ t e
tigmata	t i ɡ m a ˈt a
bagaso	b a ˈɡ a s o
Baluyot	b a ˈl u j o t
dengge	ˈd e ŋ ɡ e
Marulas	m a ɾ u ˈl a s
deretso	d e ˈɾ e t͡ʃ o
asog	ˈʔ a s o ɡ
tinedyer	t i ˈn e d j e ɾ
siyampu	s i ˈa m p u
Balmes	ˈb a l m e s
inugsukat	ʔ i n u ɡ ˈs u k a t
Collado	k o l ˈj a d o
warlahin	ˈw a ɾ l a h i n
sota	ˈs o t a
Pasamba	p a ˈs a m b a
Samar	ˈs a m a ɾ
masukal	m a ˈs u k a l
salsa	ˈs a l s a
dagasa	d a ɡ a ˈs a ʔ
itapat	ʔ i t a ˈp a t
kaligkig	k a l i ɡ ˈk i ɡ
siwang	ˈs i w a ŋ
halari	h a ˈl a ɾ i ʔ
kalihim	k a ˈl i h i m
madrama	m a ˈd ɾ a m a
salalay	s a ˈl a l a j
lalawigan	l a l a ˈw i ɡ a n
doktora	d o k ˈt o ɾ a
Ting	ˈt i ŋ
espongha	ʔ e s ˈp o ŋ h a
Aranda	ʔ a ˈɾ a n d a
pagalingin	p a ɡ a l i ˈŋ i n
balikatin	b a l i ˈk a t i n
Aquino	ʔ a ˈk i n o
alyado	ʔ a l ˈj a d o
pagbabalik	p a ɡ b a b a ˈl i k
kubtangkas	k u b t a ŋ ˈk a s
Kumiko	k u ˈm i k o
Sesus	s e ˈs u s
pamilyado	p a m i l ˈj a d o
budots	b u ˈd o t s
saklob	s a k ˈl o b
mayayabang	m a j a ˈj a b a ŋ
alahero	ʔ a l a ˈh e ɾ o
kabutihan	k a b u ˈt i h a n
nananamantala	n a n a n a m a n t a ˈl a
kaalit	k a ˈʔ a l i t
gawin	ɡ a ˈw i n
kingke	k i ŋ ˈk e
Geraldine	ˌd j e ɾ a l ˈd i n
karangalan	k a ɾ a ˈŋ a l a n
maso	ˈm a s o
kakabig	k a ˈk a b i ɡ
sapsuy	s a p ˈs u j
SK	ˈʔ e s k e j
analitika	ʔ a n a ˌl i t i ˈk a
dinuduguan	d i n u d u ɡ u ˈʔ a n
Alolod	ʔ a l o ˈl o d
wiski	ˈw i s k i
Yoshiko	j o ˈʃ i k o
Pamplona	p a m ˈp l o n a
Princess	ˈp ɾ i n s e s
lesbiyana	l e s b i ˈa n a
lukong	l u ˈk o ŋ
berdugo	b e ɾ ˈd u ɡ o
daspanin	ˈd a s p a n i n
umulan	ʔ u m u ˈl a n
Bermudez	b e ɾ ˈm u d e s
puna	p u ˈn a
salmo	ˈs a l m o
kasilyas	k a ˈs i l j a s
Ricardo	ɾ i ˈk a ɾ d o
sodiyako	s o ˈd i a k o
disiotso	d i s i ˈʔ o t͡ʃ o
bisitahin	b i s i ˈt a h i n
pilik	p i ˈl i k
protina	p ɾ o ˈt i n a
tagapamagitan	t a ɡ a p a m a ˈɡ i t a n
mawala	m a w a ˈl a ʔ
Montañez	m o n ˈt a ɲ e s
imbudo	ʔ i m ˈb u d o
Kalantiaw	k a l a n ˈt j a w
julalay	d͡ʒ u ˈl a l a j
bisa	ˈb i s a ʔ
kilos	ˈk i l o s
diko	ˈd i k o
magkuwenta	m a ɡ k u ˈe n t a
akto	ˈʔ a k t o
seks	ˈs e k s
ilot	ʔ i ˈl o t
gunimbilang	ɡ u n i m ˈb i l a ŋ
depende	d e ˈp e n d e
Michiko	m i ˈt͡ʃ i k o
anislag	ʔ a ˈn i s l a ɡ
lagayan	ˌl a ˈɡ a j a n
oposisyon	ʔ o p o s i s ˈj o n
yakyak	j a k ˈj a k
hagkan	h a ɡ ˈk a n
Olanda	ʔ o ˈl a n d a
Camarines	k a m a ˈɾ i n e s
linga	l i ˈŋ a
lumbay	l u m ˈb a j
Orejudos	ʔ o ɾ e ˈh u d o s
bobo	ˈb o b o
pamahaw	p a ˈm a h a w
Mutya	m u t ˈj a ʔ
magsimba	m a ɡ s i m ˈb a
Lanao	ˈl a n a w
ornitolohiya	ʔ o ɾ n i t o l o ˈh i a
medyebal	m e d j e ˈb a l
patol	ˈp a t o l
eskaparate	ʔ e s k a p a ˈɾ a t e
pipirmahan	p i p i ɾ m a ˈh a n
obligasyon	ʔ o b l i ɡ a s ˈj o n
grumadweyt	ɡ ɾ u ˈm a d w e j t
kargamento	k a ɾ ɡ a ˈm e n t o
Cacao	k a ˈk a w
makipot	m a ˈk i p o t
pirata	p i ˈɾ a t a
Ilokana	ʔ i l o ˈk a n a
mulinyari	m u l i n ˈj a ɾ i ʔ
Pilipinismo	p i l i p i ˈn i s m o
binasa	b i ˈn a s a
Villablanca	v i l j a ˈb l a n k a
kayat	ˈk a j a t
bilasa	b i l a ˈs a ʔ
silbiro	s i l ˈb i ɾ o
bigtiin	b i ɡ t i ˈʔ i n
sagot	s a ˈɡ o t
esmeralda	ʔ e s m e ˈɾ a l d a
lutad	l u ˈt a d
magbili	m a ɡ b i ˈl i
balatik	b a l a ˈt i k
hiwalay	h i w a ˈl a j
Rebanal	ɾ e b a ˈn a l
Huwebes	h u ˈe b e s
opisyales	ʔ o p i s ˈj a l e s
tsibog	t͡ʃ i ˈb o ɡ
medyas	ˈm e d j a s
kontralason	k o n t ɾ a ˈl a s o n
tuna	t u ˈn a ʔ
hustisya	h u s ˈt i s j a
Kristiyano	k ɾ i s t i ˈa n o
Hehoba	h e ˈh o b a
Siason	ˈs j a s o n
dehado	d e ˈh a d o
bisyo	ˈb i s j o
dagos	ˈd a ɡ o s
iwang	ˈʔ i w a ŋ
sabila	ˈs a b i l a
pasulo	p a ˈs u l o
pano	ˈp a n o
trabahadora	t ɾ a b a h a ˈd o ɾ a
nagkukuwento	n a ɡ k u k u ˈe n t o
balnisukat	b a l n i ˈs u k a t
masaktan	m a s a k ˈt a n
bulilyaso	b u l i l ˈj a s o
pilibustero	p i l i b u s ˈt e ɾ o
pakyaw	p a k ˈj a w
Laude	ˈl a w d e
hatsing	h a ˈt͡ʃ i ŋ
putak	p u ˈt a k
lawulta	l a w u l ˈt a
maambunan	m a ʔ a m b u ˈn a n
kuminoy	k u m i ˈn o j
imoralidad	ʔ i m o ɾ a l i ˈd a d
ganire	ɡ a n i ˈɾ e
magbilad	m a ɡ b i ˈl a d
banggit	b a ŋ ˈɡ i t
dumungaw	d u ˈm u ŋ a w
adres	ˈʔ a d ɾ e s
dinsol	d i n ˈs o l
Maloles	m a ˈl o l e s
rin	ˈɾ i n
kaliko	k a ˈl i k o
katarungan	k a t a ˈɾ u ŋ a n
Kuniko	k u ˈn i k o
sulit	ˈs u l i t
tonsura	t o n ˈs u ɾ a
iso	ˈʔ i s o
Medrano	m e d ˈɾ a n o
ngipin	ˈŋ i p i n
fotobam	ˈf o t o b a m
nagpapaubaya	n a ɡ p a p a ʔ u ˈb a j a ʔ
sila	s i ˈl a
Korean	k o ˈɾ i a n
tuyo	t u ˈj o ʔ
Monje	ˈm o ŋ h e
liing	l i ˈʔ i ŋ
wilik	ˈw i l i k
ulunan	ʔ u l u ˈn a n
irekomenda	ʔ i ɾ e k o m e n ˈd a
bumabahing	b u m a b a ˈh i ŋ
bilingguwal	b i l i ŋ ɡ u ˈa l
balbon	b a l ˈb o n
sanlibutan	s a n l i b u ˈt a n
magmadali	m a ɡ m a d a ˈl i ʔ
Gupit	ɡ u ˈp i t
sagupa	s a ˈɡ u p a ʔ
palasimba	p a l a s i m ˈb a
Igorot	ʔ i ɡ o ˈɾ o t
senyal	s e n ˈj a l
masiba	m a ˈs i b a ʔ
kustomer	ˈk u s t o m e ɾ
Magallanes	m a ɡ a l ˈj a n e s
subalit	s u ˈb a l i t
aguha	ʔ a ˈɡ u h a
Closa	ˈk l o s a
iba	ʔ i ˈb a
talibas	t a l i ˈb a s
gunaw	ˈɡ u n a w
letrina	l e t ˈɾ i n a
Salva	ˈs a l v a
N	ʔ e n
lohiko	ˈl o h i k o
burak	ˈb u ɾ a k
sementado	s e m e n ˈt a d o
gobernador	ɡ o b e ɾ n a ˈd o ɾ
inspektor	ʔ i n s p e k ˈt o ɾ
pinapagtawanan	p i ˌn a p a ɡ t a w a ˈn a n
Gubat	ˈɡ u b a t
sangat	ˈs a ŋ a t
tapon	ˈt a p o n
sumite	s u m i ˈt e
dalawit	d a ˈl a w i t
balasto	b a ˈl a s t o
guyabano	ɡ u j a ˈb a n o
polyeto	p o l ˈj e t o
tsokolate	t͡ʃ o k o ˈl a t e
emosyon	ʔ e m o s ˈj o n
utilitarismo	ʔ u t i l i t a ˈɾ i s m o
bagsakan	b a ɡ ˈs a k a n
tinikling	t i n i k ˈl i ŋ
simana	s i ˈm a n a
yano	ˈj a n o
dagasdas	d a ɡ a s ˈd a s
lumuklok	l u m u k ˈl o k
sakal	s a ˈk a l
raan	ˈɾ a ʔ a n
eto	ˈʔ e t o
balut	b a ˈl u t
palangiti	p a l a ŋ i ˈt i ʔ
turista	t u ˈɾ i s t a
usisain	ʔ u s i ˈs a ʔ i n
pararayos	ˌp a ɾ a ˈɾ a j o s
panrelihiyon	p a n ɾ e l i h i ˈo n
reptil	ɾ e p ˈt i l
pulupito	p u ˈl u p i t o
ambubuyog	ʔ a m b u ˈb u j o ɡ
Pesigan	p e ˈs i ɡ a n
sabak	ˈs a b a k
dagim	d a ˈɡ i m
sinehan	s i n e ˈh a n
layo	ˈl a j o ʔ
dini	ˈd i n i
albahaka	ʔ a l b a ˈh a k a
apak	ˈʔ a p a k
bulakbol	b u l a k ˈb o l
lubaw	ˈl u b a w
pasasalamat	p a s a s a ˈl a m a t
magparami	m a ɡ p a ˈɾ a m i
bitak	b i ˈt a k
uranyo	ʔ u ˈɾ a n j o
gitling	ɡ i t ˈl i ŋ
malalakas	m a l a l a ˈk a s
singsing	s i ŋ ˈs i ŋ
himagsik	h i m a ɡ ˈs i k
bayad	ˈb a j a d
molave	m o ˈl a v e
asiwa	ʔ a s i ˈw a ʔ
Basallote	b a s a l ˈj o t e
peymuth	ˈp e j m u θ
kabaretista	k a b a ɾ e ˈt i s t a
lakwatsera	l a k w a ˈt͡ʃ e ɾ a
perspektibo	p e ɾ s p e k ˈt i b o
distansiya	d i s ˈt a n s j a
kabulagsakan	k a b u l a ɡ s a ˈk a n
gumaling	ɡ u m a ˈl i ŋ
pangko	p a ŋ ˈk o
April	ˈʔ e j p ɾ i l
Javier	h a v i ˈe ɾ
tabatsingtsing	t a b a ˈt͡ʃ i ŋ t͡ʃ i ŋ
asa	ˈʔ a s a
Lupa	ˈl u p a ʔ
Marte	ˈm a ɾ t e
manananim	ˌm a n a n a ˈn i m
magulat	m a ˈɡ u l a t
palya	p a l ˈj a
tipaklong	t i p a k ˈl o ŋ
kuya	ˈk u j a
kugita	k u ˈɡ i t a ʔ
tulog	ˈt u l o ɡ
sibika	ˌs i b i ˈk a
lang	ˈl a ŋ
Ala	ʔ a ˈl a
cato	k a ˈt o
Gallardo	ɡ a l ˈj a ɾ d o
batubalani	b a t u b a ˈl a n i ʔ
purgatoryo	p u ɾ ɡ a ˈt o ɾ j o
terminal	ˌt e ɾ m i ˈn a l
banos	ˈb a n o s
lungaw	l u ˈŋ a w
baitang	b a ʔ i ˈt a ŋ
walo	w a ˈl o
tuso	ˈt u s o
bituka	b i ˈt u k a
kalinggalan	k a l i ŋ ɡ a ˈl a n
Marinduque	m a ɾ i n ˈd u k e
haligutgot	h a l i ɡ u t ˈɡ o t
ragsak	ɾ a ɡ ˈs a k
abnormalidad	ʔ a b n o ɾ m a l i ˈd a d
pakikipagchat	p a k i k i p a ɡ ˈt͡ʃ a t
semantika	s e ˌm a n t i ˈk a
brodkast	ˈb ɾ o d k a s t
buryong	b u ɾ ˈj o ŋ
upahan	ʔ u ˈp a h a n
dalubhayupan	d a ˌl u b h a ˈj u p a n
Majayjay	m a h a j ˈh a j
Layco	ˈl a j k o
Singgapur	s i ŋ ɡ a ˈp u ɾ
dutaan	d u ˈt a ʔ a n
paskuwa	ˈp a s k u a
NAWASA	n a ˈw a s a
peluka	p e ˈl u k a
makikitid	m a k i ˈk i t i d
likaw	ˈl i k a w
batia	b a t i ˈa ʔ
kamatis	k a ˈm a t i s
Jalandoni	h a l a n ˈd o n i
palay	ˈp a l a j
tsismis	ˈt͡ʃ i s m i s
Magbuhat	m a ɡ ˈb u h a t
baniaga	b a n ˈj a ɡ a ʔ
aninag	ʔ a ˈn i n a ɡ
dekorasyon	d e k o ɾ a s ˈj o n
Jurado	h u ˈɾ a d o
pilyo	ˈp i l j o
matitibay	m a t i ˈt i b a j
Dagupan	d a ˈɡ u p a n
lentehas	l e n ˈt e h a s
dinagipik	d i n a ˈɡ i p i k
buwagin	b u a ˈɡ i n
rakitis	ɾ a ˈk i t i s
kabisera	k a b i ˈs e ɾ a
tutok	ˈt u t o k
wis	ˈw i s
dalubtala	d a ˌl u b ˈt a l a ʔ
eksorsismo	ʔ e k s o ɾ ˈs i s m o
pudpod	p u d ˈp o d
suplay	s u p ˈl a j
Asyano	ʔ a s ˈj a n o
nobyo	ˈn o b j o
paepek	p a ʔ e ˈp e k
bini	ˈb i n i ʔ
tutubi	t u t u ˈb i
Segui	ˈs e ɡ i
ostrasismo	ʔ o s t ɾ a ˈs i s m o
responsable	ɾ e s p o n ˈs a b l e
salba	s a l ˈb a
engrande	ʔ e ŋ ˈɡ ɾ a n d e
sapupuhin	s a p u ˈp u h i n
lakip	ˈl a k i p
butanding	b u t a n ˈd i ŋ
aksiyon	ʔ a k s i ˈo n
mabalang	m a ˈb a l a ŋ
ilap	ʔ i ˈl a p
dabaw	ˈd a b a w
kyut	ˈk j u t
duhambindahon	d u h a m b i n ˈd a h o n
Nobuhisa	n o b u ˈh i s a
Ruedas	ɾ u ˈe d a s
Montemayor	m o n t e m a ˈj o ɾ
ekselensiya	ʔ e k s e ˈl e n s j a
makaramdam	m a k a ɾ a m ˈd a m
gumuwapo	ɡ u m u ˈa p o
Campo	ˈk a m p o
puwas	p u ˈa s
Bolivar	b o ˈl i v a ɾ
pagatasan	p a ɡ a ˈt a s a n
okra	ˈʔ o k ɾ a
kabaktan	k a b a k ˈt a n
kabalyo	k a ˈb a l j o
obsesyon	ʔ o b s e s ˈj o n
manloloko	m a n l o ˈl o k o
Juana	h u ˈa n a
maaari	m a ʔ a ˈʔ a ɾ i ʔ
Misamis	m i ˈs a m i s
mamuhay	m a ˈm u h a j
hilaw	h i ˈl a w
kurakot	k u ˈɾ a k o t
Dimapilis	d i m a ˈp i l i s
galagala	ɡ a l a ɡ a ˈl a
kordero	k o ɾ ˈd e ɾ o
mapansin	m a p a n ˈs i n
sindakin	s i n d a ˈk i n
latundan	l a t u n ˈd a n
mangangaso	m a ŋ a ˈŋ a s o
tangina	t a ŋ i ˈn a
mas	ˈm a s
garapata	ɡ a ɾ a ˈp a t a
mainsekto	m a ʔ i n ˈs e k t o
mayuldumo	m a j u l ˈd u m o
borbeg	ˈb o ɾ b e ɡ
pantalon	p a n t a ˈl o n
lubo	ˈl u b o ʔ
talungtong	t a l u ŋ ˈt o ŋ
ateismo	ʔ a t e ˈi s m o
entero	ʔ e n ˈt e ɾ o
dibdib	d i b ˈd i b
bigtihin	b i ɡ t i ˈh i n
pagdaan	p a ɡ d a ˈʔ a n
pagkabigo	p a ɡ k a b i ˈɡ o ʔ
Maunahan	m a ʔ u ˈn a h a n
lona	ˈl o n a
kaanib	k a ˈʔ a n i b
bulyaw	b u l ˈj a w
dantaon	d a n t a ˈʔ o n
tonta	ˈt o n t a
alilis	ʔ a l i ˈl i s
tanghal	t a ŋ ˈh a l
soli	ˈs o l i ʔ
Munsayac	m u n s a ˈj a k
pastilyas	p a s ˈt i l j a s
taympers	ˈt a j m p e ɾ s
sandalo	ˈs a n d a l o
gamutin	ɡ a m u ˈt i n
Hinduismo	h i n d u ˈi s m o
ostiya	ˈʔ o s t j a
matwiran	m a t ˈw i ɾ a n
Malaluan	m a l a ˈl u ʔ a n
Caparas	k a p a ˈɾ a s
bokya	ˈb o k j a ʔ
urang	ˈʔ u ɾ a ŋ
barberya	b a ɾ b e ɾ ˈj a
Sariaya	s a ɾ ˈj a j a
kendo	ˈk e n d o
papagtalunan	ˌp a p a ɡ t a ˈl u n a n
magkausap	m a ɡ k a ˈʔ u s a p
Babao	ˈb a b a w
LL	ˈʔ e l j e
Rosete	ɾ o ˈs e t e
kotamaya	k o t a ˈm a j a
iha	ˈʔ i h a
impluwensiya	ʔ i m p l u ˈe n s j a
biyopisika	b i o ˈp i s i k a
Karunungan	k a ɾ u ˈn u ŋ a n
organista	ʔ o ɾ ɡ a ˈn i s t a
masilya	m a ˈs i l j a
tangke	t a ŋ ˈk e
inidoro	ʔ i n i ˈd o ɾ o
ebakwasyon	ʔ e b a k w a s ˈj o n
Tupa	ˈt u p a
padyak	p a d ˈj a k
alandahaw	ʔ a l a n ˈd a h a w
salang	ˈs a l a ŋ
idroheno	ʔ i ˈd ɾ o h e n o
Chedeng	ˈt͡ʃ e d e ŋ
kadiri	k a ˈd i ɾ i
inampalan	ʔ i n a m ˈp a l a n
Enero	ʔ e ˈn e ɾ o
nagdedeliryo	n a ɡ d e d e ˈl i ɾ j o
abuhin	ʔ a b u ˈh i n
Dazo	ˈd a z o
panlinis	p a n ˈl i n i s
rambol	ˈɾ a m b o l
maako	m a ʔ a ˈk o
alalahanin	ʔ a l a l a ˈh a n i n
limay	ˈl i m a j
tilos	ˈt i l o s
mahikaw	m a ˈh i k a w
biyolohiya	b i o l o ˈh i a
parusa	p a ˈɾ u s a
bansot	b a n ˈs o t
krimen	ˈk ɾ i m e n
elektrisista	ʔ e l e k t ɾ i ˈs i s t a
gawangan	ɡ a ˈw a ŋ a n
Hayag	ˈh a j a ɡ
repormista	ɾ e p o ɾ ˈm i s t a
bibliyoteka	b i b l i o ˈt e k a
empleado	ʔ e m p l e ˈa d o
simetriya	s i m e t ˈɾ i a
haltak	h a l ˈt a k
sino	ˈs i n o
siyopaw	s i ˈo p a w
pambihira	p a m b i ˈh i ɾ a ʔ
mamutla	m a m u t ˈl a ʔ
timbulog	t i m ˈb u l o ɡ
tanghali	t a ŋ ˈh a l i ʔ
ow	ˈʔ o w
korapsiyon	k o ɾ a p s i ˈo n
lithaw	l i t ˈh a w
manood	m a n o ˈʔ o d
seradura	s e ɾ a ˈd u ɾ a
korni	ˈk o ɾ n i
banas	b a ˈn a s
halabos	h a l a ˈb o s
Batangueña	b a t a ŋ ˈɡ e n j a
danumsigwasan	d a n u m s i ɡ ˈw a s a n
Surigao	s u ɾ i ˈɡ a w
anghit	ʔ a ŋ ˈh i t
palapatik	p a l a ˈp a t i k
tumitingala	t u m i t i ŋ a ˈl a ʔ
Fung	ˈf u ŋ
be	ˈb e
tsok	ˈt͡ʃ o k
yakyakin	j a k j a ˈk i n
yumamot	j u m a ˈm o t
kuhol	k u ˈh o l
luwa	l u ˈa ʔ
alternatibo	ʔ a l t e ɾ n a ˈt i b o
limusina	l i m u ˈs i n a
paligsa	p a l i ɡ ˈs a
yate	ˈj a t e
pananambang	p a n a n a m ˈb a ŋ
sakate	s a ˈk a t e
bigting	b i ɡ ˈt i ŋ
ngakngak	ŋ a k ˈŋ a k
lagap	l a ˈɡ a p
duwag	d u ˈa ɡ
maputik	m a ˈp u t i k
layaw	ˈl a j a w
binhi	b i n ˈh i ʔ
madamo	m a d a ˈm o
lagkit	l a ɡ ˈk i t
depensibo	d e p e n ˈs i b o
agwa	ˈʔ a ɡ w a
apdo	ʔ a p ˈd o
eksperimento	ʔ e k s p e ɾ i ˈm e n t o
masalimuot	m a s a l i ˈm u ʔ o t
Ochoa	ʔ o ˈt͡ʃ o a
kuyaw	ˈk u j a w
bibingka	b i ˈb i ŋ k a
lambayog	l a m ˈb a j o ɡ
Naujan	n a ʔ u ˈh a n
Cortez	k o ɾ ˈt e s
sugadagitban	s u ɡ a d a ɡ i t ˈb a n
Banal	b a ˈn a l
pasukan	p a s u ˈk a n
pinuno	p i ˈn u n o ʔ
polbo	ˈp o l b o
maagap	m a ˈʔ a ɡ a p
burahin	b u ɾ a ˈh i n
pamilyaridad	p a m i l j a ɾ i ˈd a d
setro	ˈs e t ɾ o
J	d j e j
Vigan	ˈv i ɡ a n
iring	ˈʔ i ɾ i ŋ
koteho	k o ˈt e h o
hungkag	h u ŋ ˈk a ɡ
Garcia	ɡ a ɾ ˈs i a
organismo	ʔ o ɾ ɡ a ˈn i s m o
teleolohiya	t e l e o l o ˈh i a
Quintos	ˈk i n t o s
pundasyon	p u n d a s ˈj o n
oranggutan	ʔ o ˈɾ a ŋ ɡ u t a n
magsapatos	m a ɡ s a ˈp a t o s
tungki	t u ŋ ˈk i ʔ
biluslawas	b i l u s ˈl a w a s
Marife	m a ɾ i ˈf e
'y	j
agulo	ʔ a ˈɡ u l o
tagigapay	t a ɡ i ɡ a ˈp a j
Artiaga	ʔ a ɾ t i ˈa ɡ a
kapsula	ˈk a p s u l a
dekwatin	ˈd e k w a t i n
lata	ˈl a t a
Zamora	z a ˈm o ɾ a
literatura	l i t e ɾ a ˈt u ɾ a
paglilitis	p a ɡ l i ˈl i t i s
mabilis	m a b i ˈl i s
tagmangga	t a ɡ m a ŋ ˈɡ a
Biring	b i ˈɾ i ŋ
emyenda	ʔ e m ˈj e n d a
Cabungcal	k a b u ŋ ˈk a l
reyalista	ɾ e a ˈl i s t a
utitab	ʔ u ˈt i t a b
guham	ɡ u ˈh a m
walumpu	w a l u m ˈp u ʔ
kantutin	k a n t u ˈt i n
dolar	ˈd o l a ɾ
laspag	l a s ˈp a ɡ
Irlanda	ʔ i ɾ ˈl a n d a
Adlawan	ʔ a d ˈl a w a n
banayad	b a ˈn a j a d
kabukiran	k a b u ˈk i ɾ a n
subtitulo	s u b ˈt i t u l o
bahagan	b a h a ˈɡ a n
dahop	d a ˈh o p
sawing	s a ˈw i ŋ
lalamunan	l a l a ˈm u n a n
sebekoy	ˌs e ˈb e k o j
medalya	m e ˈd a l j a
pasiya	p a s i ˈa
despedida	d e s p e ˈd i d a
rosaryo	ɾ o ˈs a ɾ j o
pukyutan	p u k ˈj u t a n
sukdulan	s u k ˈd u l a n
Lascano	l a s ˈk a n o
Betty	ˈb e t i
lupagi	l u p a ˈɡ i ʔ
trilyon	t ɾ i l ˈj o n
Tayao	ˈt a j a w
Cadapan	k a ˈd a p a n
palintong	p a l i n ˈt o ŋ
sidlan	s i d ˈl a n
tabi	t a ˈb i
lupog	l u ˈp o ɡ
Marquez	m a ɾ ˈk e s
umaakyat	ʔ u m a ʔ a k ˈj a t
Mamburao	m a m b u ˈɾ a w
Clemente	k l e ˈm e n t e
rehas	ˈɾ e h a s
padyama	p a d ˈj a m a
higante	h i ˈɡ a n t e
tekwan	ˈt e k w a n
melodiya	m e l o ˈd i a
abangan	ˌʔ a ˈb a ŋ a n
magbababoy	m a ɡ b a b a ˈb o j
pagkakaisa	p a ɡ k a k a ʔ i ˈs a
akit	ˈʔ a k i t
Lumad	ˈl u m a d
punyeta	p u n ˈj e t a
butot	b u ˈt o t
ma	m a
okasyon	ʔ o k a s ˈj o n
burol	b u ˈɾ o l
pumanig	p u ˈm a n i ɡ
liyabe	l i ˈa b e
halumigmig	h a l u m i ɡ ˈm i ɡ
lako	ˈl a k o ʔ
ineng	ʔ i ˈn e ŋ
magtipid	m a ɡ t i ˈp i d
sisihan	s i s i ˈh a n
tagahanga	t a ɡ a ˈh a ŋ a ʔ
nagandahan	n a ɡ a n d a ˈh a n
Miraflores	m i ɾ a f ˈl o ɾ e s
aktibista	ʔ a k t i ˈb i s t a
Oliveros	ʔ o l i ˈv e ɾ o s
malapot	m a ˈl a p o t
gahasa	ɡ a ˈh a s a ʔ
nanamantala	n a n a m a n t a ˈl a
kamandag	k a m a n ˈd a ɡ
ragat	ˈɾ a ɡ a t
hunyango	h u n ˈj a ŋ o ʔ
bara	b a ˈɾ a
lisa	l i ˈs a ʔ
gumimik	ɡ u ˈm i m i k
buang	b u ˈʔ a ŋ
Hung	ˈh u ŋ
panday	p a n ˈd a j
oso	ˈʔ o s o
malisya	m a ˈl i s j a
Lumibao	l u ˈm i b a w
lugar	l u ˈɡ a ɾ
ya	j a
tingni	t i ŋ ˈn i
abelyana	ʔ a b e l ˈj a n a
ekskomunikado	ʔ e k s k o m u n i ˈk a d o
inggitero	ʔ i ŋ ɡ i ˈt e ɾ o
Mandaluyong	m a n d a ˈl u j o ŋ
salagimsim	s a l a ɡ i m ˈs i m
manirahan	m a n i ˈɾ a h a n
pagerper	ˌp a ˈɡ e ɾ p e ɾ
bilauo	b i ˈl a w o
denggoy	ˈd e ŋ ɡ o j
luwad	l u ˈa d
Decena	d e ˈs e n a
H	ˈʔ e j t͡ʃ
pagkabata	p a ɡ k a ˈb a t a ʔ
klaro	ˈk l a ɾ o
impormal	ʔ i m p o ɾ ˈm a l
tigbuhol	t i ɡ b u ˈh o l
restitusyon	ɾ e s t i t u s ˈj o n
Nicolas	n i k o ˈl a s
mahinhin	m a h i n ˈh i n
trabyesa	t ɾ a b ˈj e s a
aikido	ʔ a j ˈk i d o
tagarito	t a ɡ a ˈɾ i t o
palaisipan	p a ˌl a ʔ i s i ˈp a n
eskarlata	ʔ e s k a ɾ ˈl a t a
Magcawas	m a ɡ ˈk a w a s
kupal	ˈk u p a l
ingklitik	ʔ i ŋ ˈk l i t i k
magyaya	m a ɡ ˈj a j a ʔ
kuwadrilyon	k u a d ɾ i l ˈj o n
iskul	ʔ i s ˈk u l
batad	b a ˈt a d
sutla	s u t ˈl a ʔ
traidor	t ɾ a j ˈd o ɾ
kristo	ˈk ɾ i s t o
relasyon	ɾ e l a s ˈj o n
Piñon	p i ˈɲ o n
almirol	ʔ a l m i ˈɾ o l
taliwakas	t a l i w a ˈk a s
lamasin	l a ˈm a s i n
dismayado	d i s m a ˈj a d o
pispis	p i s ˈp i s
gamot	ɡ a ˈm o t
ahon	ˈʔ a h o n
alusitha	ʔ a l u s i t ˈh a ʔ
hasain	h a ˈs a ʔ i n
lityo	ˈl i t j o
bakawan	b a ˈk a w a n
mangubra	m a ŋ u b ˈɾ a
pinabulaanan	p i n a b u l a ˈʔ a n a n
tabatsing	t a ˈb a t͡ʃ i ŋ
sibasib	s i ˈb a s i b
magdagdag	m a ɡ d a ɡ ˈd a ɡ
Catapang	k a ˈt a p a ŋ
hibang	h i ˈb a ŋ
masuwerte	m a s u ˈe ɾ t e
mangomisyon	m a ŋ o m i s ˈj o n
putok	p u ˈt o k
maghalili	m a ɡ h a l i ˈl i
mainggitin	m a ʔ i ŋ ˈɡ i t i n
gumuho	ɡ u ˈm u h o ʔ
lipstik	ˈl i p s t i k
irebisa	ʔ i ɾ e b i ˈs a
estranghero	ʔ e s t ɾ a ŋ ˈh e ɾ o
sapiro	ˈs a p i ɾ o
mangagat	m a ŋ a ˈɡ a t
makalima	m a ˈk a l i m a
Nagtalon	n a ɡ ˈt a l o n
kawayanan	k a w a j a ˈn a n
umawat	ʔ u ˈm a w a t
sagubang	s a ɡ u ˈb a ŋ
Sanchez	ˈs a n t͡ʃ e s
bihod	ˈb i h o d
Despuig	d e s p u ˈi ɡ
misis	ˈm i s i s
bango	b a ˈŋ o
hayop	ˈh a j o p
Soledad	s o l e ˈd a d
mapurol	m a p u ˈɾ o l
talupak	t a ˈl u p a k
sulapid	s u ˈl a p i d
Ho	ˈh o
pagkakasakit	p a ɡ k a k a s a ˈk i t
panahinga	p a n a ˈh i ŋ a
balon	b a ˈl o n
lumamig	l u m a ˈm i ɡ
echas	ˈʔ e t͡ʃ a s
Corpus	ˈk o ɾ p u s
salapid	s a l a ˈp i d
datung	d a ˈt u ŋ
antala	ʔ a n ˈt a l a
Eden	ʔ e ˈd e n
lagong	ˈl a ɡ o ŋ
saya	s a ˈj a
bertdey	ˈb e ɾ t d e j
tagulamin	t a ɡ u l a ˈm i n
halungkat	h a l u ŋ ˈk a t
Cu	ˈk u
salik	ˈs a l i k
Cabiao	k a b ˈj a w
kabata	k a ˈb a t a ʔ
mananayaw	m a n a ˈn a j a w
kwenta	ˈk w e n t a
uway	ʔ u ˈa j
bumatak	b u ˈm a t a k
timpi	t i m ˈp i ʔ
heologo	h e ˈo l o ɡ o
katay	ˈk a t a j
Tiongco	t i ˈo ŋ k o
kasoy	k a ˈs o j
hilaga	h i ˈl a ɡ a ʔ
ayoko	ʔ a ˈj o k o
Manalo	m a ˈn a l o
tulad	ˈt u l a d
kamyas	k a m ˈj a s
maarte	m a ˈʔ a ɾ t e
alugin	ʔ a l u ˈɡ i n
bukana	b u ˈk a n a
eksihensiya	ʔ e k s i ˈh e n s j a
balabal	b a ˈl a b a l
gawan	ɡ a ˈw a n
gaong	ˈɡ a ʔ o ŋ
akwaryum	ʔ a k ˈw a ɾ j u m
hawig	h a ˈw i ɡ
Nelson	ˈn e l s o n
habonero	h a b o ˈn e ɾ o
konsumido	k o n s u ˈm i d o
uyom	ˈʔ u j o m
lilok	ˈl i l o k
kasero	k a ˈs e ɾ o
patnugot	p a t ˈn u ɡ o t
ᜊ	b a ˈb a ʔ
dapithapon	ˌd a p i t ˈh a p o n
Daisuke	d a j ˈs u k e
rehistro	ɾ e ˈh i s t ɾ o
matatauhan	m a t a t a ˈʔ u h a n
sundin	s u n ˈd i n
parinlas	p a ˈɾ i n l a s
sandugo	s a n d u ˈɡ o ʔ
destabilisasyon	d e s t a b i l i s a s ˈj o n
kumpensasyon	k u m p e n s a s ˈj o n
tanggap	t a ŋ ˈɡ a p
Liwag	ˈl i w a ɡ
sawil	s a ˈw i l
milenyal	m i ˈl e n j a l
suweter	s u ˈe t e ɾ
sagimuymoy	s a ɡ i m u j ˈm o j
bubog	ˈb u b o ɡ
Ebanghelyo	ʔ e b a ŋ ˈh e l j o
maunlad	m a ʔ u n ˈl a d
erpats	ˈʔ e ɾ p a t s
manipis	m a n i ˈp i s
Namayan	n a ˈm a j a n
daplis	d a p ˈl i s
Carunungan	k a ɾ u ˈn u ŋ a n
pahinante	p a h i ˈn a n t e
Espino	ʔ e s ˈp i n o
orasyon	ʔ o ɾ a s ˈj o n
magyasyas	m a ɡ j a s ˈj a s
heodesya	h e o ˈd e s j a
Suansing	s u a n ˈs i ŋ
tulag	t u ˈl a ɡ
Maniquiz	m a n i ˈk i s
Manilenya	m a n i ˈl e n j a
disposisyon	d i s p o s i s ˈj o n
Sarenas	s a ˈɾ e n a s
ninuno	n i ˈn u n o ʔ
Malanday	m a l a n ˈd a j
tiwasay	t i w a ˈs a j
pilit	p i ˈl i t
Allison	ˈʔ a l i s o n
malakas	m a l a ˈk a s
labaha	l a ˈb a h a
mananakay	m a n a ˈn a k a j
sapul	s a ˈp u l
panuntunan	p a n u n ˈt u n a n
kitse	k i ˈt͡ʃ e
sakto	ˈs a k t o
magulo	m a ɡ u ˈl o
lilipad	l i l i ˈp a d
suki	ˈs u k i ʔ
nakakabwisit	n a k a k a ˈb w i s i t
ipakita	ʔ i p a ˈk i t a
Guevarra	ɡ e ˈv a ɾ a
Mabato	m a b a ˈt o
mantala	m a n t a ˈl a
Alvaro	ˈʔ a l v a ɾ o
konyak	k o n ˈj a k
betis	ˈb e t i s
duweto	d u ˈe t o
tabon	ˈt a b o n
yangga	j a ŋ ˈɡ a ʔ
kolehiyal	k o l e h i ˈa l
lisan	ˈl i s a n
yumurak	j u ˈm u ɾ a k
lipa	l i ˈp a
mawasak	m a ˈw a s a k
reengkarnasyon	ɾ e ʔ e ŋ k a ɾ n a s ˈj o n
talos	t a ˈl o s
ibabaan	ʔ i b a b a ˈʔ a n
Kapitan	k a p i ˈt a n
bumagyo	b u m a ɡ ˈj o
Haw	ˈh a w
Danesa	d a ˈn e s a
datiles	ˌd a t i ˈl e s
nakabibingi	n a k a b i b i ˈŋ i
Hernandez	ʔ e ɾ ˈn a n d e s
impilya	ʔ i m ˈp i l j a
melokoton	m e l o k o ˈt o n
haya	ˈh a j a ʔ
Katigbak	k a t i ɡ ˈb a k
mama	ˈm a m a ʔ
Alberto	ʔ a l ˈb e ɾ t o
mabulaklak	m a b u l a k ˈl a k
kartamoneda	k a ɾ t a m o ˈn e d a
kartesyano	ˌk a ɾ t e s ˈj a n o
Leyte	ˈl e j t e
gagi	ˈɡ a ɡ i ʔ
Maranaw	m a ɾ a ˈn a w
asnan	ʔ a s ˈn a n
mabagyo	m a b a ɡ ˈj o
platon	p l a ˈt o n
ibahin	ʔ i b a ˈh i n
inupas	ʔ i ˈn u p a s
tampalpuki	t a m p a l ˈp u k i
bungkugan	b u ŋ ˈk u ɡ a n
bulalayak	ˌb u l a l a ˈj a k
bulyos	b u l ˈj o s
kalima	k a l i ˈm a
kurot	k u ˈɾ o t
Gabaldon	ɡ a b a l ˈd o n
propagandista	p ɾ o p a ɡ a n ˈd i s t a
tagisuyo	t a ɡ i ˈs u j o ʔ
pintor	p i n ˈt o ɾ
batchoy	b a ˈt͡ʃ o j
tambuli	t a m ˈb u l i ʔ
dibdibin	d i b d i ˈb i n
lungkag	l u ŋ ˈk a ɡ
makipagtalik	m a k i p a ɡ ˈt a l i k
libang	l i ˈb a ŋ
tampay	t a m ˈp a j
limahi	l i m a ˈh i ʔ
komplikasyon	k o m p l i k a s ˈj o n
kausap	k a ˈʔ u s a p
tambanggalan	t a m b a ŋ ɡ a ˈl a n
mangamote	m a ŋ a ˈm o t e
talangka	t a l a ŋ ˈk a ʔ
kloropormo	k l o ɾ o ˈp o ɾ m o
aberya	ʔ a b e ɾ ˈj a
chaka	t͡ʃ a ˈk a ʔ
laguslos	l a ɡ u s ˈl o s
umiintindi	ʔ u m i ʔ i n t i n ˈd i
alog	ʔ a ˈl o ɡ
tanawan	t a ˈn a w a n
pitsel	p i ˈt͡ʃ e l
tiktiko	t i k ˈt i k o ʔ
balatong	b a ˈl a t o ŋ
Triviño	t ɾ i ˈv i ɲ o
mulinilyo	m u l i ˈn i l j o
tagiliran	t a ɡ i ˈl i ɾ a n
Haponesa	h a p o ˈn e s a
balinsasayaw	b a ˌl i n s a s a ˈj a w
tinga	t i ˈŋ a
lintik	l i n ˈt i k
dukwangin	d u k w a ˈŋ i n
mahalaga	m a h a l a ˈɡ a
elepante	ʔ e l e ˈp a n t e
bulsa	b u l ˈs a
kubil	k u ˈb i l
Tagaytay	t a ɡ a j ˈt a j
halayhay	h a l a j ˈh a j
lantong	l a n ˈt o ŋ
talohimig	t a l o ˈh i m i ɡ
babaero	b a b a ˈʔ e ɾ o
diyesmo	d i ˈe s m o
biguin	b i ɡ u ˈʔ i n
dote	ˈd o t e
publiko	ˈp u b l i k o
pondohan	p o n d o ˈh a n
samat	ˈs a m a t
Summer	ˈs a m e ɾ
ermita	ʔ e ɾ ˈm i t a
gansal	ɡ a n ˈs a l
monopolyo	m o n o ˈp o l j o
takuri	t a k u ˈɾ i ʔ
dalubtao	d a ˌl u b ˈt a ʔ o
gilib	ɡ i ˈl i b
takong	t a ˈk o ŋ
tonelada	t o n e ˈl a d a
Shohei	ˈs j o h e j
kanal	k a ˈn a l
pasa	p a ˈs a
lawlaw	l a w ˈl a w
limampu	l i m a m ˈp u ʔ
Arnaiz	ʔ a ɾ ˈn a ʔ i s
panloob	p a n ˈl o ʔ o b
manghihipo	m a ŋ h i ˈh i p o ʔ
Saavedra	s a ʔ a ˈv e d ɾ a
atribido	ʔ a t ɾ i ˈb i d o
pitundaan	p i t u n d a ˈʔ a n
Asistio	ʔ a ˈs i s t j o
mangopya	m a ˈŋ o p j a
riyesgo	ɾ i ˈe s ɡ o
mamolitika	m a m o ˈl i t i k a
kaberdehan	k a ˈb e ɾ d e h a n
bakong	ˈb a k o ŋ
Zafra	ˈz a f ɾ a
enerhiya	ʔ e n e ɾ ˈh i a
Solano	s o ˈl a n o
mesa	ˈm e s a
eskapularyo	ʔ e s k a p u ˈl a ɾ j o
manlibak	m a n l i ˈb a k
radikal	ɾ a d i ˈk a l
trabahador	t ɾ a b a h a ˈd o ɾ
rotasyon	ɾ o t a s ˈj o n
badap	b a ˈd a p
laklak	l a k ˈl a k
balita	b a ˈl i t a ʔ
lagislis	l a ɡ i s ˈl i s
Arabe	ʔ a ɾ a ˈb e
diyaryo	d i ˈa ɾ j o
ibabaw	ʔ i ˈb a b a w
mapanira	m a p a ˈn i ɾ a ʔ
isakay	ʔ i s a ˈk a j
suhol	ˈs u h o l
palasyo	p a ˈl a s j o
lubid	ˈl u b i d
talukbong	t a l u k ˈb o ŋ
malabnaw	m a l a b ˈn a w
kalumbahin	k a l u m b a ˈh i n
Turkmenistan	t u ɾ k m e n i s ˈt a n
tabaw	ˈt a b a w
Ormoc	ʔ o ɾ ˈm o k
luwang	l u ˈa ŋ
ligo	ˈl i ɡ o ʔ
labandera	l a b a n ˈd e ɾ a
kanino	k a ˈn i n o
Datu	ˈd a t u
miswa	ˈm i s w a
Megumi	m e ˈɡ u m i
kongkreto	k o ŋ ˈk ɾ e t o
trosohan	t ɾ o s o ˈh a n
gikla	ɡ i k ˈl a ʔ
nino	ˈn i n o
teista	t e ˈi s t a
lasinggera	l a s i ŋ ˈɡ e ɾ a
nanananghalian	n a n a n a ŋ h a ˈl i ʔ a n
banyos	b a n ˈj o s
endoso	ʔ e n ˈd o s o
dagta	d a ɡ ˈt a ʔ
magdaos	p a ɡ ˈd a ʔ o s
alak	ˈʔ a l a k
sasapnan	s a s a p ˈn a n
holdap	ˈh o l d a p
tinig	ˈt i n i ɡ
Manahan	m a ˈn a h a n
mahumaling	m a h u m a ˈl i ŋ
jepoy	ˈd͡ʒ e p o j
Magbuhos	m a ɡ ˈb u h o s
yagong	ˈj a ɡ o ŋ
Tupas	ˈt u p a s
lunday	l u n ˈd a j
iglesya	ʔ i ɡ ˈl e s j a
saktan	s a k ˈt a n
udon	ˈʔ u d o n
utdo	ʔ u t ˈd o
milagro	m i ˈl a ɡ ɾ o
banyas	b a n ˈj a s
hangad	h a ˈŋ a d
mulkaphay	m u l k a p ˈh a j
gusgos	ɡ u s ˈɡ o s
partisipasyon	p a ɾ t i s i p a s ˈj o n
tema	ˈt e m a
Wong	ˈw o ŋ
liyempo	l i ˈe m p o
dilikas	d i l i ˈk a s
ligwan	l i ɡ ˈw a n
konektado	k o n e k ˈt a d o
Borlaza	b o ɾ ˈl a z a
hatiin	h a ˈt i ʔ i n
guya	ˈɡ u j a ʔ
barkilyos	b a ɾ ˈk i l j o s
pisan	ˈp i s a n
propesora	p ɾ o p e ˈs o ɾ a
pangyari	p a ŋ ˈj a ɾ i
kukis	ˈk u k i s
Ubalde	ʔ u ˈb a l d e
pribilehiyo	p ɾ i b i ˈl e h i o
agkap	ʔ a ɡ ˈk a p
sakramento	s a k ɾ a ˈm e n t o
balakyot	b a l a k ˈj o t
tunggak	t u ŋ ˈɡ a k
lingguwista	l i ŋ ɡ u ˈi s t a
palarindingan	p a l a ɾ i n ˈd i ŋ a n
masaker	ˈm a s a k e ɾ
Agapay	ʔ a ˈɡ a p a j
Mayon	m a ˈj o n
Salandanan	s a l a n ˈd a n a n
lumutang	l u ˈm u t a ŋ
mutsatso	m u ˈt͡ʃ a t͡ʃ o
Mañalac	m a ˈɲ a l a k
katol	k a ˈt o l
klinik	ˈk l i n i k
aakyat	ʔ a ʔ a k ˈj a t
kuwenta	k u ˈe n t a
makatarungan	m a k a t a ˈɾ u ŋ a n
saranggola	s a ɾ a ŋ ˈɡ o l a
biskonde	b i s ˈk o n d e
pantomina	ˌp a n t o ˈm i n a
Hesus	h e ˈs u s
pasayahin	p a s a j a ˈh i n
bulo	b u ˈl o ʔ
maghari	m a ɡ ˈh a ɾ i ʔ
tributaryo	t ɾ i b u ˈt a ɾ j o
kaliitan	k a l i ʔ i ˈt a n
probinsiyana	p ɾ o b i n s i ˈa n a
kampanya	k a m ˈp a n j a
korupsiyon	k o ɾ u p s i ˈo n
lakre	ˈl a k ɾ e
tugi	t u ˈɡ i ʔ
oraryo	ʔ o ˈɾ a ɾ j o
ligamento	l i ɡ a ˈm e n t o
taluiryap	t a l u ʔ i ɾ ˈj a p
malambot	m a l a m ˈb o t
Alabat	ʔ a l a ˈb a t
abolisyon	ʔ a b o l i s ˈj o n
Epipanya	ʔ e p i ˈp a n j a
peste	ˈp e s t e
kabuwanan	k a b u ˈa n a n
maglalaway	m a ɡ l a l a ˈw a j
kasalukuyan	k a s a l u ˈk u j a n
Indiyano	ʔ i n d i ˈa n o
magwahil	m a ɡ w a ˈh i l
varyant	ˈv a ɾ j a n t
magsuot	m a ɡ s u ˈʔ o t
pusakal	p u s a ˈk a l
detalye	d e ˈt a l j e
yuko	j u ˈk o ʔ
humatsing	h u m a ˈt͡ʃ i ŋ
sarsaparilya	s a ɾ s a p a ˈɾ i l j a
Osaka	ʔ o ˈs a k a
David	ˈd e j v i d
gusilaw	ɡ u ˈs i l a w
bansalagin	b a n s a l a ˈɡ i n
makuha	m a ˈk u h a
Buhain	b u ˈh a ʔ i n
lambot	l a m ˈb o t
palagi	p a ˈl a ɡ i ʔ
balana	ˈb a l a n a
mababangis	m a b a b a ˈŋ i s
bangkiling	b a ŋ k i ˈl i ŋ
yabangan	j a b a ˈŋ a n
Elorde	ʔ e ˈl o ɾ d e
ligta	l i ɡ ˈt a ʔ
Jasmine	ˈd͡ʒ a s m i n
laga	ˈl a ɡ a ʔ
alimuran	ʔ a l i m u ˈɾ a n
Ylagan	ʔ i ˈl a ɡ a n
praning	p ɾ a ˈn i ŋ
pabor	p a ˈb o ɾ
sugapa	s u ˈɡ a p a ʔ
lambing	l a m ˈb i ŋ
italiko	ʔ i ˈt a l i k o
kurus	k u ˈɾ u s
drama	ˈd ɾ a m a
dagsa	d a ɡ ˈs a ʔ
magiting	m a ˈɡ i t i ŋ
tapak	ˈt a p a k
pagandahin	p a ɡ a n d a ˈh i n
balnikapnayan	b a l n i k a p ˈn a j a n
walwal	w a l ˈw a l
okey	ˈʔ o k e j
saysay	s a j ˈs a j
patola	p a ˈt o l a
lodi	ˈl o d i
maliw	ˈm a l i w
ulbo	ʔ u l ˈb o ʔ
dagison	d a ˈɡ i s o n
Leyson	ˈl e j s o n
Garces	ˈɡ a ɾ s e s
obhetibismo	ʔ o b h e t i ˈb i s m o
katastrope	k a ˈt a s t ɾ o p e
Hizon	ˈh i z o n
anakroniko	ʔ a n a k ˌɾ o n i ˈk o
nagnanakaw	n a ɡ n a ˈn a k a w
pananawagan	p a n a n a ˈw a ɡ a n
Montenegro	m o n t e ˈn e ɡ ɾ o
sumingaw	s u m i ˈŋ a w
kerosin	ˌk e ɾ o ˈs i n
tigis	ˈt i ɡ i s
mamaya	m a m a ˈj a ʔ
koponan	k o p o ˈn a n
ibigay	ʔ i b i ˈɡ a j
magusot	m a ɡ u ˈs o t
pusaw	p u ˈs a w
amaranto	ʔ a m a ˈɾ a n t o
pangangailangan	p a ŋ a ŋ a ʔ i ˈl a ŋ a n
manulat	m a ˈn u l a t
pagong	p a ˈɡ o ŋ
hane	h a ˈn e
Banaag	b a ˈn a ʔ a ɡ
hadlang	h a d ˈl a ŋ
tsek	ˈt͡ʃ e k
umayos	ʔ u ˈm a j o s
pasigan	p a ˈs i ɡ a n
maningil	m a n i ˈŋ i l
Baquiran	b a ˈk i ɾ a n
magkasakit	m a ɡ k a s a ˈk i t
limahid	l i ˈm a h i d
gamusa	ɡ a ˈm u s a
tuma	ˈt u m a
Irlandesa	ʔ i ɾ l a n ˈd e s a
leopardo	l e o ˈp a ɾ d o
imperatibo	ʔ i m p e ɾ a ˈt i b o
Aragon	ʔ a ɾ a ˈɡ o n
Romana	ɾ o ˈm a n a
basar	b a ˈs a ɾ
kabila	k a b i ˈl a ʔ
vendo	ˈv e n d o
gumawa	ɡ u m a ˈw a ʔ
Aplasca	ʔ a p ˈl a s k a
alibutran	ʔ a l i b u t ˈɾ a n
birtud	b i ɾ ˈt u d
latay	ˈl a t a j
Kurisma	k u ˈɾ i s m a
akrostik	ʔ a k ˈɾ o s t i k
Kurita	k u ˈɾ i t a
ani	ˈʔ a n i
uhod	ˈʔ u h o d
Tindoc	t i n ˈd o k
tumawag	t u ˈm a w a ɡ
mayaw	ˈm a j a w
tenga	ˈt e ŋ a
Mabulo	m a ˈb u l o
iskolarsyip	ʔ i s ˈk o l a ɾ s j i p
Disyembre	d i s ˈj e m b ɾ e
kahoy	ˈk a h o j
suwerte	s u ˈe ɾ t e
talikakas	t a l i k a ˈk a s
anghang	ʔ a ŋ ˈh a ŋ
klabos	ˈk l a b o s
radyo	ˈɾ a d j o
Peñaflorida	p e ɲ a f l o ˈɾ i d a
yeso	ˈj e s o
Acuña	ʔ a ˈk u ɲ a
nguso	ˈŋ u s o ʔ
Odeste	ʔ o ˈd e s t e
pulpol	p u l ˈp o l
lapastanganin	l a p a s t a ˈŋ a n i n
samo	ˈs a m o ʔ
sigwasan	s i ɡ ˈw a s a n
silinyador	s i l i n j a ˈd o ɾ
demokrasya	d e m o ˈk ɾ a s j a
mutya	m u t ˈj a ʔ
silidkulay	s i ˌl i d k u ˈl a j
hamak	ˈh a m a k
panghalip	p a ŋ h a ˈl i p
iskandalo	ʔ i s ˈk a n d a l o
sulid	ˈs u l i d
maggiba	m a ɡ ɡ i ˈb a ʔ
tuldik	t u l ˈd i k
piskalya	p i s k a l ˈj a
basagulero	b a s a ɡ u ˈl e ɾ o
taksan	t a k ˈs a n
umisod	ʔ u ˈm i s o d
Manaoag	m a ˈn a w a ɡ
hapunan	h a ˈp u n a n
magaanan	m a ɡ a ʔ a ˈn a n
ulnukalnangin	ʔ u l n u k a l n a ˈŋ i n
Bajado	b a ˈh a d o
letson	l e ˈt͡ʃ o n
alangan	ʔ a l a ˈŋ a n
Bravo	ˈb ɾ a v o
ipatapon	ʔ i p a ˈt a p o n
andaderas	ʔ a n d a ˈd e ɾ a s
saksakin	s a k s a ˈk i n
muwi	ˈm u i ʔ
Pederio	p e ˈd e ɾ j o
pangkagawaran	p a ŋ k a ɡ a w a ˈɾ a n
tosino	t o ˈs i n o
kunsumisyon	k u n s u m i s ˈj o n
talulot	t a ˈl u l o t
ipadala	ʔ i p a d a ˈl a
kadalahiraan	k a d a l a h i ˈɾ a ʔ a n
tiple	ˈt i p l e
gabay	ɡ a ˈb a j
singkad	s i ŋ ˈk a d
peryodista	p e ɾ j o ˈd i s t a
mahuli	m a ˈh u l i
mangjumbag	m a ŋ ˈd͡ʒ u m b a ɡ
cno	ˈs i n o
Montecillo	m o n t e ˈs i l j o
kepo	ˈk e p o
antot	ʔ a n ˈt o t
Eguia	ʔ e ˈɡ i a
singki	s i ŋ ˈk i ʔ
paraluman	p a ɾ a ˈl u m a n
ugnay	ʔ u ɡ ˈn a j
bahid	ˈb a h i d
magbutas	m a ɡ b u ˈt a s
tribu	ˈt ɾ i b u
seleksiyon	s e l e k s i ˈo n
namnam	n a m ˈn a m
dagdag	d a ɡ ˈd a ɡ
kuwadro	k u ˈa d ɾ o
pagsasaka	p a ɡ s a ˈs a k a
ahas	ˈʔ a h a s
madrasta	m a d ˈɾ a s t a
negosyo	n e ˈɡ o s j o
kalahok	k a l a ˈh o k
lubak	l u ˈb a k
Yabut	ˈj a b u t
Bolbok	b o l ˈb o k
panuwelo	p a n u ˈe l o
nabuwisit	n a b u ˈi s i t
boba	ˈb o b a
maimot	m a ˈʔ i m o t
taimtim	t a ʔ i m ˈt i m
timbanin	t i m ˈb a n i n
ugaw	ʔ u ˈɡ a w
deskaril	d e s k a ˈɾ i l
alitaptap	ʔ a l i t a p ˈt a p
Nacpil	n a k ˈp i l
tahure	ˈt a h u ɾ e
patipati	p a t i ˈp a t i
gaya	ˈɡ a j a
Lo	ˈl o
Makaw	m a ˈk a w
Amelia	ʔ a ˈm i l j a
bigo	b i ˈɡ o ʔ
limon	l i ˈm o n
integral	ʔ i n t e ɡ ˈɾ a l
Canoy	ˈk a n o j
manamit	m a n a ˈm i t
hapit	ˈh a p i t
Keiko	ˈk e j k o
Pagdanganan	p a ɡ d a ˈŋ a n a n
Hupiter	ˈh u p i t e ɾ
pagnanakaw	p a ɡ n a ˈn a k a w
maalamat	m a ʔ a l a ˈm a t
q	ˈk j u
intimidasyon	ʔ i n t i m i d a s ˈj o n
tekas	ˈt e k a s
lingming	l i ŋ ˈm i ŋ
pinirmahan	p i n i ɾ m a ˈh a n
kuro	ˈk u ɾ o ʔ
abat	ʔ a ˈb a t
tao	ˈt a ʔ o
seko	ˈs e k o
labandero	l a b a n ˈd e ɾ o
Sobrepeña	s o b ɾ e ˈp e ɲ a
bigti	b i ɡ ˈt i
Hamayka	h a ˈm a j k a
malutong	m a l u ˈt o ŋ
senador	s e n a ˈd o ɾ
agnostiko	ʔ a ɡ ˈn o s t i k o
lansangan	l a n ˈs a ŋ a n
Guerra	ˈɡ e ɾ a
Salgado	s a l ˈɡ a d o
Fandiño	f a n ˈd i ɲ o
molestahin	m o ˌl e s t a ˈh i n
laguyo	l a ˈɡ u j o ʔ
empirisismo	ˌʔ e m p i ɾ i ˈs i s m o
Aprika	ˈʔ a p ɾ i k a
Sagitaryo	s a ɡ i ˈt a ɾ j o
Maribel	m a ɾ i ˈb e l
kibit	k i ˈb i t
ipaayos	ʔ i p a ˈʔ a j o s
bako	b a ˈk o ʔ
radyasyon	ɾ a d j a s ˈj o n
masiyasip	m a s i ˈa s i p
gatilyo	ɡ a ˈt i l j o
Naomi	n a ˈj o w m i
taludtod	t a l u d ˈt o d
alimpuyo	ʔ a l i m p u ˈj o
Sicat	ˈs i k a t
kabituinan	k a b i t u ʔ i ˈn a n
linggatong	l i ŋ ˈɡ a t o ŋ
lapit	ˈl a p i t
orihinal	ʔ o ɾ i h i ˈn a l
mawsoleo	m a w s o ˈl e o
humigit	h u m i ˈɡ i t
sigwada	s i ɡ ˈw a d a
agapay	ʔ a ˈɡ a p a j
sistema	s i s ˈt e m a
bahagdan	b a h a ɡ ˈd a n
Abulencia	ʔ a b u ˈl e n s j a
usong	ˈʔ u s o ŋ
duwende	d u ˈe n d e
sulatan	s u ˈl a t a n
Bayot	ˈb a j o t
arwa	ʔ a ɾ ˈw a ʔ
bukid	ˈb u k i d
Manaog	m a ˈn a ʔ o ɡ
bungaw	b u ˈŋ a w
sibsib	s i b ˈs i b
iyelo	ʔ i ˈe l o
dumaigdig	d u m a ʔ i ɡ ˈd i ɡ
labintador	l a b i n t a ˈd o ɾ
propesyonalismo	p ɾ o p e s j o n a ˈl i s m o
sasakyan	s a s a k ˈj a n
manukan	m a ˈn u k a n
Carreon	k a ɾ e ˈo n
tako	ˈt a k o
uwak	ʔ u ˈa k
alahado	ʔ a l a ˈh a d o
Binubusan	b i n u ˈb u s a n
talukab	t a ˈl u k a b
Setsuko	s e t ˈs u k o
Cabanatuan	k a b a n a ˈt u ʔ a n
sibuyas	s i ˈb u j a s
kantot	k a n ˈt o t
utas	ʔ u ˈt a s
sining	ˈs i n i ŋ
benesyana	b e n e s ˈj a n a
kusing	k u ˈs i ŋ
sus	ˈs u s
palabasa	p a l a b a ˈs a
letsugas	l e ˈt͡ʃ u ɡ a s
panganan	p a ˈŋ a n a n
lamog	l a ˈm o ɡ
s	ʔ e s
sunuran	ˌs u ˈn u ɾ a n
primo	ˈp ɾ i m o
bangaw	ˈb a ŋ a w
Grace	ˈɡ ɾ e j s
boto	ˈb o t o
ebolusyon	ʔ e b o l u s ˈj o n
humagulhol	h u m a ɡ u l ˈh o l
Lakan	l a ˈk a n
tsarera	t͡ʃ a ˈɾ e ɾ a
maghimagsik	m a ɡ h i m a ɡ ˈs i k
aborsiyon	ʔ a ˌb o ɾ s ˈj o n
punongkahoy	ˌp u n o ŋ ˈk a h o j
senadora	s e n a ˈd o ɾ a
payak	p a ˈj a k
marmol	m a ɾ ˈm o l
Cenizal	s e n i ˈz a l
Libra	ˈl i b ɾ a
Hapones	h a p o ˈn e s
historikal	h i s t o ɾ i ˈk a l
Kho	ˈk o
abandonado	ʔ a b a n d o ˈn a d o
labaw	ˈl a b a w
Bulan	ˈb u l a n
Pedregal	p e d ɾ e ˈɡ a l
tayamutam	t a j a ˈm u t a m
tanan	t a ˈn a n
salaan	s a l a ˈʔ a n
uliuli	ʔ u l i ˈʔ u l i
ko	k o
dagundong	d a ɡ u n ˈd o ŋ
artipisyal	ʔ a ɾ t i p i s ˈj a l
Tumacder	t u ˈm a k d e ɾ
aswang	ʔ a s ˈw a ŋ
obaryo	ʔ o ˈb a ɾ j o
baat	b a ˈʔ a t
siyantung	s i ˈa n t u ŋ
apresyasyon	ʔ a p ɾ e s ˈj a s j o n
senakulo	s e ˈn a k u l o
gulumihan	ɡ u l u ˈm i h a n
kardbord	ˈk a ɾ d b o ɾ d
tibag	t i ˈb a ɡ
kasapuwego	k a s a p u ˈe ɡ o
prangko	ˈp ɾ a ŋ k o
anyaya	ʔ a n ˈj a j a
nabubuwisit	n a b u b u ˈi s i t
boksing	ˈb o k s i ŋ
kalaliman	k a l a ˈl i m a n
editoryal	ʔ e d i t o ɾ ˈj a l
inaabisuhan	ʔ i n a ʔ a b i ˈs u h a n
awtor	ʔ a w ˈt o ɾ
maoy	m a ˈʔ o j
lagpas	l a ɡ ˈp a s
magigi	m a ˈɡ i ɡ i ʔ
beses	ˈb e s e s
rupok	ɾ u ˈp o k
kodigo	ˈk o d i ɡ o
biskuwit	b i s k u ˈi t
lagundi	l a ɡ u n ˈd i ʔ
Gumaca	ɡ u ˈm a k a
tiboom	t i ˈb u m
kaniyugan	k a n i ˈu ɡ a n
mangalunya	m a ˈŋ a l u n j a ʔ
Barayuga	b a ɾ a ˈj u ɡ a
arakibot	ʔ a ˈɾ a k i b o t
metodo	ˈm e t o d o
abiso	ʔ a ˈb i s o
kutsada	k u ˈt͡ʃ a d a
banlaw	b a n ˈl a w
parlamentaryo	p a ɾ l a m e n ˈt a ɾ j o
daluhaka	d a l u ˈh a k a ʔ
solipsismo	s o l i p ˈs i s m o
sebo	ˈs e b o
Manalastas	m a n a l a s ˈt a s
ikanga	ʔ i ˈk a ŋ a ʔ
Ty	t i
helikopter	h e l i ˈk o p t e ɾ
sapantaha	s a p a n ˈt a h a ʔ
kana	k a ˈn a ʔ
silog	s i ˈl o ɡ
hardin	h a ɾ ˈd i n
kinakastigo	k i n a k a s ˈt i ɡ o
tsikot	t͡ʃ i ˈk o t
Suan	ˈs w a n
kategorikal	k a t e ɡ o ɾ i ˈk a l
tikoy	ˈt i k o j
dara	d a ˈɾ a
Inglesero	ʔ i ŋ ɡ l e ˈs e ɾ o
mambuwisit	m a m b u ˈi s i t
kakampink	k a k a m ˈp i n k
Dee	d i
ngani	ˈŋ a n i ʔ
manguna	m a ˈŋ u n a
dupa	d u ˈp a ʔ
pangkat	p a ŋ ˈk a t
yangyang	j a ŋ ˈj a ŋ
saniban	s a ˈn i b a n
Barangka	b a ɾ a ŋ ˈk a ʔ
busilak	b u ˈs i l a k
espesyalista	ʔ e s p e s j a ˈl i s t a
timayok	t i ˈm a j o k
hinliliit	h i n l i l i ˈʔ i t
balaglawas	b a l a ɡ ˈl a w a s
maglaway	m a ɡ l a ˈw a j
BSP	ˌb i ʔ e s ˈp i
kapre	ˈk a p ɾ e
sotanghon	ˈs o t a ŋ h o n
bilas	b i ˈl a s
Kiamzon	k i ˈa m s o n
suriso	s u ˈɾ i s o
Zosimo	ˈz o s i m o
Isabang	ʔ i ˈs a b a ŋ
manghawa	m a ŋ ˈh a w a
balas	b a ˈl a s
pampanitikan	p a m ˈp a n i t i k a n
hoy	ˈh o j
Tien	ˈt j e n
bakli	b a k ˈl i ʔ
apula	ʔ a ˈp u l a ʔ
panggang	p a ŋ ˈɡ a ŋ
adhika	ʔ a d h i ˈk a ʔ
maburol	ˌm a ˈb u ɾ o l
dapal	ˈd a p a l
kakawati	k a k a ˈw a t i
personal	p e ɾ s o ˈn a l
simulasyon	s i m u l a s ˈj o n
patag	ˈp a t a ɡ
deskumpiyado	d e s k u m p i ˈa d o
Tarnate	t a ɾ ˈn a t e
pamahalaan	ˌp a m a h a l a ˈʔ a n
pakikiramay	p a k i k i ˈɾ a m a j
rehistrador	ɾ e h i s t ɾ a ˈd o ɾ
tsarter	ˈt͡ʃ a ɾ t e ɾ
tinapa	t i n a ˈp a
balbakwa	b a l b a k ˈw a
maging	m a ˈɡ i ŋ
depinisyon	d e p i n i s ˈj o n
binibini	b i n i ˈb i n i
inskripsiyon	ʔ i n s k ɾ i p s i ˈo n
Sumadsad	s u ˈm a d s a d
lalaki	l a ˈl a k i
paliguan	ˈp a l i ɡ u ʔ a n
ibinigay	ʔ i b i n i ˈɡ a j
butigan	b u t i ˈɡ a n
buyo	ˈb u j o
lamod	ˈl a m o d
kauntian	k a ʔ u n t i ˈʔ a n
organisado	ʔ o ɾ ɡ a n i ˈs a d o
lubang	ˈl u b a ŋ
durog	d u ˈɾ o ɡ
soltada	s o l ˈt a d a
palanggana	p a l a ŋ ˈɡ a n a
bugaw	ˈb u ɡ a w
Contreras	k o n ˈt ɾ e ɾ a s
ugaga	ʔ u ˈɡ a ɡ a ʔ
hikayat	h i ˈk a j a t
paminta	p a m i n ˈt a
rekluta	ɾ e k ˈl u t a
tahan	ˈt a h a n
ponema	p o ˈn e m a
panggatong	p a ŋ ˈɡ a t o ŋ
peklat	ˈp e k l a t
abla	ˈʔ a b l a
lansang	l a n ˈs a ŋ
muhala	m u ˈh a l a ʔ
dunong	ˈd u n o ŋ
Togo	ˈt o ɡ o
hangganan	h a ŋ ˈɡ a n a n
hitik	h i ˈt i k
saloy	ˈs a l o j
soberaniya	s o b e ɾ a ˈn i a
sandaigdigan	s a n d a ʔ i ɡ ˈd i ɡ a n
paksa	p a k ˈs a ʔ
manawagan	m a n a ˈw a ɡ a n
mabulas	m a ˈb u l a s
korea	k o ˈɾ e a
Zoraida	z o ˈɾ a j d a
Kankanaey	k a n k a ˈn a ʔ e j
hagap	ˈh a ɡ a p
salig	ˈs a l i ɡ
Malibiran	m a l i ˈb i ɾ a n
lanting	l a n ˈt i ŋ
tumpa	t u m ˈp a
minsanan	m i n ˈs a n a n
heneral	h e n e ˈɾ a l
taniman	t a n i ˈm a n
hanger	ˈh a ŋ e ɾ
Lantican	l a n ˈt i k a n
lamat	ˈl a m a t
sisid	ˈs i s i d
hibi	ˈh i b i
balimbing	b a l i m ˈb i ŋ
Hagonoy	h a ˈɡ o n o j
estasyon	ʔ e s t a s ˈj o n
kalsiyo	ˈk a l s j o
agwamarina	ʔ a ɡ w a m a ˈɾ i n a
palaman	p a l a ˈm a n
retirada	ɾ e t i ˈɾ a d a
numipis	n u m i ˈp i s
magkautang	m a ɡ k a ˈʔ u t a ŋ
uso	ˈʔ u s o
presko	ˈp ɾ e s k o
bumigay	b u m i ˈɡ a j
labong	l a ˈb o ŋ
magwagi	m a ɡ w a ˈɡ i ʔ
Espinoza	ʔ e s p i ˈn o z a
bayag	b a ˈj a ɡ
kuyakoy	k u ˈj a k o j
nakayukyok	n a k a j u k ˈj o k
mangailangan	m a ŋ a ʔ i ˈl a ŋ a n
sambong	s a m ˈb o ŋ
koreo	k o ɾ e ˈo
Kuwaresma	k u a ˈɾ e s m a
opresyon	ʔ o p ɾ e s ˈj o n
magnate	m a ɡ ˈn a t e
Maynila	m a j ˈn i l a ʔ
mahalin	m a h a ˈl i n
gilid	ˈɡ i l i d
tsitsaron	t͡ʃ i t͡ʃ a ˈɾ o n
kuwago	k u ˈa ɡ o
megalomanya	m e ɡ a l o ˈm a n j a
katre	ˈk a t ɾ e
Dayang	ˈd a j a ŋ
ᜑ	h a ˈh a ʔ
samay	ˈs a m a j
Cayabyab	k a j a b ˈj a b
suklay	s u k ˈl a j
mamumuhunan	m a m u m u ˈh u n a n
maghasik	m a ɡ h a ˈs i k
katukayo	k a t u ˈk a j o
alikabok	ʔ a l i k a ˈb o k
gora	ˈɡ o ɾ a
tolerante	t o l e ˈɾ a n t e
giba	ɡ i ˈb a ʔ
gahi	ˈɡ a h i ʔ
Opeña	ʔ o ˈp e ɲ a
tunggali	t u ŋ ˈɡ a l i ʔ
Ching	ˈt͡ʃ i ŋ
Kapampangan	k a p a m ˈp a ŋ a n
santan	s a n ˈt a n
kapansanan	k a p a n ˈs a n a n
dale	ˈd a l e
bakuran	b a ˈk u ɾ a n
lingguhan	l i ŋ ˈɡ u h a n
empleyada	ʔ e m p l e ˈa d a
parokyano	p a ɾ o k ˈj a n o
retratista	ɾ e t ɾ a ˈt i s t a
noon	n o ˈʔ o n
aplikasyon	ʔ a p l i k a s ˈj o n
kalan	k a ˈl a n
rito	ˈɾ i t o
pagsusunog	p a ɡ s u s u ˈn o ɡ
kalo	ˈk a l o ʔ
okultismo	ʔ o k u l ˈt i s m o
eksibisyon	ʔ e k s i b i s ˈj o n
makipagbati	m a k i p a ɡ b a ˈt i ʔ
Libjo	l i b ˈh o ʔ
ngatal	ŋ a ˈt a l
garbo	ˈɡ a ɾ b o
bukadkad	b u k a d ˈk a d
lumipad	l u m i ˈp a d
leksikograpiko	l e k s i k o ɡ ˌɾ a p i ˈk o
upas	ˈʔ u p a s
amin	ˈʔ a m i n
tagalinang	t a ɡ a l i ˈn a ŋ
Camantigue	k a m a n t i ˈɡ e
buwa	b u ˈa ʔ
kalma	ˈk a l m a
kamakalawa	k a m a k a l a ˈw a
hapay	h a ˈp a j
determinismo	d e t e ɾ m i ˈn i s m o
dulas	d u ˈl a s
Andrade	ʔ a n ˈd ɾ a d e
pikaporte	p i k a ˈp o ɾ t e
luwag	l u ˈa ɡ
pulseras	p u l ˈs e ɾ a s
Sarcia	ˈs a ɾ s j a
Hau	ˈh a w
ligat	ˈl i ɡ a t
bolta	ˈb o l t a
Ragudo	ɾ a ˈɡ u d o
kasera	k a ˈs e ɾ a
perspektiba	p e ɾ s p e k ˈt i b a
akin	ˈʔ a k i n
lunsod	l u n ˈs o d
pumanghaw	p u m a ŋ ˈh a w
nerbyoso	n e ɾ ˈb j o s o
lumot	ˈl u m o t
asno	ˈʔ a s n o
pasma	p a s ˈm a
kalangay	k a ˈl a ŋ a j
kuwako	k u ˈa k o
kupad	ˈk u p a d
iti	ˈʔ i t i
tinik	t i ˈn i k
dinsulan	d i n ˈs u l a n
asam	ʔ a ˈs a m
detalyado	d e t a l ˈj a d o
Nebraska	n e b ˈɾ a s k a
iresponsable	ʔ i r e s p o n ˈs a b l e
ligtas	l i ɡ ˈt a s
ingkorporasyon	ʔ i ŋ k o ɾ p o ɾ a s ˈj o n
Weste	ˈw e s t e
Malaruhatan	m a l a ɾ u h a ˈt a n
Indarapatra	ʔ i n d a ɾ a ˈp a t ɾ a
kilitis	k i l i ˈt i s
tulin	ˈt u l i n
bilangguan	b i l a ŋ ˈɡ u ʔ a n
ariangaw	ʔ a ɾ i ˈʔ a ŋ a w
magugulo	m a ɡ u ɡ u ˈl o
kiyeme	k i ˈe m e
Leung	ˈl j u ŋ
Kardo	ˈk a ɾ d o
'ka	ˈk a ʔ
gusali	ɡ u ˈs a l i ʔ
pagakpak	p a ɡ a k ˈp a k
luoy	l u ˈʔ o j
espantaho	ʔ e s p a n ˈt a h o
Inglatera	ʔ i ŋ ɡ l a ˈt e ɾ a
Manaois	m a ˈn a w i s
entusyasmo	ʔ e n t u s ˈj a s m o
heranyo	h e ˈɾ a n j o
meganon	ˌm e ɡ a ˈn o n
dalubmayawan	d a l u b m a ˈj a w a n
semento	s e ˈm e n t o
Ticzon	ˈt i k s o n
pakikiapid	p a k i k i ʔ a ˈp i d
pakielam	p a k i ˈʔ e l a m
alisangsang	ʔ a l i s a ŋ ˈs a ŋ
tanghalian	t a ŋ h a ˈl i ʔ a n
sadsad	s a d ˈs a d
Abellano	ʔ a b e l ˈj a n o
bilao	b i ˈl a ʔ o
ketongin	k e ˈt o ŋ i n
lumboy	l u m ˈb o j
importante	ʔ i m p o ɾ ˈt a n t e
Quimson	ˈk i m s o n
sigsa	s i ɡ ˈs a
marites	ˈm a ɾ i t e s
sikreto	s i k ˈɾ e t o
Alfredo	ʔ a l ˈf ɾ e d o
wangis	ˈw a ŋ i s
ikaanim	ʔ i k a ˈʔ a n i m
Banayad	b a ˈn a j a d
lapulapu	ˌl a p u ˈl a p u
sampid	s a m ˈp i d
Nuevo	n u ˈe v o
lampong	l a m ˈp o ŋ
kromosoma	k ɾ o m o ˈs o m a
tol	ˈt o l
alinman	ʔ a l i n ˈm a n
intriga	ʔ i n ˈt ɾ i ɡ a
Bugtong	b u ɡ ˈt o ŋ
ritrato	ɾ i t ˈɾ a t o
Jocson	ˈh o k s o n
Villamayor	v i l j a m a ˈj o ɾ
hila	ˈh i l a
kuliglig	k u l i ɡ ˈl i ɡ
talunton	t a l u n ˈt o n
ginto	ɡ i n ˈt o ʔ
guwatsinanggo	ɡ u a t͡ʃ i ˈn a ŋ ɡ o
yumabong	j u ˈm a b o ŋ
reportahe	ɾ e p o ɾ ˈt a h e
kulit	k u ˈl i t
utot	ʔ u ˈt o t
panaderya	p a n a d e ɾ ˈj a
Dalangin	d a ˈl a ŋ i n
magyo	m a ɡ ˈj o
Abelgas	ʔ a b e l ˈɡ a s
bagot	b a ˈɡ o t
hininga	h i n i ˈŋ a
GRO	ˈd j i ʔ a ɾ ʔ o
salap	ˈs a l a p
Biyernes	b i ˈe ɾ n e s
Indotsina	ʔ i n d o ˈt͡ʃ i n a
inunan	ʔ i ˈn u n a n
buling	ˈb u l i ŋ
panaguri	p a n a ɡ u ˈɾ i ʔ
takoyaki	t a k o ˈj a k i
makita	m a ˈk i t a ʔ
bati	b a ˈt i ʔ
bumalikwas	b u m a l i k ˈw a s
makatha	m a k a t ˈh a ʔ
hindi	h i n ˈd i ʔ
tatap	t a ˈt a p
isulat	ʔ i ˈs u l a t
mahahapdi	m a h a h a p ˈd i ʔ
Bogota	b o ɡ o ˈt a
mami	ˈm a m i
estrikto	ʔ e s ˈt ɾ i k t o
panananim	p a n a n a ˈn i m
pison	p i ˈs o n
ebak	ˈʔ e b a k
pandangal	p a n ˈd a ŋ a l
sapalaran	ˈs a p a l a ɾ a n
bangketa	b a ŋ ˈk e t a
Montaño	m o n ˈt a ɲ o
luwan	l u ˈa n
tilandoy	t i l a n ˈd o j
manlait	m a n ˈl a ʔ i t
diitan	ˌd i ˈʔ i t a n
siyokoy	s i ˈo k o j
tolerable	t o l e ˈɾ a b l e
Domantay	d o m a n ˈt a j
pananamantala	p a n a n a m a n t a ˈl a
ohetes	ʔ o ˈh e t e s
apatita	ʔ a p a ˈt i t a
Nadine	n a ˈd i n
paminggalan	ˌp a m i ŋ ˈɡ a l a n
lugo	l u ˈɡ o
silidkatwan	s i ˌl i d k a t ˈw a n
Yap	ˈj a p
mestiso	m e s ˈt i s o
sakol	ˈs a k o l
liko	l i ˈk o ʔ
kabit	k a ˈb i t
mabagsakan	ˌm a b a ɡ s a ˈk a n
mamilis	m a m i ˈl i s
heko	ˈh e k o
manigo	m a ˈn i ɡ o ʔ
dalubwikaan	d a ˌl u b w i ˈk a ʔ a n
maimbot	m a ʔ i m ˈb o t
tsispa	ˈt͡ʃ i s p a
Corcuera	k o ɾ k u ˈe ɾ a
Manatad	m a ˈn a t a d
Laylo	ˈl a j l o
anib	ˈʔ a n i b
tokador	t o k a ˈd o ɾ
ugoy	ʔ u ˈɡ o j
Dijamco	d i ˈh a m k o
kampyon	k a m ˈp j o n
ungkat	ʔ u ŋ ˈk a t
Melchor	m e l ˈt͡ʃ o ɾ
sipot	s i ˈp o t
lirika	ˈl i ɾ i k a
Olaguer	ʔ o l a ˈɡ e ɾ
tamales	t a ˈm a l e s
Lubiano	l u b ˈj a n o
humalakhak	h u m a l a k ˈh a k
hostes	ˈh o s t e s
Anunsiyasyon	ʔ a n u n s i a s ˈj o n
C	s i
tambakol	t a m ˈb a k o l
kumpisal	k u m p i ˈs a l
entremetido	ʔ e n t ɾ e m e ˈt i d o
Audrey	ˈʔ o d ɾ i
albakora	ʔ a l b a ˈk o ɾ a
Masilungan	m a s i ˈl u ŋ a n
silab	s i ˈl a b
tanggalin	t a ŋ ɡ a ˈl i n
bilugan	b i l u ˈɡ a n
manman	m a n ˈm a n
Fukien	ˈf u k j e n
yumanig	j u m a ˈn i ɡ
nagbabaon	n a ɡ b a ˈb a ʔ o n
panuruan	ˈp a n u ɾ u ʔ a n
dalubituinan	d a ˌl u b i t u ʔ i ˈn a n
sapak	s a ˈp a k
aroma	ʔ a ˈɾ o m a
paraiso	p a ɾ a ˈʔ i s o
kutong	ˈk u t o ŋ
asinan	ʔ a ˈs i n a n
umulit	ʔ u ˈm u l i t
Mallare	m a l ˈj a ɾ e
kabibili	k a b i b i ˈl i
tawge	ˈt a w ɡ e
Kaputsino	k a p u ˈt͡ʃ i n o
Kamaynilaan	k a m a j n i ˈl a ʔ a n
haspe	h a s ˈp e
ukab	ˈʔ u k a b
kamuning	k a m u ˈn i ŋ
nitrogliserina	n i t ɾ o ɡ l i s e ˈɾ i n a
ampiyon	ʔ a m p i ˈo n
dagitban	d a ɡ i t ˈb a n
sahod	ˈs a h o d
Manalaysay	m a n a l a j ˈs a j
Froilan	ˈf ɾ o j l a n
triduo	ˈt ɾ i d u ʔ o
Esguerra	ʔ e s ˈɡ e r a
pagkaigkasin	p a ɡ k a ʔ i ɡ ˈk a s i n
suminga	s u m i ˈŋ a
kuwa	k u ˈa ʔ
asido	ˈʔ a s i d o
lumambitin	l u m a m ˈb i t i n
balbal	b a l ˈb a l
Caguiat	ˈk a ɡ j a t
es	ʔ e s
landi	l a n ˈd i ʔ
matapunan	m a t a ˈp u n a n
takip	t a ˈk i p
timos	ˈt i m o s
garya	ˈɡ a ɾ j a ʔ
kundena	k u n d e ˈn a
elegansiya	ʔ e l e ˈɡ a n s j a
Lucero	l u ˈs e ɾ o
tauhan	t a ˈʔ u h a n
almuwerso	ʔ a l m u ˈe ɾ s o
dalya	ˈd a l j a
Italyano	ʔ i t a l ˈj a n o
Caluya	k a ˈl u j a
hupa	ˈh u p a ʔ
Cueto	k u ˈe t o
sikolohiya	s i k o l o ˈh i a
talentado	t a l e n ˈt a d o
Paligsahan	p a l i ɡ ˈs a h a n
panahon	p a n a ˈh o n
jabol	d͡ʒ a ˈb o l
kalimbahin	k a l i m b a ˈh i n
baranggay	b a ɾ a ŋ ˈɡ a j
lagim	l a ˈɡ i m
sanaysay	s a n a j ˈs a j
ordenansa	ʔ o ɾ d e ˈn a n s a
maggantsilyo	m a ɡ ɡ a n ˈt͡ʃ i l j o
maabo	m a ʔ a ˈb o
kalaswaan	k a l a s w a ˈʔ a n
pasipismo	p a s i ˈp i s m o
Epikureismo	ʔ e p i k u ɾ e ˈi s m o
magkaaway	m a ɡ k a ˈʔ a w a j
talimang	t a l i ˈm a ŋ
abyog	ʔ a b ˈj o ɡ
talino	t a ˈl i n o
rebulto	ɾ e ˈb u l t o
panenteismo	p a n e n t e ˈi s m o
gagapang	ɡ a ˈɡ a p a ŋ
magjakol	m a ɡ d͡ʒ a ˈk o l
nais	ˈn a ʔ i s
alat	ˈʔ a l a t
mambiktima	m a m ˈb i k t i m a
mangalandakan	m a ŋ a l a n ˈd a k a n
gadgaran	ɡ a d ˈɡ a ɾ a n
mandadangkal	m a n d a d a ŋ ˈk a l
rekisito	ɾ e k i ˈs i t o
sanke	s a n ˈk e ʔ
kubrekama	k u b ɾ e ˈk a m a
talas	ˈt a l a s
talaba	t a l a ˈb a
iwas	ˈʔ i w a s
yatyat	j a t ˈj a t
Cobarrubias	k o b a ˈɾ u b j a s
anek	ʔ a ˈn e k
salakay	s a ˈl a k a j
lantutay	l a n ˈt u t a j
lindayag	l i n ˈd a j a ɡ
ipakuha	ʔ i p a ˈk u h a
antok	ʔ a n ˈt o k
bayawak	b a ˈj a w a k
Corazon	k o ɾ a ˈz o n
Franco	ˈf ɾ a ŋ k o
magbabasa	m a ɡ b a b a ˈs a
gumban	ɡ u m ˈb a n
isapribado	ʔ i s a p ɾ i ˈb a d o
relohero	ɾ e l o ˈh e ɾ o
hapag	h a ˈp a ɡ
waray	w a ˈɾ a j
aguho	ʔ a ˈɡ u h o ʔ
proteksiyonismo	p ɾ o t e k s i o ˈn i s m o
agam	ˈʔ a ɡ a m
anasan	ˌʔ a ˈn a s a n
Razon	ɾ a ˈz o n
libra	ˈl i b ɾ a
suplete	s u p ˈl e t e
talihilig	t a l i ˈh i l i ɡ
lalagyan	l a l a ɡ ˈj a n
maghalabos	m a ɡ h a l a ˈb o s
ganda	ɡ a n ˈd a
Alcaide	ʔ a l ˈk a j d e
potahe	p o ˈt a h e
panwelo	p a n ˈw e l o
anis	ʔ a ˈn i s
sumbong	s u m ˈb o ŋ
kumpiyansa	k u m p i ˈa n s a
sanib	ˈs a n i b
kumporme	k u m ˈp o ɾ m e
umusbong	ʔ u m u s ˈb o ŋ
Londres	ˈl o n d ɾ e s
also	ˈʔ a l s o
bisikleta	b i s i k ˈl e t a
tahong	t a ˈh o ŋ
Gascon	ɡ a s ˈk o n
mayoldomo	m a j o l ˈd o m o
biyaya	b i ˈa j a ʔ
Saog	ˈs a ʔ o ɡ
deskripsiyon	d e s k ɾ i p s i ˈo n
groser	ˈɡ ɾ o s e ɾ
angkan	ʔ a ŋ ˈk a n
bisaklat	b i s a k ˈl a t
lupig	ˈl u p i ɡ
shiboli	ˈʃ i b o l i
Agusan	ʔ a ˈɡ u s a n
talang	ˈt a l a ŋ
ᜐ	s a ˈs a ʔ
petisyon	p e t i s ˈj o n
nguyngoy	ŋ u j ˈŋ o j
Pekto	ˈp e k t o
peseta	p e ˈs e t a
lunaw	l u ˈn a w
bigasan	ˌb i ˈɡ a s a n
Katipunan	k a t i ˈp u n a n
kuwarenta	k u a ˈɾ e n t a
ugali	ʔ u ˈɡ a l i ʔ
z	z i
maano	m a ʔ a ˈn o
Mauban	m a ˈʔ u b a n
samaral	s a ˈm a ɾ a l
Vizconde	v i s ˈk o n d e
sangkap	s a ŋ ˈk a p
depresasyon	d e p ɾ e s a s ˈj o n
dalwa	d a l ˈw a
bagalan	b a ˈɡ a l a n
dayan	d a ˈj a n
Magsayo	m a ɡ ˈs a j o
bayabasan	ˌb a j a b a ˈs a n
singa	s i ˈŋ a
dapo	ˈd a p o ʔ
magkatay	m a ɡ ˈk a t a j
matindi	m a t i n ˈd i
hinga	h i ˈŋ a
gariya	ɡ a ˈɾ i a ʔ
beho	ˈb e h o
bertebrado	b e ɾ t e b ˈɾ a d o
soberano	s o b e ˈɾ a n o
yumahod	j u ˈm a h o d
Esperanto	ʔ e s p e ˈɾ a n t o
piyudalismo	p i u d a ˈl i s m o
repleksiyon	ɾ e p l e k s i ˈo n
Abucay	ʔ a ˈb u k a j
Natanauan	n a t a ˈn a w a n
dado	ˈd a d o
kusim	k u ˈs i m
Peñaflor	p e ɲ a ˈf l o ɾ
abain	ʔ a b a ˈʔ i n
oslo	ˈʔ o s l o
Flora	ˈf l o ɾ a
tupak	t u ˈp a k
Maala	m a ˈʔ a l a
uraw	ʔ u ˈɾ a w
tosta	t o s ˈt a
iho	ˈʔ i h o
rebelyon	ɾ e b e l ˈj o n
libid	ˈl i b i d
selestiyal	s e l e s t i ˈa l
Pilipino	p i l i ˈp i n o
pangmatanda	p a ŋ m a t a n ˈd a ʔ
kontento	k o n ˈt e n t o
isangkot	ʔ i s a ŋ ˈk o t
katha	k a t ˈh a ʔ
omsim	ˈʔ o m s i m
kliyente	k l i ˈe n t e
gumising	ɡ u ˈm i s i ŋ
ewan	ˈʔ e w a n
retraksiyon	ɾ e t ɾ a k s i ˈo n
estapa	ʔ e s ˈt a p a
Sin	ˈs i n
matinis	m a ˈt i n i s
Tagupa	t a ˈɡ u p a
Imperial	ʔ i m p e ɾ ˈj a l
disko	ˈd i s k o
Michelena	m i t͡ʃ e ˈl e n a
lusok	l u ˈs o k
siyete	s i ˈe t e
pindutan	p i n ˈd u t a n
proyekto	p ɾ o ˈj e k t o
kabaiyuan	k a b a ʔ i u ˈʔ a n
'di	d i ʔ
kalapati	k a l a ˈp a t i
barker	ˈb a ɾ k e ɾ
maleta	m a ˈl e t a
katalaghayan	k a t a l a ɡ h a ˈj a n
sakong	ˈs a k o ŋ
peg	ˈp e ɡ
manuntok	m a n u n ˈt o k
nagagandahan	n a ɡ a ɡ a n d a ˈh a n
basbasan	b a s b a ˈs a n
Rajah	ˈɾ a h a
lawaan	l a ˈw a ʔ a n
Pinas	p i ˈn a s
kahelada	k a h e ˈl a d a
magat	ˈm a ɡ a t
yaya	ˈj a j a
haro	ˈh a ɾ o
apoy	ʔ a ˈp o j
Valmores	v a l ˈm o ɾ e s
Vecino	v e ˈs i n o
sinsay	s i n ˈs a j
siyesta	s i ˈe s t a
solusyon	s o l u s ˈj o n
tate	t a ˈt e ʔ
X	ʔ e k s
sepelin	ˈs e p e l i n
rotonda	ɾ o ˈt o n d a
redaksiyon	ɾ e d a k s i ˈo n
sumunod	s u m u ˈn o d
oras	ˈʔ o ɾ a s
magdemanda	m a ɡ d e ˈm a n d a
sapagka	s a p a ɡ ˈk a ʔ
TNT	ˈt i ʔ e n t i
mapera	m a ˈp e ɾ a
optimista	ʔ o p t i ˈm i s t a
taltak	t a l ˈt a k
Ivy	ˈʔ a j v i
pantukoy	p a n ˈt u k o j
sabog	s a ˈb o ɡ
tsang	ˈt͡ʃ a ŋ
punla	p u n ˈl a ʔ
Estigoy	ʔ e s t i ˈɡ o j
bronse	ˈb ɾ o n s e
abyugin	ʔ a b j u ˈɡ i n
sundong	s u n ˈd o ŋ
erkon	ˈʔ e ɾ k o n
kimona	k i ˈm o n a
hapis	ˈh a p i s
piyesa	p i ˈe s a
marungis	m a ˈɾ u ŋ i s
sagwan	s a ɡ ˈw a n
kelan	ˈk e l a n
lingkod	l i ŋ ˈk o d
g̃	ŋ
obserba	ʔ o b s e ɾ ˈb a
tikling	t i k ˈl i ŋ
unyonista	ʔ u n j o ˈn i s t a
kakanin	k a k a ˈn i n
Kamatayan	k a m a ˈt a j a n
Lupao	l u ˈp a w
sulong	ˈs u l o ŋ
matimbang	m a t i m ˈb a ŋ
pamamahagi	p a m a m a ˈh a ɡ i ʔ
Urugway	ʔ u ɾ u ɡ ˈw a j
nakainom	n a k a ʔ i ˈn o m
asul	ʔ a ˈs u l
tokneneng	t o k ˈn e n e ŋ
eskultor	ʔ e s k u l ˈt o ɾ
baisi	b a ˈʔ i s i ʔ
mambabarang	ˌm a m b a ˈb a ɾ a ŋ
siklo	ˈs i k l o
dokumentaryo	d o k u m e n ˈt a ɾ j o
Maranan	m a ˈɾ a n a n
inspeksiyon	ʔ i n s p e k s i ˈo n
muok	m u ˈʔ o k
inhenyeriya	ʔ i n h e n j e ˈɾ i a
ligis	l i ˈɡ i s
balde	b a l ˈd e
kayumanis	k a j u ˈm a n i s
karbungkulo	k a ɾ ˈb u ŋ k u l o
kali	k a ˈl i
magluto	m a ɡ ˈl u t o ʔ
lakbay	l a k ˈb a j
manunula	m a n u n u ˈl a ʔ
bamos	b a ˈm o s
gahol	ˈɡ a h o l
burara	b u ɾ a ˈɾ a ʔ
Pagaspas	p a ɡ a s ˈp a s
endyi	ˈʔ e n d j i
pinansiyal	p i ˌn a n s i ˈa l
adelpa	ʔ a ˈd e l p a
ibangsilyo	ʔ i b a ŋ ˈs i l j o
umbok	ʔ u m ˈb o k
maghuramentado	m a ɡ h u ɾ a m e n ˈt a d o
kasal	k a ˈs a l
astinggal	ʔ a s t i ŋ ˈɡ a l
silam	ˈs i l a m
salaula	s a l a ˈʔ u l a ʔ
kunsumido	k u n s u ˈm i d o
nipis	n i ˈp i s
amot	ˈʔ a m o t
ladlad	l a d ˈl a d
bagol	b a ˈɡ o l
toniko	ˈt o n i k o
kuwan	k u ˈa n
kulayin	k u l a ˈj i n
mayroon	m a j ɾ o ˈʔ o n
Arevalo	ʔ a ˈɾ e v a l o
kariton	k a ɾ i ˈt o n
permiso	p e ɾ ˈm i s o
bentaha	b e n ˈt a h a
rangya	ɾ a ŋ ˈj a ʔ
ganansiya	ɡ a ˈn a n s j a
Siam	s i ˈa m
naganap	n a ɡ a ˈn a p
dyudo	ˈd j u d o
Jaro	ˈh a ɾ o
polo	ˈp o l o
samaya	s a m a ˈj a ʔ
kanila	k a n i ˈl a
bumasa	b u ˈm a s a
persigido	p e ɾ s i ˈɡ i d o
kahit	ˈk a h i t
balikan	ˌb a ˈl i k a n
mabibigat	m a b i b i ˈɡ a t
tungaw	t u ˈŋ a w
tulos	ˈt u l o s
baligtad	b a l i ɡ ˈt a d
Yolanda	j o ˈl a n d a
kamot	ˈk a m o t
sandal	s a n ˈd a l
Tseko	ˈt͡ʃ e k o
maghagilap	m a ɡ h a ɡ i ˈl a p
buboy	ˈb u b o j
Dulay	ˈd u l a j
madagta	m a d a ɡ ˈt a ʔ
enagwas	ʔ e ˈn a ɡ w a s
giwang	ˈɡ i w a ŋ
sinigwelas	s i n i ɡ ˈw e l a s
singkamas	s i ŋ k a ˈm a s
tinggil	t i ŋ ˈɡ i l
aborsiyonista	ʔ a b o ɾ s i o ˈn i s t a
sirkito	ˈs i ɾ k i t o
sikologo	s i ˈk o l o ɡ o
oportunismo	ʔ o p o ɾ t u ˈn i s m o
magbabaon	m a ɡ b a ˈb a ʔ o n
higa	h i ˈɡ a ʔ
residente	ɾ e s i ˈd e n t e
kapatawaran	k a p a t a w a ˈɾ a n
matalik	m a ˈt a l i k
bagnet	b a ɡ ˈn e t
lara	ˈl a ɾ a ʔ
mangobra	m a ˈŋ o b ɾ a
taklip	t a k ˈl i p
babag	b a ˈb a ɡ
salimao	s a l i m a ˈʔ o
peram	ˈp e ɾ a m
Libya	ˈl i b j a
kritiko	ˈk ɾ i t i k o
Elizaga	ʔ e l i ˈz a ɡ a
kandidatura	k a n d i d a ˈt u ɾ a
reperensiya	ɾ e p e ˈɾ e n s j a
uslak	ʔ u s ˈl a k
bayna	ˈb a j n a
Ann	ˈʔ a n
tumangkad	t u m a ŋ ˈk a d
suplada	s u p ˈl a d a
ayungin	ʔ a ˈj u ŋ i n
Aliga	ʔ a ˈl i ɡ a
empleyado	ʔ e m p l e ˈa d o
daloy	ˈd a l o j
Inocencio	ʔ i n o ˈs e n s j o
bungbong	b u ŋ ˈb o ŋ
maglinis	m a ɡ ˈl i n i s
Sandoval	s a n d o ˈv a l
tatsihaan	t a t s i ˈh a ʔ a n
balam	ˈb a l a m
ateneo	ʔ a t e ˈn e o
Isko	ʔ i s ˈk o ʔ
kulaysukat	k u l a j ˈs u k a t
akurdiyon	ʔ a k u ɾ d i ˈo n
Malilay	m a ˈl i l a j
bihilante	b i h i ˈl a n t e
kompiyuteran	k o m p i ˈu t e ɾ a n
hipno	h i p ˈn o
pagkasuplado	p a ɡ k a s u p ˈl a d o
Tauro	ˈt a w ɾ o
unawa	ʔ u ˈn a w a ʔ
onlayn	ˈʔ o n l a j n
likot	l i ˈk o t
haka	ˈh a k a ʔ
daos	ˈd a ʔ o s
Moymoy	ˈm o j m o j
singaw	s i ˈŋ a w
yukod	j u ˈk o d
tagatuos	t a ɡ a t u ˈʔ o s
balipik	b a ˈl i p i k
burges	b u ɾ ˈɡ e s
Po	ˈp o
Sangandaan	s a ˌŋ a n d a ˈʔ a n
masikip	m a s i ˈk i p
Chiyoko	t͡ʃ i ˈo k o
oeste	ʔ o ˈe s t e
sangal	s a ˈŋ a l
kuwela	k u ˈe l a
sinturon	s i n t u ˈɾ o n
sundan	s u n ˈd a n
kalumbaba	k a l u m ˈb a b a ʔ
panlikod	p a n l i ˈk o d
sinigurado	s i n i ɡ u ˈɾ a d o
asupre	ʔ a ˈs u p ɾ e
dapat	ˈd a p a t
sumpa	s u m ˈp a ʔ
uyad	ˈʔ u j a d
paboritismo	p a b o ɾ i ˈt i s m o
balandra	b a ˈl a n d ɾ a
Turko	ˈt u ɾ k o
dedikasyon	d e d i k a s ˈj o n
junakis	d͡ʒ u ˈn a k i s
barato	b a ˈɾ a t o
iniina	ʔ i ˌn i ʔ i ˈn a
turong	ˈt u ɾ o ŋ
hirol	ˈh i ɾ o l
kandaro	k a n ˈd a ɾ o
sangandaan	s a ˌŋ a n d a ˈʔ a n
ambisyon	ʔ a m b i s ˈj o n
kupo	ˈk u p o ʔ
nanghawa	n a ŋ ˈh a w a
lugaw	ˈl u ɡ a w
Gerda	ˈɡ e ɾ d a
otel	ʔ o ˈt e l
Manalang	m a ˈn a l a ŋ
talindaw	t a l i n ˈd a w
sanggumay	s a ŋ ˈɡ u m a j
wangwang	ˈw a ŋ w a ŋ
f	ˈʔ e f
kasama	k a ˈs a m a
kamelyo	k a ˈm e l j o
Kulas	k u ˈl a s
em	ʔ e m
palitada	p a l i ˈt a d a
humawak	h u ˈm a w a k
himay	h i ˈm a j
kalyo	ˈk a l j o
saro	ˈs a ɾ o
asawa	ʔ a ˈs a w a
bilo	b i ˈl o
Ayako	ʔ a ˈj a k o
daungan	ˌd a ˈʔ u ŋ a n
sulsol	s u l ˈs o l
pasintabi	p a s i n ˈt a b i ʔ
amnestiya	ʔ a m n e s ˈt i a
Gonzales	ɡ o n ˈz a l e s
kriket	ˈk ɾ i k e t
pananampalataya	p a n a n a m p a l a ˈt a j a
husto	h u s ˈt o
Aleman	ʔ a l e ˈm a n
kontestant	k o n ˈt e s t a n t
kamya	ˈk a m j a
Casiguran	k a s i ˈɡ u ɾ a n
kisay	k i ˈs a j
lumakas	l u m a ˈk a s
apostol	ʔ a p o s ˈt o l
hingalo	h i ŋ a ˈl o ʔ
Aguilera	ʔ a ɡ i ˈl e ɾ a
Carandang	k a ɾ a n ˈd a ŋ
yumi	ˈj u m i ʔ
Anor	ʔ a ˈn o ɾ
plantsa	ˈp l a n t͡ʃ a
gapong	ɡ a ˈp o ŋ
eksaherado	ʔ e k s a h e ˈɾ a d o
ikit	ˈʔ i k i t
maanak	m a ʔ a ˈn a k
kainin	k a ˈʔ i n i n
kutya	k u t ˈj a ʔ
matibay	m a ˈt i b a j
Diamante	d j a ˈm a n t e
birilidad	b i ɾ i l i ˈd a d
Tamiko	t a ˈm i k o
baway	ˈb a w a j
kontrasenyas	k o n t ɾ a ˈs e n j a s
bungkos	b u ŋ ˈk o s
aruskaldo	ʔ a ɾ u s ˈk a l d o
maulanan	m a ʔ u l a ˈn a n
kapas	ˈk a p a s
tabernakulo	t a b e ɾ ˌn a k u ˈl o
gladyador	ɡ l a d j a ˈd o ɾ
pupu	ˈp u p u ʔ
bunggabilya	b u ŋ ɡ a ˈb i l j a
sisne	ˈs i s n e
tikim	t i ˈk i m
bagal	ˈb a ɡ a l
baklad	b a k ˈl a d
tumulong	t u ˈm u l o ŋ
buwitre	b u ˈi t ɾ e
Kaprikorniyo	k a p ɾ i ˈk o ɾ n j o
ingreso	ʔ i ŋ ˈɡ ɾ e s o
jontis	ˈd͡ʒ o n t i s
labis	ˈl a b i s
Aldover	ʔ a l d o ˈv e ɾ
huwataw	h u ˈa t a w
malasado	m a l a ˈs a d o
anemya	ʔ a ˈn e m j a
Ablog	ʔ a b ˈl o ɡ
gahaman	ɡ a h a ˈm a n
kapagka	k a p a ɡ ˈk a ʔ
ermat	ˈʔ e ɾ m a t
magbasanlot	m a ɡ b a s a n ˈl o t
instituto	ʔ i n s t i ˈt u t o
gasera	ɡ a ˈs e ɾ a
lamon	ˈl a m o n
Eukaristiya	j u k a ɾ i s ˈt i a
NAPOLCOM	ˈn a p o l k o m
patidyugto	p a t i d j u ɡ ˈt o ʔ
Islam	ʔ i s ˈl a m
eskandalosa	ʔ e s k a n d a ˈl o s a
tampak	t a m ˈp a k
golp	ˈɡ o l p
kumbulsiyon	k u m b u l s i ˈo n
labimpito	l a b i m p i ˈt o
kahapon	k a ˈh a p o n
lusog	l u ˈs o ɡ
halata	h a l a ˈt a ʔ
Magdangal	m a ɡ d a ˈŋ a l
lungayngay	l u ŋ a j ˈŋ a j
yaon	j a ˈʔ o n
waley	w a ˈl e j
