skela	s k ê l a
kolonijalan	k ô l o n i j aː l a n
golišavost	ɡ o l ǐ ʃ a ʋ oː s t
đihad	d͡ʑ ǐ x aː d
redovan	r ê d oː ʋ a n
кривица	k r i ʋ ǐ t͡s a
uračunavati	u r a t͡ʃ u n ǎː ʋ a t i
sistematičan	s i s t e m ǎ t i t͡ʃ a n
тискати	t î s k a t i
датуља	d ǎ t u ʎ a
pokvariti	p o k ʋ ǎː r i t i
називати	n a z ǐː ʋ a t i
kroničar	k r ǒ n i t͡ʃ aː r
аутаркија	a u t ǎ r k i j a
ekonomičan	e k o n ǒ m i t͡ʃ a n
ругалачки	r ǔː ɡ a l a t͡ʃ k iː
врежа	ʋ r êː ʒ a
плиновод	p l î n o ʋ oː d
Мехмед	m ě h m e d
uputstvo	u p ǔ t s t ʋ o
исправан	î s p r aː ʋ a n
izobličavati	i z o b l i t͡ʃ ǎː ʋ a t i
великодушан	ʋ e l i k ǒ d u ʃ a n
родбински	r ô d b iː n s k iː
битер	b ǐ t e r
masnica	m ǎ s n i t͡s a
темпао	t e m p a o
крепати	k r ě p a t i
druželjubivo	d r u ʒ e ʎ ǔ b i ʋ o
графем	ɡ r ǎ f eː m
одобрити	o d ǒ b r i t i
jeftinoća	j e f t i n ǒ t͡ɕ a
исцрпити	i s t͡s ř̩ː p i t i
boljitak	b o ʎ ǐː t a k
apsorbirati	a p s o r b ǐː r a t i
opak	ô p aː k
пракрт	p r ǎ k r t
krolati	k r ǒ l a t i
одрађивати	o d r a d͡ʑ ǐː ʋ a t i
basnoslovan	b â s n o s l oː ʋ a n
сјеверноамерички	s j e ʋ e r n o a m ě r i t͡ʃ k iː
rodni	r ô d n iː
Kroacija	k r ǒ aː t͡s i j a
симпатично	s i m p ǎ t i t͡ʃ n o
гланц	ɡ l â n t͡s
зачаривати	z a t͡ʃ a r ǐː ʋ a t i
predati	p r ě d a t i
поносити	p o n ǒ s i t i
бахат	b â x a t
меница	m ê n i t͡s a
sakrament	s a k r ǎ m e n t
бугарски	b û ɡ a r s k iː
gljivar	ɡ ʎ ǐ ʋ aː r
утјешно	ǔ t j e ʃ n o
часослов	t͡ʃ â s o s l o ʋ
krhati	k r̂ x a t i
izravan	î z r aː ʋ a n
odrađivati	o d r a d͡ʑ ǐː ʋ a t i
umetnica	ǔ m e t n i t͡s a
besprekorno	b e s p r ěː k oː r n o
сиједост	s i j ěː d oː s t
izmjeničan	î z m j e n i t͡ʃ a n
Paragvaj	p â r a ɡ ʋ aː j
нишанџија	n i ʃ ǎ n d͡ʒ i j a
девет	d ê ʋ e t
galama	ɡ a l ǎː m a
бушити	b ǔː ʃ i t i
безвјеран	b ě z ʋ j eː r a n
деветина	d e ʋ ě t i n a
разоружати	r a z o r ǔ ʒ a t i
чиновничин	t͡ʃ i n ǒ ʋ n i t͡ʃ i n
odijeliti	o d j ěː l i t i
чланство	t͡ʃ l ǎ n s t ʋ o
крепао	k r ê p a o
želudac	ʒ ě l u d a t͡s
neograničen	n e o ɡ r ǎ n i t͡ʃ e n
оџачки	ǒ d͡ʒ a t͡ʃ k iː
индискреција	i n d i s k r ěː t͡s i j a
дневни	d n êː ʋ n iː
oživiti	o ʒ ǐː ʋ i t i
lagodnost	l â ɡ o d n oː s t
omesti	ǒ m eː s t i
микрофон	m î k r o f oː n
urotiti	u r ǒ t i t i
замерљив	z a m ě r ʎ i ʋ
bosanski	b ǒ s a n s k iː
шрафцигер	ʃ r ǎ f t͡s iː ɡ e r
katoličanstvo	k a t o l i t͡ʃ ǎː n s t ʋ o
željeznički	ʒ ě ʎ e z n i t͡ʃ k iː
računovođa	r a t͡ʃ u n ǒ ʋ o d͡ʑ a
aleutski	a l ě u t s k iː
бог	b ôː ɡ
šuštar	ʃ û ʃ t aː r
ветеринарка	ʋ e t e r ǐ n aː r k a
akuzativ	â k u z a t iː ʋ
Sumatra	s ǔ m a t r a
dramaturgija	d r a m a t ǔ r ɡ i j a
pregalac	p r ě ɡ a l a t͡s
prelijetati	p r e l i j ěː t a t i
tračara	t r ǎ t͡ʃ a r a
малочас	m â l o t͡ʃ a s
č	t͡ʃ
земљопосједник	z e m ʎ o p ǒː s j e d n iː k
tekstualan	t ê k s t u aː l aː n
поново	p ô n o ʋ o
гошће	ɡ ǒ ʃ t͡ɕ e
двојина	d ʋ o j ǐ n a
raskošno	r ǎː s k o ʃ n o
ovjeriti	ǒ ʋ j e r i t i
линеарно	l î n e aː r n o
јечам	j ě t͡ʃ a m
прештампавати	p r e ʃ t a m p ǎː ʋ a t i
безгрешно	b ě z ɡ r e ʃ n o
sabrati	s ǎ b r a t i
podržavati	p o d r ʒ ǎː ʋ a t i
prepirka	p r ě p iː r k a
usavršavati	u s a ʋ r ʃ ǎː ʋ a t i
kozar	k ǒ z aː r
гондолијер	ɡ o n d o l ǐ j eː r
слаткорјечив	s l a t k o r j ě t͡ʃ i ʋ
bakšiš	b ǎ k ʃ i ʃ
stvor	s t ʋ ô r
мрзак	m r̂ z a k
расправљати	r ǎ s p r a ʋ ʎ a t i
шупчина	ʃ ǔ p t͡ʃ i n a
biografski	b i ǒ ɡ r a f s k iː
starčić	s t ǎ r t͡ʃ i t͡ɕ
библиофил	b i b l i ǒ f iː l
страдати	s t r ǎː d a t i
vrzmati	ʋ r̂ z m a t i
notorno	n ǒ t oː r n o
бабарога	b a b a r ǒː ɡ a
пешице	p ê ʃ i t͡s eː
истина	î s t i n a
vrpoljiti	ʋ r p ǒ ʎ i t i
однекуд	ǒ d n e k u d
трагичност	t r ǎ ɡ i t͡ʃ n oː s t
buhica	b ǔ x i t͡s a
воњати	ʋ ǒ ɲ a t i
сумпор	s ûː m p o r
сталешки	s t ǎː l e ʃ k iː
beglajter	b e ɡ l ǎ j t e r
ukrcavati	u k r̩ t͡s ǎː ʋ a t i
јахање	j â x aː ɲ e
kožuh	k ǒ ʒ u x
прилагођивати	p r i l a ɡ o d͡ʑ ǐː ʋ a t i
čovječanstvo	t͡ʃ o ʋ j e t͡ʃ ǎ n s t ʋ o
smeon	s m ě o n
сјена	s j ê n a
avion	a ʋ ǐ oː n
свагдашњи	s ʋ ǎ ɡ d a ʃ ɲ iː
с́утра	ɕ û t r a
gorjeti	ɡ ǒ r j e t i
ovđe	ǒː ʋ d͡ʑ e
пљачкати	p ʎ â t͡ʃ k a t i
демон	d ě m oː n
podnošljiv	p o d n ǒ ʃ ʎ i ʋ
zaseban	z ǎː s e b a n
одобрење	o d o b r ěː ɲ e
компетенција	k o m p e t ě n t͡s i j a
разумно	r â z uː m n o
rezistentan	r e z i s t ě n t a n
голишавост	ɡ o l ǐ ʃ a ʋ oː s t
узнемирити	u z n e m ǐː r i t i
сувозач	s û ʋ o z aː t͡ʃ
beračica	b e r ǎ t͡ʃ i t͡s a
рано	r â n o
појављивати	p o j a ʋ ʎ ǐː ʋ a t i
japanski	j ǎ p aː n s k iː
postariji	p ô s t a r i j iː
Пристег	p r ǐ s t e ɡ
мобилизација	m o b i l i z ǎː t͡s i j a
dvojina	d ʋ o j ǐ n a
прелетати	p r e l ěː t a t i
адмирал	a d m ǐ r aː l
синов	s îː n o ʋ
pak	p â k
polubrat	p o l ǔ b r a t
refleksivno	r ê f l e k s iː ʋ n o
корити	k ǒ r i t i
бескаматни	b ě s k a m a t n iː
izolirano	i z ǒ l iː r a n o
vratnica	ʋ r â t n i t͡s a
ugasiti	u ɡ ǎː s i t i
побеђивати	p o b e d͡ʑ ǐː ʋ a t i
богаз	b ô ɡ a z
galski	ɡ âː l s k iː
aktivist	a k t ǐ ʋ i s t
ideološki	i d e ǒ l o ʃ k iː
slonovski	s l ǒ n o ʋ s k iː
лептир	l ê p t iː r
уопште	ǔ o p ʃ t e
čudotvoran	t͡ʃ û d o t ʋ oː r a n
шпилкарта	ʃ p îː l k aː r t a
ručurda	r ǔ t͡ʃ uː r d a
часно	t͡ʃ â s n o
zločinstvo	z l ǒ t͡ʃ iː n s t ʋ o
izlišno	î z l i ʃ n o
oporavljati	o p ǒ r a ʋ ʎ a t i
Арменац	a r m ěː n a t͡s
наум	n ǎ u m
глибовит	ɡ l i b ǒ ʋ i t
kolajna	k ǒ l aː j n a
прихватити	p r ǐ x ʋ a t i t i
црквенословенски	t͡s r̩ k ʋ e n o s l ǒ ʋ e n s k iː
стидјети	s t ǐː d j e t i
monotonija	m o n o t ǒ n i j a
prevashodan	p r e v ǎ s x o d a n
крајишник	k r ǎ j i ʃ n iː k
црвењети	t͡s r ʋ ě ɲ e t i
pobeći	p ǒ b e t͡ɕ i
несвест	n ê s ʋ eː s t
jajašce	j a j ǎ ʃ t͡s e
sakagija	s a k ǎ ɡ i j a
iznad	î z n a d
prepoznati	p r e p ǒ z n a t i
побјељивати	p o b j e ʎ ǐː ʋ a t i
neizvestan	n ê i z ʋ e s t a n
човјек	t͡ʃ ô ʋ j e k
smotriti	s m ǒ t r i t i
деизам	d e ǐ z a m
перфект	p ě r f e k t
пољубити	p o ʎ ǔː b i t i
шопати	ʃ ô p a t i
танац	t â n a t͡s
pristignuti	p r ǐ s t i ɡ n u t i
rudeti	r ǔː d e t i
vani	ʋ ǎ n i
трпеза	t ř p e z a
mješovit	m j e ʃ ǒ ʋ i t
samotnik	s â m o t n iː k
разложан	r ǎː z l o ʒ a n
козица	k ǒ z i t͡s a
плебејац	p l e b ěː j a t͡s
ostrvo	ô s t r ʋ o
геј	ɡ êː j
australijski	a ǔ s t r aː l iː j s k iː
diletant	d i l ě t a n t
plaćati	p l ǎː t͡ɕ a t i
šupljikav	ʃ u p ʎ ǐ k a ʋ
nepristojan	n ê p r i s t oː j a n
mikrofon	m î k r o f oː n
iskvariti	i s k ʋ ǎː r i t i
vetar	ʋ ê t a r
jučeranji	j u t͡ʃ ě r a ɲ iː
superioran	s û p e r i oː r a n
kolektor	k ǒ l e k t o r
licemjerka	l î t͡s e m j eː r k a
сидвестер	s ǐ d ʋ e s t e r
alergologijski	a l e r ɡ o l ǒ ɡ iː j s k iː
кшатрија	k ʃ ǎ t r i j a
Apolon	a p ǒ l oː n
живети	ʒ ǐː ʋ e t i
sjemenka	s j ě m eː n k a
луднички	l ǔː d n i t͡ʃ k iː
strizati	s t r ǐː z a t i
odjednom	o d j ě d n oː m
transverzala	t r a n s ʋ e r z ǎː l a
iluzionizam	i l u z i o n ǐ z a m
potajan	p ô t aː j a n
зове	z ǒ ʋ e
гробар	ɡ r ǒ b aː r
анексија	a n ě k s i j a
импозантно	i m p o z ǎ n t n o
fotografija	f o t o ɡ r ǎ f i j a
Afrikanac	a f r i k ǎː n a t͡s
зеугма	z e ǔ ɡ m a
mletački	m l ê t a t͡ʃ k iː
cijepati	t͡s i j ěː p a t i
растати	r ǎ s t a t i
kauzativan	k â u z a t iː ʋ a n
prepisivati	p r e p i s ǐː ʋ a t i
виспрен	ʋ î s p r e n
patricijski	p a t r ǐ t s iː j s k iː
lečiti	l ěː t͡ʃ i t i
оживјети	o ʒ ǐː ʋ j e t i
непостојан	n e p ǒː s t o j aː n
lopovština	l o p ǒː ʋ ʃ t i n a
рукица	r ǔ k i t͡s a
biljka	b îː ʎ k a
пакосник	p â k o s n iː k
probava	p r ô b a ʋ a
čemerika	t͡ʃ e m ě r i k a
nasljedan	n ǎː s ʎ e d a n
склониште	s k l ô n iː ʃ t e
upaliti	u p ǎː l i t i
редовно	r ê d oː ʋ n o
причекати	p r ǐ t͡ʃ e k a t i
osiguranje	o s i ɡ u r ǎː ɲ e
modalitet	m o d a l ǐ t eː t
pretražiti	p r e t r ǎː ʒ i t i
improvizacija	i m p r o ʋ i z ǎː t͡s i j a
porudžbina	p ǒ r u d͡ʒ b i n a
izdahnuti	i z d ǎ x n u t i
залуд	z â l uː d
oteti	ǒ t eː t i
polumrak	p ô l u m r aː k
slučajno	s l û t͡ʃ aː j n o
perspektivan	p ê r s p e k t iː ʋ a n
амандман	a m ǎ n d m aː n
вежбати	ʋ ê ʒ b a t i
podrugnuti	p ǒ d r u ɡ n u t i
темељито	t e m ě ʎ i t o
Ś	ɕ
feudalan	f ê u d aː l a n
vidljiv	ʋ ǐ d ʎ i ʋ
prijedložni	p r i j ěː d l o ʒ n iː
оправдати	ǒ p r aː ʋ d a t i
pravoverje	p r â ʋ o ʋ eː r j e
teatar	t e ǎː t a r
криминолог	k r i m i n ǒ l o ɡ
boginja	b ǒ ɡ i ɲ a
neznatno	n ê z n aː t n o
kontaminacija	k o n t a m i n ǎː t͡s i j a
masturbirati	m a s t u r b ǐː r a t i
симултано	s î m u l t aː n o
злоба	z l ǒ b a
амортизација	a m o r t i z ǎː t͡s i j a
затворен	z ǎ t ʋ o r e n
suparnik	s ǔ p aː r n iː k
непотпун	n ê p o t p u n
разблудница	r ǎː z b l u d n i t͡s a
Британија	b r ǐ t aː n i j a
змајев	z m â j e ʋ
змај	z m â j
Флорида	f l ǒ r i d a
кочија	k ǒ t͡ʃ i j a
бала	b â l a
kriška	k r î ʃ k a
масив	m ǎ s iː ʋ
bezizražajno	b ê z i z r a ʒ aː j n o
plesač	p l ě s aː t͡ʃ
казаљка	k ǎ z aː ʎ k a
управљати	ǔ p r a ʋ ʎ a t i
рушевност	r û ʃ eː ʋ n oː s t
лучити	l ǔː t͡ʃ i t i
грмети	ɡ ř m e t i
rukovoditi	r u k o ʋ ǒ d i t i
rastvoriti	r a s t ʋ ǒ r i t i
aktualizirati	a k t u a l i z ǐː r a t i
besa	b ěː s a
spavalica	s p ǎː ʋ a l i t͡s a
грамзивац	ɡ r ǎ m z i ʋ a t͡s
окултан	ǒ k u l t a n
противно	p r ô t iː ʋ n o
импресиван	î m p r e s iː ʋ a n
преврат	p r ê ʋ r aː t
ненавидети	n e n ǎː ʋ i d e t i
хватати	x ʋ â t a t i
забољети	z a b ǒ ʎ e t i
bujon	b ǔ j oː n
igračka	ǐ ɡ r a t͡ʃ k a
сензуалан	s ê n z uː a l a n
spiralan	s p ǐ r aː l a n
одвише	ô d ʋ i ʃ eː
taktika	t ǎ k t i k a
ravnomjerno	r â ʋ n o m j eː r n o
zavladati	z a ʋ l ǎː d a t i
мисионар	m i s i ǒ n aː r
порнографија	p o r n o ɡ r ǎ f i j a
mnenje	m n ěː ɲ e
приљубљивати	p r i ʎ u b ʎ ǐː ʋ a t i
примјењивати	p r i m j e ɲ ǐː ʋ a t i
magičar	m ǎ ɡ i t͡ʃ aː r
танан	t ǎ n a n
спријатељити	s p r i j a t ě ʎ i t i
препричавати	p r e p r i t͡ʃ ǎː ʋ a t i
агресија	a ɡ r ě s i j a
vještak	ʋ j ě ʃ t aː k
коничан	k ǒ n i t͡ʃ a n
вересија	ʋ e r ě s i j a
barakuda	b a r a k ǔː d a
izazivati	i z a z ǐː ʋ a t i
истакнути	i s t ǎ k n u t i
симболизирати	s i m b o l i z ǐː r a t i
пустињачки	p ǔː s t i ɲ aː t͡ʃ k iː
бећаруша	b e t͡ɕ ǎ r u ʃ a
hrabriti	x r ǎː b r i t i
fragmentaran	f r â ɡ m e n t aː r a n
госпоштина	ɡ o s p ǒ ʃ t i n a
zloradost	z l ǒ r a d oː s t
Priština	p r ǐ ʃ t i n a
iznervirati	i z n e r ʋ ǐː r a t i
komanda	k ǒ m aː n d a
njim	ɲ îː m
snebiti	s n ě b i t i
veseo	ʋ ê s e o
тајвански	t â j ʋ aː n s k iː
фармакологија	f a r m a k o l ǒ ɡ i j a
smešiti	s m ěː ʃ i t i
Мјесец	m j ê s eː t͡s
arhiepiskop	a r x i ě p i s k o p
posvemašnji	p ǒ s ʋ e m a ʃ ɲ iː
убитачан	û b i t a t͡ʃ a n
omogućiti	o m o ɡ ǔː t͡ɕ i t i
мелодрама	m ê l o d r aː m a
ponovno	p ô n oː ʋ n o
bizon	b ǐ z oː n
pismenost	p î s m e n oː s t
баздјети	b ǎ z d j e t i
наговест	n â ɡ o ʋ eː s t
znoj	z n ôː j
саламандар	s a l a m ǎ n d a r
смртоносно	s m r t ǒ n o s n o
istosmerno	î s t o s m eː r n o
сноб	s n ô b
ogrebotina	o ɡ r e b ǒ t i n a
listati	l ǐ s t a t i
kroatizam	k r o a t ǐ z a m
бос	b ôː s
petorica	p e t ǒ r i t͡s a
спиритуализам	s p i r i t u a l ǐ z a m
Креолац	k r e ǒː l a t͡s
analfabetizam	a n a l f a b e t ǐ z a m
specijalizacija	s p e t͡s i j a l i z ǎː t͡s i j a
трачница	t r â t͡ʃ n i t͡s a
nepovratan	n ê p o ʋ r aː t a n
савјет	s ǎː ʋ j e t
шетач	ʃ ě t aː t͡ʃ
kršćanstvo	k ř̩ ʃ t͡ɕ aː n s t ʋ o
факат	f â k a t
заклонити	z a k l ǒ n i t i
спаваоница	s p a ʋ a ǒː n i t͡s a
Кенија	k êː n i j a
diplomirati	d i p l o m ǐː r a t i
ауторски	ǎ u t o r s k iː
нерешен	n ě r eː ʃ e n
придјевни	p r ǐː d j eː ʋ n iː
nihče	ˈn i x t ʃ ɛ
обавјештавати	o b a ʋ j e ʃ t ǎː ʋ a t i
mesečarka	m ê s e t͡ʃ aː r k a
materijalistički	m a t e r i j a l ǐ s t i t ʃ k iː
bezbojan	b ê z b oː j a n
bezimenost	b ě z i m e n oː s t
tvrtka	t ʋ r̂ t k a
prsten	p r̂ s t eː n
bezizgledno	b ê z i z ɡ l eː d n o
прћити	p r̩̂ t͡ɕ i t i
zaratiti	z ǎ r a t i t i
lakovjerno	l â k o ʋ j eː r n o
компарација	k o m p a r ǎː t͡s i j a
punktualan	p û n k t u aː l a n
митолог	m i t ǒ l o ɡ
trasa	t r â s a
dadaist	d a d ǎ i s t
ćurka	t͡ɕ ǔː r k a
коприва	k ǒ p r i ʋ a
пљуштати	p ʎ ǔː ʃ t a t i
bajt	b â j t
vojak	ʋ ǒ j aː k
motka	m ô t k a
праваш	p r ǎ ʋ aː ʃ
лоптаст	l ô p t a s t
preferirati	p r e f e r ǐː r a t i
pogača	p ǒ ɡ a t͡ʃ a
častan	t͡ʃ â s t a n
trajan	t r âː j a n
stapati	s t ǎː p a t i
guliti	ɡ ǔː l i t i
blizanac	b l i z ǎː n a t͡s
препирка	p r ě p iː r k a
krknuti	k r̂ k n u t i
блатњав	b l â t ɲ a ʋ
упасти	ǔ p a s t i
узајамно	û z a j aː m n o
igdje	î ɡ d j e
кролавати	k r o l ǎː ʋ a t i
autokracija	a u t o k r ǎ t͡s i j a
фењер	f ě ɲ e r
египтолог	e ɡ i p t ǒ l o ɡ
esencija	e s ě n t͡s i j a
жабљи	ʒ â b ʎ iː
češati	t͡ʃ ě ʃ a t i
ruralan	r ǔ r aː l a n
pastuh	p â s t uː x
tradicijski	t r ǎ d iː t͡s i j s k i
glasan	ɡ l â s a n
ljepojka	ʎ ě p oː j k a
sabor	s ǎː b o r
Квебек	k ʋ e b ê k
брада	b r ǎː d a
јабуковина	j â b u k o ʋ i n a
toplo	t ô p l o
bistroumlje	b î s t r o uː m ʎ e
сувислост	s ǔ ʋ i s l oː s t
makro	m â k r o
шенгајст	ʃ êː n ɡ a j s t
bezbolno	b ě z b oː l n o
ананас	â n a n a s
radikalno	r â d i k aː l n o
Адвент	ǎ d ʋ e n t
silaziti	s ǐ l a z i t i
сувласница	s ǔ ʋ l aː s n i t͡s a
sednica	s ê d n i t͡s a
сладорача	s l a d ǒ r a t͡ʃ a
lizalica	l ǐː z a l i t͡s a
pička	p î t͡ʃ k a
slično	s l ǐ t͡ʃ n o
једнак	j ê d n aː k
ipokrit	ǐ p o k r i t
odustajati	o d ǔ s t a j a t i
лимузина	l i m u z ǐː n a
ратни	r â t n iː
варав	ʋ â r a ʋ
republički	r e p ǔ b l i t͡ʃ k iː
базирати	b a z ǐː r a t i
двојбен	d ʋ ǒ j b e n
veterinarka	ʋ e t e r ǐ n aː r k a
отклањати	ǒ t k l a ɲ a t i
čador	t ʃ â d o r
punoljetničin	p u n ô ʎ e t n i t͡ʃ i n
доктрина	d o k t r ǐː n a
tukac	t ǔː k a t͡s
предодређивати	p r e d o d r e d͡ʑ ǐː ʋ a t i
торњати	t ǒ r ɲ a t i
upornost	u p ǒː r n oː s t
приморавати	p r i m o r ǎː ʋ a t i
izazovno	î z a z oː ʋ n o
ефикасан	ê f i k a s a n
интуиција	i n t u ǐː t͡s i j a
цистерна	t͡s ǐ s t eː r n a
oduzimati	o d ǔ z i m a t i
orah	ǒ r a x
шербет	ʃ ě r b e t
беженство	b ě ʒ eː n s t ʋ o
јашити	j â ʃ i t i
аномалија	a n o m ǎ l i j a
дувар	d û ʋ aː r
потпис	p ǒ t p i s
аукција	a ǔ k t͡s i j a
udruga	û d r u ɡ a
цер	t͡s ê r
абдоменски	a b d ǒː m e n s k iː
severoistok	s e ʋ e r o ǐ s t o k
лом	l ôː m
pozan	p ôː z a n
svanuti	s ʋ ǎ n u t i
прорадити	p r o r ǎː d i t i
temeljito	t e m ě ʎ i t o
maršal	m ǎ r ʃ aː l
лицемерка	l î t͡s e m eː r k a
уклонити	u k l ǒ n i t i
литоралан	l î t o r aː l a n
nešto	n ê ʃ t o
гиб	ɡ îː b
dogovor	d ô ɡ o ʋ oː r
производ	p r o ǐ z ʋ o d
vratiti	ʋ r ǎː t i t i
regrutirati	r e ɡ r u t ǐː r a t i
smisao	s m îː s a o
лонгитуда	l o n ɡ i t ǔː d a
Beotija	b e ǒ t i j a
vjetrobran	ʋ j ê t r o b r aː n
obavezati	o b a ʋ ěː z a t i
битка	b î t k a
ludeti	l ǔː d e t i
кошаркаш	k o ʃ ǎ r k aː ʃ
мисао	m îː s a o
злонамеран	z l o n ǎː m eː r a n
udžbenik	û d͡ʒ b e n iː k
многостран	m n o ɡ ǒ s t r a n
пријећи	p r i j êː t͡ɕ i
изнијети	ǐ z n j eː t i
аметице	ǎ m e t i t͡s e
хлад	x l âː d
акупунктура	a k u p u n k t ǔː r a
štednja	ʃ t ěː d ɲ a
коса	k ǒ s a
stan	s t âː n
меридијан	m e r i d ǐ j aː n
sjediniti	s j e d ǐː n i t i
uzor	ǔː z o r
sujeveran	s û j e ʋ eː r a n
rukavičarski	r u k ǎ ʋ i t͡ʃ aː r s k iː
храпав	x r â p a ʋ
osmica	ǒ s m i t͡s a
sabirač	s a b ǐ r aː t͡ʃ
opkop	ǒ p k o p
štrajfati	ʃ t r â j f a t i
nikoji	n î k o j iː
привикавати	p r i ʋ i k ǎː ʋ a t i
redovit	r e d ǒ ʋ i t
štampa	ʃ t âː m p a
тополошки	t o p ǒ l o ʃ k iː
красноречје	k r a s n ǒ r eː t͡ʃ j e
pomicati	p ǒ m i t͡s a t i
анархичан	a n ǎ r x i t͡ʃ a n
сврачји	s ʋ r â t͡ʃ j iː
пискати	p î s k a t i
krakatost	k r ǎ k a t oː s t
špric	ʃ p r î t͡s
мало	m â l o
снежан	s n ê ʒ a n
nogomet	n ô ɡ o m eː t
okrivljivati	o k r i ʋ ʎ ǐː ʋ a t i
сурађивати	s u r a d͡ʑ ǐː ʋ a t i
заредавати	z a r e d ǎː ʋ a t i
tekstopisac	t e k s t o p ǐː s a t͡s
naročito	n ǎː r o t͡ʃ i t o
особан	ǒ s o b a n
породити	p o r ǒ d i t i
крчмарски	k r̂ t͡ʃ m a r s k iː
stih	s t î x
заједнички	z â j e d n i t ʃ k iː
vukojebina	ʋ u k o j ě b i n a
етнологија	e t n o l ǒ ɡ i j a
šaptati	ʃ ǎ p t a t i
primjesa	p r îː m j e s a
kleptomanija	k l e p t o m ǎ n i j a
четверокут	t͡ʃ ê t ʋ e r o k uː t
медвед	m ě d ʋ e d
секташки	s ě k t aː ʃ k iː
подилазити	p o d ǐ l a z i t i
amorfno	ǎ m o r f n o
антипод	a n t ǐ p oː d
preći	p r êː t͡ɕ i
liptati	l ǐ p t a t i
bljutav	b ʎ û t a ʋ
kvota	k ʋ ǒː t a
ramazan	r a m ǎ z aː n
судац	s ǔː d a t͡s
slaboumnost	s l a b o ǔː m n oː s t
napustiti	n a p ǔ s t i t i
nevelik	n ě ʋ e l i k
gnojivo	ɡ n ô j iː ʋ o
labav	l â b a ʋ
tvrdokoran	t ʋ r̂ d o k oː r a n
izraelski	î z r a e l s k iː
наследан	n ǎː s ʎ e d a n
šparmajstor	ʃ p ǎː r m aː j s t o r
плућни	p l ûː t͡ɕ n iː
аварски	ǎ ʋ aː r s k iː
bankroter	b a n k r ǒ t eː r
придјевски	p r ǐː d j e ʋ s k iː
руинирати	r u i n ǐː r a t i
autizam	a u t ǐ z a m
buva	b ǔ ʋ a
neobično	n ê o b i t͡ʃ n o
луталица	l ǔː t a l i t͡s a
корозија	k ǒ r oː z i j a
десет	d ê s e t
upošljavati	u p o ʃ ʎ ǎː ʋ a t i
kozičavost	k ǒ z i t͡ʃ a ʋ oː s t
improvizator	i m p r o ʋ ǐ z aː t o r
transmisija	t r a n s m ǐ s i j a
vreća	ʋ r ê t͡ɕ a
ружичаст	r û ʒ i t͡ʃ a s t
oronuo	o r ǒ n u o
nemo	n êː m o
просвјед	p r ǒ s ʋ j e d
кука	k û k a
избечити	i z b ěː t͡ʃ i t i
краљевски	k r ǎː ʎ e ʋ s k iː
панславист	p a n s l ǎ ʋ i s t
praznični	p r âː z n i t͡ʃ n iː
цокл	t͡s ǒ k l
sinčić	s ǐ n t͡ʃ i t͡ɕ
водопија	ʋ o d ǒ p i j a
откинути	ǒ t k i n u t i
sarma	s ǎ r m a
paša	p â ʃ a
штамлокал	ʃ t â m l o k aː l
научити	n a ǔ t͡ʃ i t i
aforist	a f ǒ r i s t
vjeroispovijest	ʋ j e r o ǐ s p o ʋ j eː s t
nesit	n ê s i t
биљежница	b ǐ ʎ e ʒ n i t͡s a
treba	t r ěː b a
Кадеш	k ǎ d e ʃ
rukopisni	r û k o p iː s n iː
махнути	m ǎː x n u t i
pretvarač	p r e t ʋ ǎ r aː t͡ʃ
raskoljivati	r a s k o ʎ ǐː ʋ a t i
шелман	ʃ ê l m a n
kolonizator	k o l o n ǐ z aː t o r
хладноратовски	x l a d n o r ǎ t o ʋ s k iː
zaboravnost	z a b o r ǎː ʋ n oː s t
vuna	ʋ û n a
primjetljiv	p r i m j ě t ʎ i ʋ
одабрати	o d ǎ b r a t i
насљедница	n ǎː s ʎ e d n i t͡s a
Buzet	b ǔ z e t
рукометаш	r u k o m ě t aː ʃ
pohlepnost	p ô x l eː p n oː s t
svršetak	s ʋ r ʃ ěː t a k
relativitet	r e l a t i ʋ ǐ t eː t
zlo	z l ô
vozarina	ʋ o z ǎ r i n a
левица	l ě ʋ i t͡s a
оаза	o ǎː z a
дом	d ô m
езотеричан	e z o t ě r i t͡ʃ a n
најам	n ǎː j a m
Африканка	a f r ǐ k aː n k a
исплетати	ǐ s p l e t a t i
postignuti	p ǒ s t i ɡ n u t i
медијски	m êː d iː j s k iː
друкчији	d r ǔ k t͡ʃ i j iː
ахирет	ǎː x i r e t
ранити	r â n i t i
mandarin	m a n d ǎ r iː n
nadvojvoda	n â d ʋ o j ʋ o d a
neutralizirati	n e u t r a l i z ǐː r a t i
афикс	ǎ f i k s
стишати	s t ǐ ʃ a t i
прерачунавати	p r e r a t͡ʃ u n ǎː ʋ a t i
хијерархијски	x i j e r ǎ r x iː j s k iː
vojvodstvo	ʋ ǒ j ʋ o d s t ʋ o
необјективно	n ê o b j e k t i ʋ n o
tehničar	t ě x n i t͡ʃ aː r
тржишни	t r̂ ʒ iː ʃ n iː
облигација	o b l i ɡ ǎː t͡s i j a
izbirljiv	i z b ǐ r ʎ i ʋ
подсмијех	p ô d s m i j eː x
zastor	z ǎː s t o r
суделовати	s ǔ d e l o ʋ a t i
истрошити	i s t r ǒ ʃ i t i
човјечанство	t͡ʃ o ʋ j e t͡ʃ ǎ n s t ʋ o
slatkorječiv	s l a t k o r j ě t͡ʃ i ʋ
верификатор	ʋ e r i f ǐ k aː t o r
longituda	l o n ɡ i t ǔː d a
poletjeti	p o l ě t j e t i
курцшлус	k û r t͡s ʃ l u s
концентрат	k o n t͡s ě n t r aː t
ћурак	t͡ɕ ǔ r a k
отпочивати	o t p o t͡ʃ ǐː ʋ a t i
kršiti	k ř ʃ i t i
проучавање	p r o u t͡ʃ ǎː ʋ aː ɲ e
grobnica	ɡ r ô b n i t͡s a
степски	s t ê p s k iː
шпера	ʃ p ěː r a
срдачност	s r̩̂ d aː t͡ʃ n oː s t
будница	b ǔː d n i t͡s a
бајка	b âː j k a
obračunavati	o b r a t͡ʃ u n ǎː ʋ a t i
затишје	z ǎː t iː ʃ j e
hrabar	x r ǎː b a r
snalaziti	s n ǎ l a z i t i
сетва	s ê t ʋ a
nevjesta	n ě ʋ j e s t a
зачудо	z ǎ t͡ʃ u d o
perje	p êː r j e
snošljivo	s n ǒ ʃ ʎ i ʋ o
несавршен	n e s ǎ ʋ r ʃ e n
osećajno	ô s e t͡ɕ aː j n o
nejasan	n ě j a s a n
jezgro	j ěː z ɡ r o
snabdeti	s n ǎ b d e t i
непробојан	n ê p r o b oː j a n
sopranistica	s o p r a n ǐ s t i t͡s a
лажирати	l a ʒ ǐː r a t i
kakofonično	k a k o f ǒ n i t͡ʃ n o
zabuna	z âː b u n a
prepiliti	p r e p ǐː l i t i
алеутски	a l ě u t s k iː
neurastenija	n e u r a s t ě n i j a
turbulentan	t u r b ǔ l e n t a n
spasilac	s p ǎ s i l a t͡s
истраживати	i s t r a ʒ ǐː ʋ a t i
pivski	p îː ʋ s k iː
časovit	t͡ʃ a s ǒ ʋ i t
луталац	l ǔː t a l a t͡s
патика	p ǎ t i k a
људождер	ʎ u d ǒ ʒ d e r
мормонизам	m o r m o n ǐ z a m
дјевац	d j ěː ʋ a t͡s
пролом	p r ǒ l o m
одмеравати	o d m e r ǎː ʋ a t i
трнина	t ř̩ n i n a
проучити	p r o ǔ t͡ʃ i t i
verenik	ʋ ê r e n iː k
superlativan	s û p e r l a t iː ʋ a n
nektar	n ê k t a r
потомство	p ǒ t oː m s t ʋ o
узбуђеност	ǔ z b uː d͡ʑ e n oː s t
neopozivo	n e o p ǒ z i ʋ o
prebacivati	p r e b a t͡s ǐː ʋ a t i
đevojčica	d͡ʑ e ʋ ǒ j t͡ʃ i t͡s a
stočarski	s t ô t͡ʃ a r s k iː
kriminalan	k r î m i n aː l a n
контаминација	k o n t a m i n ǎː t͡s i j a
petao	p ěː t a o
sabljica	s â b ʎ i t͡s a
naguravati	n a ɡ u r ǎː ʋ a t i
otrcanost	ǒ t r̩̄ t͡s aː n oː s t
knjižnica	k ɲ ǐː ʒ n i t͡s a
založiti	z a l ǒ ʒ i t i
bira	b î r a
mač	m â t͡ʃ
pripremiti	p r i p r ěː m i t i
tata	t â t a
kisnuti	k î s n u t i
голишавац	ɡ o l ǐ ʃ a ʋ a t͡s
патос	p ǎ t o s
epigram	e p ǐ ɡ r a m
bočica	b ô t͡ʃ i t͡s a
aoristni	â o r i s t n iː
intelektualan	î n t e l e k t u aː l a n
samozadovoljavati	s a m o z a d o ʋ o ʎ ǎː ʋ a t i
главни	ɡ l ǎ ʋ n iː
štreka	ʃ t r ě k a
finansije	f i n ǎ n s i j e
очекивање	o t͡ʃ e k ǐː ʋ aː ɲ e
достава	d ô s t a ʋ a
шраубнцијер	ʃ r ǎ u b n t͡s i j e r
аутомат	a u t ǒ m aː t
таласаст	t a l ǎ s a s t
dvije	d ʋ î j e
trgovati	t r ɡ ǒ ʋ a t i
фокус	f ǒː k u s
вук	v ûː k
хортикултура	x o r t i k u l t ǔː r a
temperamentnost	t e m p e r ǎ m e n t n oː s t
несаломљив	n e s a l ǒ m ʎ i ʋ
poznatost	p ô z n aː t oː s t
zanemariv	z a n e m ǎ r i ʋ
потплатити	p o t p l ǎː t i t i
importirati	i m p o r t ǐː r a t i
igalo	ǐ ɡ a l o
извршни	ǐ z ʋ r ʃ n iː
neumeren	n e ǔ m e r e n
rajčica	r ǎ j t͡ʃ i t͡s a
salitreni	s ǎ l i t r e n iː
ustrajan	û s t r aː j a n
љупкост	ʎ û p k oː s t
ljudskost	ʎ û d s k oː s t
ogled	ô ɡ l eː d
менаџер	m ě n a d͡ʒ e r
teutonski	t ě u t oː n s k iː
generacija	ɡ e n e r ǎː t͡s i j a
monoton	m ô n o t o n
totalitaran	t ô t a l i t aː r a n
porota	p ô r o t a
rodoslovlje	r ô d o s l oː ʋ ʎ e
сардела	s ǎ r d e l a
омогућити	o m o ɡ ǔː t͡ɕ i t i
mučitelj	m ǔ t͡ʃ i t e ʎ
impertinentan	i m p e r t i n ě n t a n
педијатар	p e d ǐ j aː t a r
Ulcinj	ǔ l t͡s i ɲ
магличаст	m ǎ ɡ l i t͡ʃ a s t
internacionalizam	i n t e r n a t͡s i o n a l ǐ z a m
алзашки	ǎ l z a ʃ k iː
пацифизам	p a t͡s i f ǐ z a m
duvar	d û ʋ aː r
заповједник	z a p o ʋ j ě d n iː k
топоним	t o p ǒ n iː m
сасма	s ǎ s m a
истосмеран	î s t o s m eː r a n
пролазан	p r ǒː l a z a n
прозивати	p r o z ǐː ʋ a t i
домаћица	d o m ǎ t͡ɕ i t͡s a
неутешан	n ê u t e ʃ a n
гавран	ɡ â ʋ r aː n
prestup	p r ěː s t u p
spanać	s p ă n aː t͡ɕ
konac	k ǒ n a t͡s
жељети	ʒ ě ʎ e t i
jugo	j û ɡ o
antifašizam	a n t i f a ʃ ǐ z a m
олакотност	ô l a k o t n oː s t
одмагати	o d m ǎː ɡ a t i
safer	s ǎ f e r
разорити	r a z ǒ r i t i
uspjeti	ǔ s p j e t i
неостварив	n e o s t ʋ ǎ r i ʋ
хорна	x ôː r̩ n a
панентеизам	p a n e n t e ǐ z a m
архитектица	a r x ǐ t e k t i t͡s a
autohton	a u t ǒ x t o n
Titograd	t î t o ɡ r aː d
крстопуће	k r s t ǒ p uː t͡ɕ e
халуцинирати	x a l u t͡s i n ǐː r a t i
бацач	b ǎ t͡s aː t͡ʃ
гостољубив	ɡ o s t o ʎ ǔ b i ʋ
predočivati	p r e d o t͡ʃ ǐː ʋ a t i
прекопати	p r e k ǒ p a t i
sebi	s ê b i
promišljeno	p r ǒ m i ʃ ʎ e n o
vjetrenjača	ʋ j e t r ě ɲ a t͡ʃ a
летак	l ê t a k
socijalizam	s o t͡s i j a l ǐ z a m
поставити	p ǒ s t a ʋ i t i
посљедица	p ǒ s ʎ e d i t͡s a
tri	t r îː
слово	s l ô ʋ o
feljton	f ě ʎ t oː n
špur	ʃ p ûː r
забункерирати	z a b u n k e r ǐː r a t i
anđelčić	a n d͡ʑ ě l t͡ʃ i t͡ɕ
џепар	d͡ʒ ê p aː r
besmislenost	b ě s m i s l e n oː s t
križalina	k r ǐ ʒ a l i n a
vrtoglavo	ʋ r t ǒ ɡ l a ʋ o
тескера	t ê s k e r a
потезати	p o t ěː z a t i
его	êː ɡ o
имагинација	i m a ɡ i n ǎː t͡s i j a
ukočiti	u k ǒː t͡ʃ i t i
soliti	s ǒ l i t i
злурадост	z l ǔ r a d oː s t
šiba	ʃ î b a
Indonezija	i n d ǒ n eː z i j a
опорављати	o p ǒ r a ʋ ʎ a t i
melodrama	m ê l o d r aː m a
ekonomski	e k ǒ n o m s k iː
svetogrđe	s ʋ ê t o ɡ r̄ d͡ʑ e
primjećivati	p r i m j e t͡ɕ ǐː ʋ a t i
haićanski	x a ǐː t͡ɕ a n s k iː
zatvor	z ǎː t ʋ o r
kda	ˈɡ d aː
пепељаст	p ê p e ʎ a s t
блебетати	b l e b ě t a t i
бициклистика	b i t͡s i k l ǐ s t i k a
самаритански	s a m a r ǐ t aː n s k i
delovati	d ê l o ʋ a t i
istjeravati	i s t j e r ǎː ʋ a t i
introspektivan	i n t r o s p ě k t iː ʋ a n
паучић	p â u t͡ʃ i t͡ɕ
zvaničan	z ʋ ǎ n i t͡ʃ a n
Алабама	a l a b ǎ m a
котачић	k o t ǎ t͡ʃ i t͡ɕ
svilast	s ʋ î l a s t
просац	p r ǒ s a t͡s
čitljiv	t͡ʃ ǐ t ʎ i ʋ
popustljivo	p o p ǔ s t ʎ i ʋ o
amorfan	ǎ m o r f a n
iscuriti	i s t͡s ǔː r i t i
šajba	ʃ âː j b a
хвалисаво	x ʋ a l ǐ s a ʋ o
one	ǒ n e
glodati	ɡ l ǒ d a t i
pijandura	p i j ǎ n d u r a
расправити	r ǎ s p r a ʋ i t i
obrisati	ǒ b r i s a t i
амелиорација	a m e l i o r ǎː t͡s i j a
proricati	p r o r ǐː t͡s a t i
predlagati	p r e d l ǎː ɡ a t i
pudl	p ǔː d l
pojedinac	p o j e d ǐː n a t͡s
богорадити	b o ɡ o r ǎː d i t i
bijes	b i j êː s
Трст	t r̩̂ s t
Badnjak	b â d ɲ aː k
uzleteti	u z l ě t e t i
албанолошки	a l b a n ǒ l o ʃ k iː
izliječiti	i z l i j ěː t͡ʃ i t i
odazvati	o d ǎ z ʋ a t i
мекоћа	m e k ǒ t͡ɕ a
агресорски	ǎ ɡ r e s o r s k iː
примерено	p r ǐ m e r e n o
hipotetičnost	x i p o t ě t i t͡ʃ n oː s t
plavojka	p l ǎ ʋ oː j k a
специјалан	s p ê t͡s i j aː l a n
prijesan	p r i j ěː s a n
располовити	r a s p o l ǒ ʋ i t i
гмизати	ɡ m î z a t i
свагдањи	s ʋ ǎ ɡ d a ɲ iː
eholalija	e x o l ǎ l i j a
svetioničar	s ʋ e t i ǒ n i t͡ʃ aː r
rashlađivati	r a s x l a d͡ʑ ǐː ʋ a t i
zijevati	z j ěː ʋ a t i
Kain	k ǎ i n
регрутација	r e ɡ r u t ǎː t͡s i j a
калкулатор	k a l k ǔ l aː t o r
трпети	t řː p e t i
sanjar	s ǎ ɲ aː r
траса	t r â s a
induktivno	î n d u k t iː ʋ n o
недостижан	n ê d o s t i ʒ a n
akcentirati	a k t͡s e n t ǐː r a t i
skoro	s k ǒ r o
štiga	ʃ t ǐː ɡ a
вагати	ʋ ǎː ɡ a t i
хотелски	x ǒ t e l s k iː
звиждачица	z ʋ i ʒ d ǎ t͡ʃ i t͡s a
потписник	p ǒ t p i s n iː k
верити	ʋ ê r i t i
фригидан	f r ǐ ɡ iː d a n
kriptologija	k r i p t o l ǒ ɡ i j a
arhiv	ǎ r x iː ʋ
лов	l ôː ʋ
неуставан	n ê u s t aː ʋ a n
zagonetati	z a ɡ o n ěː t a t i
досезати	d o s ěː z a t i
сељанин	s ě ʎ a n i n
изгред	î z ɡ r eː d
gotica	ɡ ǒ t i t͡s a
намакнути	n a m ǎ k n u t i
оружје	ǒ r uː ʒ j e
bjelance	b j e l ǎː n t͡s e
krajputašica	k r a j p u t ǎ ʃ i t͡s a
јењати	j ě ɲ a t i
osifikacija	o s i f i k ǎː t͡s i j a
сачинити	s a t͡ʃ ǐ n i t i
кметство	k m ě t s t ʋ o
dekret	d ě k r eː t
изум	ǐ z u m
шљунчан	ʃ ʎ ǔ n t͡ʃ a n
radovati	r â d o ʋ a t i
izbježljiv	i z b j ě ʒ ʎ i ʋ
rečit	r ě t͡ʃ i t
pratilac	p r ǎ t i l a t͡s
kič	k î t͡ʃ
папирничар	p a p ǐː r n i t͡ʃ aː r
Анкара	ǎ n k a r a
okruženje	o k r u ʒ ěː ɲ e
аналитичар	a n a l ǐ t i t͡ʃ aː r
бућ	b û t͡ɕ
košnuti	k ô s n u t i
partijski	p ǎ r t iː j s k iː
анголски	ǎ n ɡ o l s k iː
сименталски	s i m ě n t aː l s k iː
pripovijetka	p r î p o ʋ i j eː t k a
мода	m ǒː d a
neopoziv	n e o p ǒ z i ʋ
kišovit	k i ʃ ǒ ʋ i t
lijeha	l i j ě x a
обзорје	ǒ b z oː r j e
podnevnik	p ǒː d n eː ʋ n iː k
biznismen	b ǐ z n i s m e n
Tuđman	t û d͡ʑ m a n
ножица	n ǒ ʒ i t͡s a
potpredsjednik	p o t p r ěː d s j e d n iː k
ментални	m ě n t aː l n iː
пробуђивати	p r o b u d͡ʑ ǐː ʋ a t i
катапулт	k a t ǎ p u l t
iguman	î ɡ u m aː n
беланчевина	b e l ǎː n t͡ʃ e ʋ i n a
srebren	s r ê b r e n
крадљивац	k r ǎ d ʎ i ʋ a t͡s
kanadski	k ǎ n a d s k iː
забртвљеност	z ǎ b r t ʋ ʎ e n oː s t
iskorak	î s k o r aː k
признати	p r ǐ z n a t i
водич	ʋ ǒ d iː t͡ʃ
промишљеност	p r ǒ m i ʃ ʎ e n oː s t
istinoljublje	î s t i n o ʎ uː b ʎ e
белихтати	b e l ǐ x t a t i
jednostavno	j ê d n o s t aː ʋ n o
nuzgred	n û z ɡ r eː d
reptil	r ě p t iː l
srdačnost	s r̩̂ d aː t͡ʃ n oː s t
бајат	b ǎ j a t
probrati	p r ǒ b r a t i
осредњи	ô s r e d ɲ iː
podbosti	p ǒ d b o s t i
jes	j ê sː
замамити	z a m ǎː m i t i
проучавати	p r o u t͡ʃ ǎː ʋ a t i
шумно	ʃ ûː m n o
канаринац	k a n a r ǐː n a t͡s
мисал	m ǐ s aː l
обавештајни	ô b a ʋ e ʃ t aː j n iː
Крапинац	k r a p ǐː n a t͡s
dejstvovati	d ě j s t ʋ o ʋ a t i
истребљивати	i s t r e b ʎ ǐː ʋ a t i
automobilist	a u t o m o b ǐ l i s t
продаја	p r ô d a j a
debeo	d ě b e o
tane	t â n e
seliti	s ě l i t i
регула	r ê ɡ u l a
podsticati	p ǒ d s t i t͡s a t i
селендра	s ě l eː n d r a
doktorica	d ô k t o r i t͡s a
latinizacija	l a t i n i z ǎː t͡s i j a
гутати	ɡ ǔ t a t i
škrgutati	ʃ k r ɡ ǔ t a t i
ситница	s i t n ǐ t͡s a
vjernica	ʋ j êː r n i t͡s a
delikatno	d ê l i k aː t n o
prerušiti	p r ě r u ʃ i t i
nezaboravljiv	n e z a b o r ǎ ʋ ʎ i ʋ
sjedati	s j ê d a t i
nem	n êː m
silogizam	s i l o ɡ ǐ z a m
izjašnjavati	i z j a ʃ ɲ ǎː ʋ a t i
обмана	ô b m a n a
konverzacija	k o n ʋ e r z ǎː t͡s i j a
voleti	ʋ ǒ l e t i
boravak	b ǒ r a ʋ a k
ljigavo	ʎ î ɡ a ʋ o
осветољубив	o s ʋ e t o ʎ ǔ b i ʋ
tjelovježba	t j ě l o ʋ j e ʒ b a
крчмити	k r̂ t͡ʃ m i t i
jednina	j e d n ǐ n a
primetljivo	p r i m ě t ʎ i ʋ o
капица	k â p i t͡s a
vera	ʋ ê r a
нордијски	n ǒ r d iː j s k iː
ceremonijalan	t͡s ê r e m o n i j aː l a n
glibovit	ɡ l i b ǒ ʋ i t
brodica	b r ǒ d i t͡s a
стрмо	s t r̂ m o
raspadati	r ǎ s p a d a t i
спаваћи	s p ǎ ʋ aː t͡ɕ iː
торзија	t ǒ r z i j a
rapsodija	r ǎ p s oː d i j a
безумност	b ě z uː m n oː s t
инфантилно	î n f a n t iː l n o
бродић	b r ǒ d iː t͡ɕ
bojažljiv	b o j ǎ ʒ ʎ i ʋ
temporalan	t ê m p o r aː l a n
nesamostalno	n ê s a m o s t aː l n o
учвршћивати	u t͡ʃ ʋ r̩ ʃ t͡ɕ ǐː ʋ a t i
pregledno	p r ěː ɡ l e d n o
садитељ	s ǎ d i t e ʎ
божиј	b ô ʒ iː j
Ahil	ǎ x i l
štaubzauger	ʃ t ǎ u b z a u ɡ e r
багер	b ǎː ɡ e r
šema	ʃ ěː m a
безбојан	b ê z b oː j a n
накит	n ǎː k i t
акултурација	a k u l t u r ǎː t͡s i j a
панамски	p ǎ n a m s k iː
vječan	ʋ j ê t͡ʃ a n
palac	p â l a t͡s
uricati	u r ǐː t s a t i
буба	b û b a
šmugler	ʃ m û ɡ l e r
испасти	ǐ s p a s t i
секретарски	s e k r ě t aː r s k iː
alternacija	a l t e r n ǎː t͡s i j a
милосрдан	m î l o s rː d a n
Сијам	s ǐ j aː m
aktivan	â k t iː ʋ a n
ловокрадица	l o ʋ o k r ǎ d i t͡s a
умереност	ǔ m e r e n oː s t
prosperirati	p r o s p e r ǐː r a t i
злонамерност	z l o n ǎː m eː r n oː s t
trgati	t r̂ ɡ a t i
џигерица	d͡ʒ ǐ ɡ e r i t͡s a
opasno	ô p aː s n o
ганути	ɡ ǎ n u t i
izvlačiti	i z ʋ l ǎː t͡ʃ i t i
preletjeti	p r e l ě t j e t i
њок	ɲ ô k
спона	s p ô n a
opsesivno	ô p s e s iː ʋ n o
bubanj	b ûː b a ɲ
preda	p r ê d a
завера	z âː ʋ e r a
izbeći	ǐ z b e t͡ɕ i
povraćati	p ǒ ʋ r a t͡ɕ a t i
sakatost	s ǎ k a t oː s t
козјетина	k ǒ z j e t i n a
giljotinirati	ɡ i ʎ o t i n ǐː r a t i
здравље	z d r âː ʋ ʎ e
preotimati	p r e ǒ t i m a t i
skaut	s k ǎ u t
крофна	k r ǒː f n a
опстанак	ǒ p s t a n a k
на	n a
хвалиша	x ʋ ǎ l i ʃ a
skratiti	s k r ǎː t i t i
зујара	z ǔ j a r a
пелуд	p ě l u d
до	d ô
vertikala	ʋ e r t i k ǎː l a
умишљати	u m ǐː ʃ ʎ a t i
сачињавати	s a t͡ʃ i ɲ ǎː ʋ a t i
авионски	a ʋ ǐ o n s k iː
iznositi	i z n ǒ s i t i
punoletan	p û n o l e t a n
Burma	b ûː r m a
страхота	s t r a x ǒ t a
obrijati	ǒ b r i j a t i
kiptjeti	k ǐ p t j e t i
љубица	ʎ û b i t͡s a
naseobina	n ǎː s e o b i n a
čopor	t͡ʃ ô p o r
бањ	b â ɲ
аденски	ǎː d e n s k iː
plitko	p l îː t k o
шибати	ʃ ǐː b a t i
тесати	t ě s a t i
грудњак	ɡ r ûː d ɲ aː k
штикла	ʃ t ǐ k l a
помислити	p ǒ m i s l i t i
незрео	n ě z r e o
kukavica	k û k a ʋ i t͡s a
ovsen	ô ʋ s e n
važan	ʋ ǎː ʒ a n
змијица	z m ǐ j i t͡s a
ijekavski	i j ěː k a ʋ s k iː
ништаван	n î ʃ t aː ʋ a n
razumno	r â z uː m n o
sklonost	s k l ô n oː s t
trkačica	t r̩ k ǎ t͡ʃ i t͡s a
хомеоморфизам	x o m e o m o r f ǐ z a m
рехабилитирати	r e x a b i l i t ǐː r a t i
viti	ʋ î t i
постојање	p ǒː s t o j aː ɲ e
zaposlen	z ǎ p o s l e n
еуфорично	e u f ǒ r i t͡ʃ n o
чвор	t͡ʃ ʋ ôː r
трпељив	t r p ě ʎ i ʋ
медитерански	m e d i t ě r aː n s k iː
уштеда	û ʃ t e d a
irha	ǐ r x a
nasmejavati	n a s m e j ǎː ʋ a t i
tijekom	t i j e k o m
paranoik	p a r a n ǒ i k
pobuna	p ô b u n a
kriv	k r îː ʋ
стражњица	s t r â ʒ ɲ i t͡s a
пласирати	p l a s ǐː r a t i
barbadoski	b a r b ǎː d o s k iː
ткати	t k â t i
veslački	ʋ ě s l aː t ʃ k iː
трачати	t r â t͡ʃ a t i
ауторитет	a u t o r ǐ t eː t
zastajati	z ǎ s t a j a t i
fizioterapeutkinja	f i z i o t e r a p ě u t k i ɲ a
ишчупати	i ʃ t͡ʃ ǔ p a t i
mazati	m â z a t i
раван	r ǎː ʋ a n
вјетрић	ʋ j ê t r i t͡ɕ
јесенас	j e s ě n a s
presahnuti	p r e s ǎ x n u t i
штрајх	ʃ t r â j x
шписбиргер	ʃ p îː s b i r ɡ e r
doviknuti	d o ʋ ǐː k n u t i
školjkast	ʃ k ô ʎ k a s t
omladina	ǒ m l a d i n a
nepismenost	n ě p i s m e n oː s t
higroskopan	x î ɡ r o s k o p a n
ikoji	î k o j iː
nepravilan	n ê p r a ʋ iː l a n
delegacija	d e l e ɡ ǎː t͡s i j a
штеточина	ʃ t e t ǒ t͡ʃ i n a
sekundaran	s ê k u n d aː r a n
наткрилити	n a t k r ǐː l i t i
минут	m ǐ n uː t
увредити	u ʋ r ěː d i t i
стрвинар	s t ř ʋ i n aː r
коначно	k ǒ n a t͡ʃ n o
barel	b ǎ r e l
muktaš	m ǔ k t aː ʃ
нобеловац	n ǒ b e l o ʋ a t͡s
вражји	ʋ r ǎ ʒ j iː
zerzevat	z e r z ě ʋ aː t
jeziv	j ě z i ʋ
latvijski	l ǎ t ʋ iː j s k iː
камионџија	k a m i ǒ n d͡ʒ i j a
dosje	d ǒ s j eː
Ištvan	î ʃ t ʋ aː n
kurvica	k ûː r ʋ i t͡s a
фолклорист	f o l k l ǒ r i s t
zakopati	z a k ǒ p a t i
konferencija	k o n f e r ě n t͡s i j a
beštija	b ě ʃ t i j a
kontemplativan	k ô n t e m p l a t iː ʋ a n
коментирати	k o m e n t ǐː r a t i
usluga	û s l u ɡ a
žumance	ʒ u m ǎː n t͡s e
љубљени	ʎ ûː b ʎ e n iː
злокобан	z l ǒ k o b a n
rijetkost	r i j ěː t k oː s t
list	l îː s t
zelenaš	z e l ě n aː ʃ
Madrid	m ǎ d r iː d
imaginarno	î m a ɡ i n aː r n o
razgovorljiv	r a z ɡ o ʋ ǒ r ʎ i ʋ
шубара	ʃ ǔ b a r a
рен	r ê n
žep	ʒ æ p
лук	l û k
анестезија	a n e s t ě z i j a
прихваћати	p r ǐ x ʋ a t͡ɕ a t i
šmrkati	ʃ m řː k a t i
становати	s t a n ǒ ʋ a t i
šte	ʃ t ɛ
nekada	n ê k a d a
začetak	z a t͡ʃ ěː t a k
упливати	ǔ p l i ʋ a t i
полиандрија	p o l i ǎ n d r i j a
algebra	ǎ l ɡ eː b r a
малољетнички	m â l o ʎ e t n i t͡ʃ k iː
шестосједалница	ʃ e s t o s j ě d aː l n i t͡s a
trezvenjakinja	t r e z ʋ e ɲ ǎ k i ɲ a
prihvatljivost	p r i x ʋ ǎ t ʎ i ʋ oː s t
сванути	s ʋ ǎ n u t i
синтерирање	s i n t e r ǐː r aː ɲ e
одмалена	o d m a l ě n a
predsjednik	p r ěː d s j e d n iː k
раса	r â s a
преполовити	p r e p o l ǒ ʋ i t i
čednost	t͡ʃ ê d n oː s t
изазивач	i z a z ǐ ʋ aː t͡ʃ
pred	p r ê d
разломити	r a z l ǒ m i t i
Perun	p ê r u n
смјерати	s m j ěː r a t i
prijemnik	p r ǐ j eː m n iː k
шурак	ʃ u r a k
objašnjiv	o b j ǎ ʃ ɲ i ʋ
pomilovati	p ǒ m i l o ʋ a t i
корпулентан	k o r p u l ě n t a n
анатомија	a n a t ǒ m i j a
lisa	l î s a
башче	b ǎː ʃ t͡ʃ e
alofon	â l o f oː n
духовник	d u x ǒ ʋ n iː k
тетоважа	t e t o ʋ ǎː ʒ a
čovječan	t͡ʃ ô ʋ j e t͡ʃ a n
загосподарити	z a ɡ o s p o d ǎː r i t i
neobranjivo	n e o b r ǎ ɲ i ʋ o
voćnjak	ʋ ô t͡ɕ ɲ aː k
violončelo	ʋ i o l ǒ n t͡ʃ e l o
џевајир	d͡ʒ e ʋ ǎː j i r
одијело	o d j ěː l o
veselje	ʋ e s ěː ʎ e
надимак	n ǎː d i m a k
мутав	m û t a ʋ
налазити	n ǎ l a z i t i
бедно	b êː d n o
дражестан	d r â ʒ e s t a n
jasmin	j ǎ s m iː n
оивичити	ǒ i ʋ i t͡ʃ i t i
kormilo	k ǒ r m i l o
ukrutiti	u k r ǔː t i t i
čiji	t͡ʃ ǐ j iː
о	o
мишји	m î ʃ j iː
круцијалан	k r û t͡s i j aː l a n
Skoplje	s k ô p ʎ e
брбљав	b r̂ b ʎ a ʋ
нестручњак	n ě s t r u t͡ʃ ɲ aː k
довести	d ǒ ʋ e s t i
rodski	r ô d s k i
pušiti	p û ʃ i t i
gladijator	ɡ l a d ǐ j aː t o r
tragati	t r ǎ ɡ a t i
povrediti	p o ʋ r ěː d i t i
мирисан	m î r iː s a n
научан	n ǎː u t͡ʃ a n
ćoza	t͡ɕ ô z a
zloćudnost	z l ǒ t͡ɕ u d n oː s t
pretjeran	p r ě t j e r aː n
биљежити	b ǐ ʎ e ʒ i t i
премијера	p r e m i j ěː r a
ублаживати	u b l a ʒ ǐː ʋ a t i
академија	a k a d ě m i j a
betonirati	b e t o n ǐː r a t i
англицизам	a n ɡ l i t͡s ǐ z a m
šogor	ʃ ôː ɡ o r
procent	p r ǒ t͡s e n t
анахронизам	a n a x r o n ǐ z a m
kovčežina	k ǒ ʋ t͡ʃ e ʒ i n a
rog	r ôː ɡ
утаначити	u t a n ǎː t͡ʃ i t i
biskupija	b i s k ǔ p i j a
љубавница	ʎ ǔː b aː ʋ n i t͡s a
voćni	ʋ ô t͡ɕ n iː
вјечан	ʋ j ê t͡ʃ a n
Rajna	r âː j n a
politologija	p o l i t o l ǒ ɡ i j a
uznemiriti	u z n e m ǐː r i t i
елоквентан	e l o k ʋ ě n t a n
сицвана	s î t͡s ʋ a n a
бајам	b ǎ j a m
turobno	t û r oː b n o
alijenacija	a l i j e n ǎː t͡s i j a
kapura	k ǎ p u r a
prekaliti	p r e k ǎː l i t i
прилазак	p r ǐ l a z a k
licemjeran	l î t͡s e m j eː r a n
похлепност	p ô x l eː p n oː s t
сродност	s r ô d n oː s t
blistati	b l ǐ s t a t i
законит	z ǎː k o n i t
nerazuman	n ê r a z uː m a n
vrhunski	ʋ ř x uː n s k iː
тактички	t ǎ k t i t ʃ k iː
metafora	m e t ǎ f o r a
predodžba	p r ě d o d͡ʒ b a
Nikaragvanac	n i k a r a ɡ ʋ ǎː n a t͡s
урачунавати	u r a t͡ʃ u n ǎː ʋ a t i
опаска	ǒ p a s k a
кркљанац	k r k ʎ ǎː n a t͡s
ranoranilac	r a n o r ǎ n i l a t͡s
sultanat	s u l t ǎ n aː t
travnjak	t r âː ʋ ɲ aː k
јогунасто	j ǒ ɡ u n a s t o
улудо	û l uː d o
šparhet	ʃ p ǎ r x e t
pehlivan	p e x l ǐ ʋ aː n
срам	s r âː m
popravak	p ǒ p r a ʋ a k
hmelj	x m ê ʎ
neopipljiv	n e o p ǐ p ʎ i ʋ
импресиониран	i m p r e s i ǒ n i r a n
nelagodno	n ê l a ɡ o d n o
živahan	ʒ î ʋ aː x a n
љубитељ	ʎ ǔ b i t e ʎ
strategija	s t r ǎ t eː ɡ i j a
казалишни	k ǎ z a l iː ʃ n iː
def	d ê f
досадан	d ô s aː d a n
atički	ǎ t i t͡ʃ k iː
шмук	ʃ m û k
пехливан	p e x l ǐ ʋ aː n
bomba	b ôː m b a
превоз	p r ěː ʋ o z
будаласт	b u d ǎ l a s t
триангулирати	t r i a n ɡ u l ǐː r a t i
атом	ǎ t oː m
шепав	ʃ ê p a ʋ
проза	p r ǒː z a
крволиптање	k r ʋ o l ǐ p t aː ɲ e
slap	s l âː p
ispostavljati	i s p ǒ s t a ʋ ʎ a t i
ženidba	ʒ ě n i d b a
kovanica	k o ʋ ǎ n i t͡s a
Sanja	s â ɲ a
fleksija	f l ě k s i j a
stradalac	s t r ǎː d a l a t͡s
претјеривати	p r e t j e r ǐː ʋ a t i
anomalija	a n o m ǎ l i j a
visiti	ʋ î s i t i
lakrdija	l a k ř̩ d i j a
pobijeliti	p o b i j ěː l i t i
komfor	k ǒ m f oː r
izroditi	i z r ǒ d i t i
забрујати	z a b r ǔː j a t i
klupa	k l ǔː p a
kompetencija	k o m p e t ě n t͡s i j a
zadesiti	z ǎ d e s i t i
marama	m ǎ r a m a
pokladnica	p ǒ k l a d n i t͡s a
бесмртан	b ě s m r t a n
еротичан	e r ǒ t i t͡ʃ a n
Kambodža	k a m b ǒ d͡ʒ a
silvanac	s i l ʋ ǎː n a t͡s
литургијски	l i t ǔ r ɡ iː j s k iː
Tuzi	t ǔː z i
nasuprot	n â s u p r o t
marljiv	m ǎ r ʎ i ʋ
шпекулант	ʃ p e k ǔ l a n t
mesečina	m ê s e t͡ʃ i n a
датотека	d a t o t ěː k a
бруталан	b r û t aː l a n
јединцат	j e d ǐ n t͡s a t
спрдати	s p řː d a t i
ткање	t k ǎː ɲ e
сакристија	s a k r ǐ s t i j a
разлаз	r ǎː z l a z
ledolomac	l e d o l ǒː m a t͡s
raščlanjivati	r a ʃ t͡ʃ l a ɲ ǐː ʋ a t i
mlezivo	m l ê z iː ʋ o
ljubaznik	ʎ û b a z n iː k
особит	ǒ s o b i t
tupoglavac	t u p ǒ ɡ l a ʋ a t͡s
bubrežni	b ǔ b r e ʒ n iː
zlonamernik	z l o n ǎː m eː r n iː k
дуњалук	d u ɲ ǎː l u k
pluralizacija	p l u r a l i z ǎː t͡s i j a
jarčev	j âː r t͡ʃ e ʋ
pšenica	p ʃ ě n i t͡s a
крмни	k r̂ m n iː
кравујац	k r a ʋ ǔː j a t͡s
историја	ǐ s t oː r i j a
уопће	ǔ o p t͡ɕ e
притисак	p r ǐ t i s a k
телеграфски	t e l ě ɡ r a f s k iː
жучљив	ʒ ǔ t͡ʃ ʎ i ʋ
izdah	î z d aː x
mati	m â t i
odbrana	ô d b r a n a
повремено	p ǒ ʋ r e m e n o
početnica	p ǒ t͡ʃ e t n i t͡s a
нежност	n ê ʒ n oː s t
цинички	t s ǐ n i t ʃ k iː
уверавати	u ʋ e r ǎː ʋ a t i
промишљати	p r o m ǐː ʃ ʎ a t i
сексуалан	s ê k s u aː l a n
skunjiti	s k ǔː ɲ i t i
федерализам	f e d e r a l ǐ z a m
заслужено	z ǎ s l uː ʒ e n o
kalkulirati	k a l k u l ǐː r a t i
ispitni	ǐ s p i t n iː
pauk	p â uː k
strejtaš	ˈs t r ê j t aː ʃ
чоха	t͡ʃ ǒ x a
bačvar	b â t͡ʃ ʋ aː r
алегорија	a l e ɡ ǒ r i j a
toponimski	t o p ǒ n i m s k iː
саклонити	s a k l ǒ n i t i
samur	s ǎ m uː r
diskreditirati	d i s k r e d i t ǐː r a t i
бугарштица	b u ɡ ǎ r ʃ t i t͡s a
karavanski	k a r ǎ ʋ aː n s k iː
sapunica	s a p ǔ n i t͡s a
секира	s ě k i r a
књижевник	k ɲ ǐ ʒ eː ʋ n iː k
zbornik	z b ôː r n iː k
podmornički	p ǒ d m oː r n i t͡ʃ k iː
шогорица	ʃ o ɡ ǒ r i t͡s a
баршунаст	b ǎ r ʃ u n a s t
подмитљивост	p o d m ǐ t ʎ i ʋ oː s t
tužiteljstvo	t ǔ ʒ i t e ʎ s t ʋ o
fonetički	f o n ě t i t͡ʃ k iː
икуа	î k u d
шлагворт	ʃ l ǎ ɡ ʋ o r t
магичност	m ǎ ɡ i t͡ʃ n oː s t
furundžija	f u r ǔ n d͡ʒ i j a
женидба	ʒ ě n i d b a
dokle	d ǒː k l eː
смена	s m ê n a
мијешалица	m i j ě ʃ a l i t͡s a
кркан	k ř k a n
слобода	s l o b ǒ d a
sramiti	s r ǎː m i t i
hurikan	x û r i k a n
bekhend	b ê k x e n d
вриштав	ʋ r ǐ ʃ t a ʋ
унија	ûː n i j a
истоваривач	i s t o ʋ a r ǐ ʋ aː t͡ʃ
f	f
ајмо	ǎ j m o
Antun	ǎ n t uː n
jutarnji	j û t aː r ɲ iː
ludača	l ǔ d a t͡ʃ a
albanski	ǎ l b aː n s k iː
dve	d ʋ êː
razmjenjivati	r a z m j e ɲ ǐː ʋ a t i
hranitelj	x r ǎ n i t e ʎ
putarina	p u t a r i n a
примаран	p r î m aː r a n
оправдан	ǒ p r aː ʋ d aː n
Америка	a m ě r i k a
odbrambeni	ǒ d b r a m b e n iː
tek	t ê k
размјеран	r ǎː z m j eː r a n
kratkotrajan	k r â t k o t r aː j a n
budala	b u d ǎ l a
безаконит	b e z ǎː k o n i t
штихпроба	ʃ t î x p r oː b a
razodijevati	r a z o d j ěː ʋ a t i
језикословац	j e z i k o s l ǒː ʋ a t͡s
predstavljati	p r ě d s t a ʋ ʎ a t i
осјећати	ǒ s j e t͡ɕ a t i
квалификација	k ʋ a l i f i k ǎː t͡s i j a
рушеван	r û ʃ eː ʋ a n
обавјештајни	ô b a ʋ j e ʃ t aː j n iː
objedinjavati	o b j e d i ɲ ǎː ʋ a t i
crvojedina	t͡s r ʋ ǒ j e d i n a
штосдемфер	ʃ t ôː s d e m f e r
напећи	n ǎ p e t͡ɕ i
švanengezang	ʃ ʋ ǎː n e n ɡ e z a n ɡ
доље	d ô ʎ e
пажљивост	p ǎ ʒ ʎ i ʋ oː s t
пргав	p r̂ ɡ a ʋ
шармирати	ʃ a r m ǐː r a t i
недра	n ê d r a
овладати	o ʋ l ǎː d a t i
узалуд	û z a l uː d
neveran	n ê ʋ e r a n
крашки	k r â ʃ k iː
svježina	s ʋ j e ʒ ǐ n a
тропопауза	t r o p o p ǎ u z a
призивати	p r i z ǐː ʋ a t i
Sabah	s a b a x
пренути	p r ê n u t i
akvizicija	a k ʋ i z ǐː t͡s i j a
дјелати	d j ê l a t i
slavić	s l ǎ ʋ iː t͡ɕ
trovač	t r ǒ ʋ aː t͡ʃ
осакаћивати	o s a k a t͡ɕ ǐː ʋ a t i
обратити	o b r ǎː t i t i
kontinuirano	k o n t i n ǔ iː r a n o
фашизам	f a ʃ ǐ z a m
seksi	s ê k s iː
rečnički	r êː t͡ʃ n iː t͡ʃ k iː
kovrčast	k ǒ ʋ r̩ t͡ʃ a s t
tegljač	t ě ɡ ʎ aː t͡ʃ
репресиван	r ê p r e s iː ʋ a n
стјецати	s t j ê t͡s a t i
епископ	ě p i s k o p
pudla	p û d l a
идеалист	i d e ǎ l i s t
ekavica	ěː k a ʋ i t͡s a
кмет	k m ê t
сируп	s ǐ r u p
delikatnost	d ê l i k aː t n oː s t
подржати	p o d ř ʒ a t i
agogičan	a ɡ ǒ ɡ i t͡ʃ a n
звање	z ʋ ǎː ɲ e
пловућац	p l o ʋ ǔː t͡ɕ a t͡s
drača	d r â t͡ʃ a
aperitiv	a p e r ǐ t iː ʋ
абнормалност	a b n o r m ǎː l n oː s t
autosugestija	a u t o s u ɡ ě s t i j a
kaftan	k ǎ f t a n
regularno	r ê ɡ u l aː r n o
ударац	ǔ d a r a t͡s
pučina	p ǔ t͡ʃ i n a
umjeren	ǔ m j e r e n
ratoborno	r â t o b oː r n o
робиња	r ǒ b i ɲ a
чинилац	t͡ʃ ǐ n i l a t͡s
tučak	t ǔː t͡ʃ a k
spoj	s p ôː j
подмукло	p ǒ d m uː k l o
услован	ǔː s l oː ʋ a n
скровиште	s k r ô ʋ iː ʃ t e
triler	t r î l e r
cviker	t͡s ʋ ǐ k e r
adventistkinja	a d ʋ ě n t i s t k i ɲ a
критичарка	k r ǐ t i t͡ʃ aː r k a
козметички	k o z m ě t i t ʃ k iː
kozmopolitski	k o z m o p ǒ l iː t s k iː
magnetski	m ǎ ɡ n eː t s k i
послушати	p ǒ s l u ʃ a t i
klizaljka	k l ǐː z aː ʎ k a
безбојно	b ê z b oː j n o
сулундар	s u l ǔ n d aː r
prostreti	p r ǒ s t r eː t i
bar	b âː r
сакупљачки	s a k ǔ p ʎ aː t͡ʃ k iː
набој	n ǎː b o j
реагирати	r e a ɡ ǐː r a t i
antikomunistički	a n t i k o m u n ǐ s t i t͡ʃ k iː
садржајно	s â d r ʒ aː j n o
očito	ǒ t͡ʃ i t o
kana	k â n a
смрзавати	s m r z ǎː ʋ a t i
удавача	u d ǎ ʋ a t͡ʃ a
господарити	ɡ o s p o d ǎː r i t i
Bratislava	b r ǎ t i s l a ʋ a
razvesti	r ǎ z ʋ e s t i
refraktor	r ě f r a k t o r
барбарство	b ǎ r b aː r s t ʋ o
zadrugarka	z âː d r u ɡ aː r k a
vrijeme	ʋ r i j ěː m e
zahtev	z ǎː x t e ʋ
удаљеност	ǔ d aː ʎ e n oː s t
ескимски	ě s k iː m s k iː
крпа	k r̂ p a
zaplaviti	z a p l ǎː ʋ i t i
sastavljač	s a s t ǎ ʋ ʎ aː t͡ʃ
разједињавати	r a z j e d i ɲ ǎː ʋ a t i
iscediti	i s t͡s ěː d i t i
аналфабетизам	a n a l f a b e t ǐ z a m
splavar	s p l ǎ ʋ aː r
умерен	ǔ m e r e n
трампа	t r âː m p a
svlačiti	s ʋ l ǎː t͡ʃ i t i
надлактица	n ǎ d l a k t i t͡s a
момче	m ǒ m t͡ʃ e
мужеван	m û ʒ eː ʋ a n
коптски	k ô p t s k iː
ви	ʋ îː
замотуљак	z a m o t ǔː ʎ a k
licencija	l i t͡s ě n t͡s i j a
цемент	t͡s ě m e n t
rusofil	r u s ǒ f iː l
ћутати	t͡ɕ ǔː t a t i
nazivnik	n ǎː z iː ʋ n iː k
muškobanja	m u ʃ k ǒ b a ɲ a
крипта	k r î p t a
компетентно	k o m p e t ě n t n o
picajzla	p i t͡s ǎ j z l a
smiono	s m ǐ o n o
lijepiti	l j ěː p i t i
сентименталност	s e n t i m e n t ǎː l n oː s t
мамурност	m â m uː r n oː s t
линеаран	l î n e aː r a n
пратити	p r â t i t i
бесмртница	b ě s m r̩ t n i t͡s a
рибарство	r i b ǎː r s t ʋ o
pravdati	p r âː ʋ d a t i
објединити	o b j e d ǐː n i t i
безуман	b ě z uː m a n
silovitost	s i l ǒ ʋ i t oː s t
Берн	b êː r n
глицерин	ɡ l i t͡s ě r iː n
Palestinac	p a l e s t ǐː n a t͡s
Анатолија	a n a t ǒː l i j a
лексикографски	l e k s i k ǒ ɡ r a f s k iː
ptičji	p t î t͡ʃ j iː
beznadan	b ě z n a d a n
birtija	b ǐ r t i j a
bućnuti	b û t͡ɕ n u t i
udarništvo	ǔ d aː r n iː ʃ t ʋ o
veroispoved	ʋ e r o ǐ s p o ʋ eː d
кецеља	k ě t͡s e ʎ a
parazitologija	p a r a z i t o l ǒ ɡ i j a
uredan	û r e d a n
инвестирати	i n ʋ e s t ǐː r a t i
подморнички	p ǒ d m oː r n i t͡ʃ k iː
smalaksati	s m a l ǎ k s a t i
сирота	s i r ǒ t a
telefonist	t e l e f ǒ n i s t
nebrojeno	n ě b r o j e n o
razmijeniti	r a z m j ěː n i t i
nadoknada	n â d o k n a d a
legalno	l ě ɡ aː l n o
забуна	z âː b u n a
слепоочни	s l e p ǒ o t͡ʃ n iː
pobliže	p ô b l i ʒ eː
agnostičarka	a ɡ n ǒ s t i t͡ʃ aː r k a
гордијски	ɡ ǒ r d iː j s k iː
злонамерно	z l o n ǎː m eː r n o
хајдемо	x ǎ j d e m o
изравнавати	i z r a ʋ n ǎː ʋ a t i
naknaditi	n ǎ k n a d i t i
ideologija	i d e o l ǒ ɡ i j a
kredo	k r êː d o
preduzeće	p r e d u z e t͡ɕ e
стакленик	s t a k l ě n iː k
antropomorfizam	a n t r o p o m o r f ǐ z a m
уротник	ǔ r o t n iː k
presvući	p r ě s ʋ uː t͡ɕ i
dohvatljiv	d o x ʋ ǎ t ʎ i ʋ
излаз	î z l aː z
upisati	u p ǐː s a t i
nesposoban	n ê s p o s o b a n
imputirati	i m p u t ǐː r a t i
узалудно	û z a l uː d n o
napeti	n ǎ p eː t i
kinin	k ǐ n iː n
univerzitetski	u n i ʋ e r z ǐ t eː t s k iː
neosiguran	n ê o s i ɡ u r aː n
пучина	p ǔ t͡ʃ i n a
nedjeljiv	n e d j ě ʎ i ʋ
ploviti	p l ǒ ʋ i t i
tabela	t a b ě l a
воз	ʋ ôː z
губитница	ɡ ǔ b i t n i t͡s a
који	k ǒ j iː
лак	l â k
anarhistički	a n a r x ǐ s t i t ʃ k iː
patnik	p â t n iː k
osmorica	o s m ǒ r i t͡s a
dohvatiti	d ǒ x ʋ a t i t i
zagrađivati	z a ɡ r a d͡ʑ ǐː ʋ a t i
змијски	z m îː j s k iː
treptav	t r ê p t a ʋ
promotriti	p r o m ǒ t r i t i
hijerarhijski	x i j e r ǎ r x iː j s k iː
usmjeravati	u s m j e r ǎː ʋ a t i
roba	r ô b a
dominirati	d o m i n ǐː r a t i
Хваранин	x ʋ ǎː r a n i n
iti	ˈiː t i
смијешан	s m j ěː ʃ a n
лоптати	l ô p t a t i
lukavac	l û k a ʋ a t͡s
zarudeti	z a r ǔː d e t i
manipulacija	m a n i p u l ǎː t͡s i j a
nadomestak	n a d ǒ m e s t a k
каолин	k a ǒ l iː n
стварно	s t ʋ âː r n o
никада	n î k a d a
beril	b ě r iː l
kokodakati	k o k o d ǎː k a t i
žutokljunac	ʒ u t o k ʎ ǔː n a t͡s
цијев	t͡s i j êː ʋ
čar	t͡ʃ âː r
галицијски	ɡ ǎ l iː t͡s iː j s k iː
supstancija	s u p s t ǎ n t͡s i j a
деликатан	d ê l i k aː t a n
Данац	d ǎː n a t͡s
берилијум	b ě r iː l i j u m
fanatičan	f a n ǎ t i t͡ʃ a n
незамисливо	n e z a m ǐ s l i ʋ o
sušiti	s ǔː ʃ i t i
pozirati	p o z ǐː r a t i
жупанијски	ʒ u p ǎ n iː j s k iː
zamerljiv	z a m ě r ʎ i ʋ
функција	f ǔ n k t͡s i j a
Маџарска	m â d͡ʒ a r s k aː
теоретик	t e o r ě t i k
суд	s ûː d
ћелија	t͡ɕ ě l i j a
astralan	ǎ s t r aː l a n
одламати	o d l ǎː m a t i
консекутивно	k ô n s e k u t iː ʋ n o
začuđivati	z a t͡ʃ u d͡ʑ ǐː ʋ a t i
побољшати	p o b ǒ ʎ ʃ a t i
тематски	t ě m a t s k iː
ljudožderstvo	ʎ u d ǒ ʒ d eː r s t ʋ o
fascinantan	f a s t͡s i n ǎ n t a n
špiccange	ʃ p î t͡s t͡s aː n ɡ e
прибости	p r ǐ b o s t i
inače	î n aː t͡ʃ e
usisavati	u s i s ǎː ʋ a t i
šinter	ʃ îː n t e r
oksid	ǒ k s iː d
neosnovan	n ê o s n o ʋ aː n
смаћи	s m â t͡ɕ i
самозаштита	s a m o z ǎ ʃ t i t a
амфибија	ǎ m f iː b i j a
изоштрити	i z ǒ ʃ t r i t i
гојазност	ɡ ô j aː z n oː s t
пека	p ê k a
подучити	p o d ǔ t͡ʃ i t i
окусити	ǒ k u s i t i
tipično	t ǐ p i t͡ʃ n o
istosmjeran	î s t o s m j eː r a n
ciganski	t s î ɡ a n s k iː
veterinarski	ʋ e t e r ǐ n aː r s k iː
slizati	s l ǐː z a t i
замена	z âː m e n a
допремити	d o p r ěː m i t i
neznanje	n e z n ǎː ɲ e
praktično	p r ǎ k t i t͡ʃ n o
несхваћен	n ě s x ʋ a t͡ɕ e n
tunjevina	t ǔ ɲ e ʋ i n a
gluvoća	ɡ l u ʋ ǒ t͡ɕ a
rasprodati	r a s p r ǒ d a t i
смрдљив	s m ř d ʎ i ʋ
nepisan	n ě p iː s aː n
mandragora	m a n d r ǎ ɡ o r a
gospoština	ɡ o s p ǒ ʃ t i n a
израђати	i z r ǎː d͡ʑ a t i
превој	p r ěː ʋ o j
надбискуп	n ǎ d b i s k u p
topljiv	t ǒ p ʎ i ʋ
неуспело	n ê u s p e l o
ојачавати	o j a t͡ʃ ǎː ʋ a t i
наставити	n ǎ s t a ʋ i t i
гласник	ɡ l âː s n iː k
рецепт	r ě t͡s e p t
примјер	p r ǐː m j e r
poluga	p ǒ l u ɡ a
босиљак	b ǒ s i ʎ a k
умакнути	u m ǎ k n u t i
плешив	p l ě ʃ i ʋ
мјесечарка	m j ê s e t͡ʃ aː r k a
strn	s t r̩̂ː n
равномјеран	r â ʋ n o m j eː r a n
кружок	k r ǔ ʒ o k
гангстерски	ɡ ǎ n ɡ s t e r s k iː
прамен	p r â m eː n
стајати	s t â j a t i
jedro	j ê d r o
дисјункција	d i s j ǔ n k t͡s i j a
vidik	ʋ ǐ d iː k
rima	r ǐː m a
клиторис	k l ǐ t oː r i s
картограф	k a r t ǒ ɡ r a f
надати	n ǎː d a t i
веселост	ʋ ê s e l oː s t
hala	x a l a
hrestomatija	x r e s t o m ǎ t i j a
тролејбус	t r o l ěː j b u s
астрологија	a s t r o l ǒ ɡ i j a
обијест	ô b i j eː s t
дискретно	d ǐ s k r e t n o
reparacija	r e p a r ǎː t͡s i j a
umiti	ǔ m i t i
dravski	d r âː ʋ s k iː
амбивалентност	a m b i ʋ ǎ l e n t n oː s t
нитко	n î t k o
објашњење	o b j a ʃ ɲ ěː ɲ e
klizati	k l ǐː z a t i
ласкати	l â s k a t i
iseljavati	i s e ʎ ǎː ʋ a t i
верифицирати	ʋ e r i f i t͡s ǐː r a t i
процјена	p r ô t͡s j e n a
умислити	ǔ m i s l i t i
krčmariti	k r t͡ʃ m ǎː r i t i
Црногорац	t͡s r̩ n ǒ ɡ o r a t͡s
јендек	j ě n d e k
попречно	p ô p r e t͡ʃ n o
uspavati	u s p ǎː ʋ a t i
накалемити	n a k ǎ l e m i t i
шпага	ʃ p ǎː ɡ a
cvrkutati	t͡s ʋ r̩ k ǔ t a t i
đevrek	d͡ʑ ě ʋ r e k
kozarenje	k o z ǎː r eː ɲ e
rastavljati	r ǎ s t a ʋ ʎ a t i
попити	p ǒ p i t i
glogov	ɡ l ǒ ɡ o ʋ
кострет	k ô s t r eː t
неизљечивост	n e i z ʎ ě t͡ʃ i ʋ oː s t
неразговијетан	n ê r a z ɡ o ʋ i j eː t a n
higijeničar	x i ɡ i j ě n i t͡ʃ aː r
aktuelan	â k t u eː l a n
чегртуша	t͡ʂ e ɡ ř t u ʃ a
глодати	ɡ l ǒ d a t i
животињски	ʒ i ʋ ǒ t iː ɲ s k iː
cevčica	t͡s ě ʋ t͡ʃ i t͡s a
užurbanost	ǔ ʒ u r b aː n oː s t
праживотиња	p r â ʒ i ʋ o t i ɲ a
nekretnina	n e k r e t n ǐ n a
aerodinamičan	a e r o d i n ǎ m i t͡ʃ a n
ihtiologija	i x t i o l ǒ ɡ i j a
nekonvencionalan	n ê k o n ʋ e n t͡s i o n aː l a n
krdžalija	k r̂ d͡ʒ a l i j a
плеоназам	p l e o n ǎ z a m
šleper	ʃ l ê p e r
хигијеничарка	x i ɡ i j ě n i t͡ʃ aː r k a
вранац	ʋ r ǎː n a t͡s
kaiš	k ǎ i ʃ
одмерити	ǒ d m e r i t i
osvit	ǒ s ʋ i t
свуд	s ʋ û d
родитељ	r ǒ d i t e ʎ
nadimati	n ǎ d i m a t i
zavodljiv	z a ʋ ǒ d ʎ i ʋ
цвјетни	t͡s ʋ j ě t n iː
самогласнички	s â m o ɡ l a s n i t͡ʃ k iː
akov	ǎ k o ʋ
sjeveroistočni	s j e ʋ e r o ǐ s t o t͡ʃ n iː
опасач	o p ǎ s aː t͡ʃ
негативан	n ê ɡ a t iː ʋ a n
upijati	u p ǐː j a t i
тропосфера	t r o p o s f ěː r a
кровар	k r ǒ ʋ aː r
њим	ɲ îː m
крв	k r̩̂ː ʋ
котураш	k o t ǔ r aː ʃ
црквењак	t͡s r k ʋ ě ɲ aː k
вермут	ʋ ě r m u t
industrijski	i n d ǔ s t r iː j s k iː
vrištav	ʋ r ǐ ʃ t a ʋ
koturina	k o t ǔ r i n a
monah	m ǒ n a x
новчаница	n o ʋ t͡ʃ ǎ n i t͡s a
mutiti	m ǔː t i t i
sapunar	s a p ǔ n aː r
испитни	ǐ s p i t n iː
калемити	k ǎ l e m i t i
котар	k ô t aː r
Онтарио	o n t âː r i o
kompromis	k o m p r ǒ m i s
postidjeti	p o s t ǐː d j e t i
урезати	ǔ r e z a t i
podbel	p ǒ d b e l
nepokretljiv	n e p o k r ě t ʎ i ʋ
сјетва	s j ê t ʋ a
зажељети	z a ʒ ě ʎ e t i
припадност	p r ǐ p a d n oː s t
posmrče	p ǒ s m r̩ t͡ʃ e
судбина	s û d b i n a
јесетра	j ě s e t r a
снажан	s n ǎː ʒ a n
набацивати	n a b a t͡s ǐː ʋ a t i
promisliti	p r ǒ m i s l i t i
кампања	k a m p ǎ ɲ a
otpisivati	o t p i s ǐː ʋ a t i
ринути	r ǐ n u t i
tomahavk	t ǒ m a x a ʋ k
кратковрат	k r a t k ǒ ʋ r a t
glasovati	ɡ l â s o ʋ a t i
гушчад	ɡ û ʃ t͡ʃ aː d
prolamati	p r o l ǎː m a t i
narodnost	n ǎː r o d n oː s t
замењив	z a m ě ɲ i ʋ
премијер	p r e m ǐ j eː r
ниједанпут	n i j e d ǎ n p uː t
увидјети	ǔ ʋ i d j e t i
верификацијски	ʋ e r i f i k ǎː t͡s iː j s k iː
привид	p r ǐː ʋ i d
kosturnica	k ǒ s t uː r n i t͡s a
Švicarska	ʃ ʋ î t͡s a r s k aː
дрводеља	d r ʋ ǒ d e ʎ a
заварати	z ǎ ʋ a r a t i
сувенир	s u ʋ ě n iː r
куповати	k u p ǒ ʋ a t i
дефетистички	d e f e t ǐ s t i t͡ʃ k iː
бензен	b ě n z eː n
inteligencija	i n t e l i ɡ ě n t͡s i j a
архаичан	a r x ǎ i t͡ʃ a n
pustinjački	p ǔː s t i ɲ aː t͡ʃ k iː
dabar	d ǎ b a r
бактериолог	b a k t e r i ǒ l o ɡ
barem	b ǎ r e m
svetionik	s ʋ e t i ǒ n iː k
сакупљач	s a k ǔ p ʎ aː t͡ʃ
krepao	k r ê p a o
slasno	s l â s n o
јачати	j ǎ t͡ʃ a t i
обао	ô b a o
наочаре	n â o t͡ʃ aː r e
albanolog	a l b a n ǒ l o ɡ
groziti	ɡ r ǒ z i t i
громобран	ɡ r ô m o b r aː n
domorodac	d o m o r ǒː d a t͡s
трауматолог	t r a u m a t ǒ l o ɡ
бирач	b ǐ r aː t͡ʃ
atmosfera	a t m o s f ěː r a
pogodan	p ô ɡ o d a n
зборник	z b ôː r n iː k
звездица	z ʋ ě z d i t͡s a
ikud	î k u d
kongregacija	k o n ɡ r e ɡ ǎː t͡s i j a
рационалисткиња	r a t͡s i o n ǎ l i s t k i ɲ a
nahraniti	n a x r ǎː n i t i
udovica	u d ǒ ʋ i t͡s a
bogatiti	b ǒ ɡ a t i t i
redukcija	r e d ǔ k t͡s i j a
претопити	p r e t ǒ p i t i
матријархални	m â t r i j a r x aː l n iː
kanibal	k ǎ n i b a l
bezemljaš	b e z ě m ʎ aː ʃ
umoran	û m oː r a n
spadati	s p â d a t i
унаказити	u n a k ǎː z i t i
graditeljski	ɡ r ǎ d i t e ʎ s k iː
козоношка	k o z ǒ n o ʃ k a
таутологија	t a u t o l ǒ ɡ i j a
јагуар	j â ɡ u aː r
новорођен	n o ʋ o r ǒ d͡ʑ e n
Сплићанин	s p l î t͡ɕ a n i n
odzvanjati	o d z ʋ ǎː ɲ a t i
бисер	b ǐ s e r
demonski	d ě m oː n s k iː
потражити	p o t r ǎː ʒ i t i
Pandora	p a n d ǒː r a
злоупотријебити	z l o u p o t r j ěː b i t i
ručno	r û t͡ʃ n o
блистав	b l î s t a ʋ
пластелин	p l a s t ě l iː n
štoviše	ʃ t ǒ ʋ i ʃ e
obljetnica	ǒ b ʎ e t n i t͡s a
cimerica	t͡s î m e r i t͡s a
прољеће	p r ǒ ʎ e t͡ɕ e
солидаран	s ô l i d aː r a n
Kalifornija	k a l i f ǒ r n i j a
уприличити	u p r ǐː l i t͡ʃ i t i
размак	r ǎː z m a k
срамити	s r ǎː m i t i
досетљиво	d o s ě t ʎ i ʋ o
праворијек	p r â ʋ o r i j eː k
пробирати	p r o b ǐː r a t i
упомоћ	û p o m oː t͡ɕ
prost	p r ô s t
dotepuh	d o t ě p uː x
otprilike	o t p r ǐː l i k eː
коаксијалан	k ô a k s i j aː l a n
tvrdokornost	t ʋ r d o k ǒː r n oː s t
сунути	s ǔː n u t i
preplaćivati	p r e p l a t͡ɕ ǐː ʋ a t i
тророг	t r ǒ r o ɡ
jezer	j ê z eː r
mirovinski	m î r o ʋ iː n s k iː
žabica	ʒ â b i t͡s a
izlječiv	i z ʎ ě t͡ʃ i ʋ
ustrajati	ǔ s t r a j a t i
сажаљевати	s a ʒ a ʎ ěː ʋ a t i
pandur	p ǎ n d uː r
živahnost	ʒ î ʋ aː x n oː s t
rugoba	r u ɡ ǒ b a
sjera	s j ê r a
štovati	ʃ t ǒ ʋ a t i
lišaj	l î ʃ aː j
kroasan	k r o ǎ s aː n
враћати	ʋ r â t͡ɕ a t i
стабилизација	s t a b i l i z ǎː t͡s i j a
блазиња	b l ǎ z i ɲ a
garant	ɡ ǎ r a n t
Олибљанин	ǒ l i b ʎ a n i n
razmicati	r ǎ z m i t͡s a t i
opustiti	o p ǔ s t i t i
шизофренија	ʃ i z o f r ě n i j a
semantički	s e m ǎ n t i t ʃ k iː
rabotnik	r ǎ b o t n iː k
салаш	s ǎ l aː ʃ
biseran	b ǐ s eː r a n
главоломка	ɡ l a ʋ ǒ l o m k a
неопорезив	n e o p o r ě z i ʋ
ургентан	u r ɡ ě n t a n
djelić	d j ě l i t͡ɕ
расходовати	r ǎː s x o d o ʋ a t i
džepar	d͡ʒ ê p aː r
равнодушност	r a ʋ n ǒ d u ʃ n oː s t
Кошчанин	k ǒ ʃ t͡ʃ a n i n
прештампати	p r ě ʃ t aː m p a t i
кошутовина	k ǒ ʃ u t o ʋ i n a
преписати	p r e p ǐː s a t i
блокирати	b l o k ǐː r a t i
шлафцимер	ʃ l âː f t͡s i m e r
državnički	d ř ʒ aː ʋ n i t ʃ k iː
органски	ǒ r ɡ aː n s k iː
њургало	ɲ û r ɡ a l o
неуроза	n e u r ǒː z a
pobornik	p ǒ b oː r n iː k
gospođica	ɡ ô s p o d͡ʑ i t͡s a
arogantan	a r o ɡ ǎ n t a n
naučan	n ǎː u t͡ʃ a n
тијесан	t j ěː s a n
razdavati	r a z d ǎː ʋ a t i
црвенити	t͡s r ʋ ě n i t i
магистар	m a ɡ ǐ s t a r
otpravljati	ǒ t p r a ʋ ʎ a t i
скалпирати	s k a l p ǐː r a t i
ружно	r ûː ʒ n o
немаштовитост	n e m a ʃ t ǒ ʋ i t oː s t
прћаст	p r̩̂ t͡ɕ a s t
неописиво	n e o p ǐ s i ʋ o
кострешити	k o s t r ěː ʃ i t i
kovinotokar	k ô ʋ i n o t o k aː r
дешавати	d e ʃ ǎː ʋ a t i
баљезгати	b a ʎ ě z ɡ a t i
dubina	d u b ǐ n a
nemogućnost	n e m o ɡ ǔː t͡ɕ n oː s t
cirkulacija	t͡s i r k u l ǎː t͡s i j a
prežderavati	p r e ʒ d ě r a v a t i
жиголо	ʒ î ɡ o l o
Баварска	b ǎ ʋ aː r s k a
posetilac	p o s ě t i l a t͡s
omaška	ǒ m a ʃ k a
бушилица	b ǔ ʃ i l i t͡s a
šteka	ʃ t ê k a
svezak	s ʋ ê z a k
svizac	s ʋ ǐː z a t͡s
širokogrudnost	ʃ i r o k ǒ ɡ r u d n oː s t
pretopiti	p r e t ǒ p i t i
матица	m â t i t͡s a
ćup	t͡ɕ û p
opozivati	o p o z ǐː ʋ a t i
десетогодишњак	d e s e t o ɡ ǒ d i ʃ ɲ aː k
samotan	s â m o t a n
поремећај	p ô r e m e t͡ɕ aː j
биљни	b îː ʎ n iː
педагог	p e d ǎ ɡ o ɡ
граматичар	ɡ r a m ǎ t i t͡ʃ aː r
papak	p ǎː p a k
pandža	p âː n d͡ʒ a
upropašćivati	u p r o p a ʃ t͡ɕ ǐː ʋ a t i
slalom	s l ǎ l o m
семиотика	s e m i ǒ t i k a
šina	ʃ î n a
trema	t r ěː m a
либерализам	l i b e r a l ǐ z a m
propadati	p r ǒ p a d a t i
srodnost	s r ô d n oː s t
izricati	i z r ǐː t͡s a t i
kristalizirati	k r i s t a l i z ǐː r a t i
izbliza	î z b l iː z a
Tibet	t ǐ b e t
ирационализам	i r a t͡s i o n a l ǐ z a m
пјенити	p j ê n i t i
pantalone	p a n t a l ǒː n e
posljednji	p ǒ s ʎ e d ɲ iː
izbliže	î z b l i ʒ eː
hrpa	x ř p a
znanost	z n â n oː s t
успевати	u s p ěː ʋ a t i
расплакивати	r a s p l a k ǐː ʋ a t i
естетика	e s t ě t i k a
банкрот	b ǎ n k r oː t
средњи	s r ê d ɲ iː
леопардов	l ê o p aː r d o ʋ
ослонити	o s l ǒ n i t i
лутати	l ǔː t a t i
ivica	î ʋ i t͡s a
верс	ʋ ê r s
насмешити	n a s m ěː ʃ i t i
лоповски	l ǒ p o ʋ s k iː
милостиво	m i l ǒ s t i ʋ o
zasluženo	z ǎ s l uː ʒ e n o
bigotan	b ǐ ɡ o t a n
разнеживати	r a z n e ʒ ǐː ʋ a t i
уцена	û t͡s e n a
Перун	p ê r u n
издаја	î z d a j a
истакнут	ǐ s t a k n uː t
пажљив	p ǎ ʒ ʎ i ʋ
учесник	ǔ t͡ʃ e s n iː k
безболно	b ě z b oː l n o
кошаркашица	k o ʃ a r k ǎ ʃ i t͡s a
ћудљивац	t͡ɕ ǔ d ʎ i ʋ a t͡s
окривити	o k r ǐː ʋ i t i
individualnost	i n d i ʋ i d u ǎː l n oː s t
regresivan	r ê ɡ r e s iː ʋ a n
šelf	ʃ ê l f
uočljiv	u ǒ t͡ʃ ʎ i ʋ
оборив	o b ǒ r i ʋ
altimetar	ǎ l t i m e t a r
stečaj	s t ê t͡ʃ aː j
ispravak	ǐ s p r a ʋ a k
materinski	m â t e r iː n s k iː
utvrditi	u t ʋ řː d i t i
tadž	t â d͡ʒ
železnica	ʒ ě l e z n i t͡s a
poznavati	p o z n ǎː ʋ a t i
bojevati	b o j ě ʋ a t i
задивити	z a d ǐː ʋ i t i
лимунада	l i m u n ǎː d a
си	s i
психолошки	p s i x ǒ l o ʃ k iː
кружић	k r ǔː ʒ i t͡ɕ
спецификација	s p e t͡s i f i k ǎː t͡s i j a
darivati	d a r ǐː ʋ a t i
циркулација	t͡s i r k u l ǎː t͡s i j a
ispovest	ǐ s p o ʋ eː s t
pedesetoro	p e d ě s eː t o r o
индоктринација	i n d o k t r i n ǎː t͡s i j a
насљеђе	n ǎː s ʎ eː d͡ʑ e
jajolik	j a j ǒ l i k
oduprijeti	o d ǔ p r j eː t i
šperholc	ʃ p ě r x o l t͡s
krviti	k ř ʋ i t i
sućut	s û t͡ɕ uː t
difuzivnost	d i f u z ǐː ʋ n oː s t
napatiti	n ǎ p a t i t i
уличица	û l i t͡ʃ i t͡s a
sumanut	s ǔ m aː n uː t
кожни	k ô ʒ n iː
препуштати	p r e p ǔː ʃ t a t i
zdaj	ˈz d a j
razumevati	r a z u m ěː ʋ a t i
sužavati	s u ʒ ǎː ʋ a t i
nastranost	n ǎ s t r a n oː s t
tijesan	t j ěː s a n
мјешовит	m j e ʃ ǒ ʋ i t
прекидати	p r e k ǐː d a t i
iber	ǐː b e r
tobdžija	t ǒ b d͡ʒ i j a
Cejlon	t͡s ě j l oː n
dočaravati	d o t͡ʃ a r ǎː ʋ a t i
slamarica	s l â m a r i t͡s a
Paragvajac	p a r a ɡ ʋ ǎː j a t͡s
отимати	ǒ t i m a t i
кривоклетник	k r i ʋ ǒ k l e t n iː k
obestan	ô b eː s t a n
vojvotkinja	ʋ ǒ j ʋ o t k i ɲ a
juriš	j û r iː ʃ
pregristi	p r ě ɡ r i s t i
štikati	ʃ t î k a t i
sedmerac	s e d m ěː r a t͡s
štampati	ʃ t âː m p a t i
gol	ɡ ôː l
potjernica	p ǒ t j eː r n i t͡s a
pribrajati	p r i b r ǎː j a t i
nalik	n ǎː l i k
бунило	b ǔ n i l o
kutija	k ǔ t i j a
omladinac	o m l a d ǐː n a t͡s
iznenađen	i z n ě n aː d͡ʑ e n
нераздруживост	n e r a z d r ǔ ʒ i ʋ oː s t
Северњача	s e ʋ ěː r ɲ a t͡ʃ a
истраживач	i s t r a ʒ ǐ ʋ aː t͡ʃ
sinak	s î n a k
čekati	t͡ʃ ê k a t i
штрајк	ʃ t r â j k
весело	ʋ ê s e l o
poremećivati	p o r e m e t͡ɕ ǐː ʋ a t i
страница	s t r ǎ n i t͡s a
ексцентричан	e k s t͡s ě n t r i t͡ʃ a n
svjetlo	s ʋ j ê t l o
двориште	d ʋ ǒ r iː ʃ t e
flatulencija	f l a t u l ě n t͡s i j a
sablastan	s â b l aː s t a n
đerdek	d͡ʑ ě r d e k
кожара	k ǒ ʒ a r a
опустити	o p ǔ s t i t i
pelena	p ê l e n a
укрштати	u k řː ʃ t a t i
разрјешив	r a z r j ě ʃ i ʋ
развезати	r a z ʋ ěː z a t i
бесавесно	b e s ǎː ʋ e s n o
lijevak	l i j ěː ʋ a k
rosa	r ǒ s a
прометејски	p r o m ě t e j s k iː
излизивати	i z l i z ǐː ʋ a t i
ospice	ô̞ s̪ p i t̪͡s̪ e̞
pristojnost	p r i s t ǒː j n oː s t
јавански	j ǎ ʋ aː n s k iː
čudan	t͡ʃ û d a n
debilan	d ê b iː l a n
nevaljao	n e v ǎ ʎ a o
refrakcija	r e f r ǎ k t͡s i j a
темпларски	t ě m p l aː r s k iː
poraće	p ǒ r aː t͡ɕ e
кратковидност	k r a t k o ʋ ǐː d n oː s t
zemljotres	z ê m ʎ o t r eː s
крепко	k r ê p k o
Dalibor	d ǎ l i b o r
бифе	b ǐ f eː
окрутан	ô k r uː t a n
prikladan	p r ǐ k l a d a n
Хондурас	x ô n d u r aː s
polinezijski	p o l ǐ n eː z iː j s k iː
belac	b ěː l a t͡s
одрицати	o d r ǐː t͡s a t i
bugarštica	b u ɡ ǎ r ʃ t i t͡s a
Тунис	t ǔ n i s
pripovedač	p r i p o ʋ ě d aː t͡ʃ
oštar	ô ʃ t a r
Буда	b ǔː d a
лутња	l ǔː t ɲ a
apodiktički	a p o d ǐ k t i t͡ʃ k i
дозвола	d ô z ʋ o l a
подао	p ô d a o
demagogija	d e m a ɡ ǒ ɡ i j a
ubrzanje	u b r z ǎː ɲ e
астматичар	a s t m ǎ t i t͡ʃ aː r
epitaf	e p ǐ t a f
razorno	r ǎː z oː r n o
goreti	ɡ ǒ r e t i
praznovernost	p r â z n o ʋ eː r n oː s t
brčkati	b r̂ t͡ʃ k a t i
висак	ʋ ǐː s a k
izgarati	i z ɡ ǎː r a t i
bokserice	b ô k s e r i t͡s e
prdnuti	p r̂ d n u t i
zastupnica	z ǎː s t u p n i t͡s a
ljuvezan	ʎ u v e z a n
škrtost	ʃ k r̂ t oː s t
besputan	b ě s p u t a n
smenjivati	s m e ɲ ǐː ʋ a t i
присјетити	p r ǐ s j e t i t i
zavladavati	z a ʋ l a d ǎː ʋ a t i
publikacija	p u b l i k ǎː t͡s i j a
šprica	ʃ p r î t͡s a
protivno	p r ô t iː ʋ n o
najednom	n a j ě d n oː m
тепсти	t ê p s t i
рудлавост	r û d l a ʋ oː s t
шелесхамер	ʃ ě l e s x a m e r
ива	ǐː ʋ a
avanzirati	a ʋ a n z ǐː r a t i
аметист	a m ě t i s t
прорачун	p r ô r a t͡ʃ uː n
течан	t ê t͡ʃ a n
venozan	ʋ ě n oː z a n
застајати	z ǎ s t a j a t i
kuknjava	k ǔ k ɲ a ʋ a
zaboga	z â b o ɡ a
temeljiti	t e m ě ʎ i t i
нагао	n ǎː ɡ a o
протјерати	p r ǒ t j e r a t i
vrbovina	ʋ ř b o ʋ i n a
muzlica	m û z l i t͡s a
plod	p l ôː d
прожети	p r ǒ ʒ eː t i
кашупски	k ǎ ʃ u p s k iː
тесан	t ěː s a n
одштета	ô d ʃ t e t a
ormar	ǒ r m aː r
špajz	ʃ p â j z
utešljiv	u t ě ʃ ʎ i ʋ
стеарин	s t e ǎ r iː n
куца	k ǔː t͡s a
krivovjerstvo	k r i ʋ ǒ ʋ j eː r s t ʋ o
Сарајка	s ǎ r aː j k a
средоземни	s r ê d o z eː m n iː
plato	p l ǎ t oː
poći	p ôː t͡ɕ i
грдити	ɡ řː d i t i
разбијач	r a z b ǐ j aː t͡ʃ
kanap	k ǎ n aː p
žedno	ʒ êː d n o
poliandrija	p o l i ǎ n d r i j a
носталгичар	n o s t ǎ l ɡ i t͡ʃ aː r
uzbunjivati	u z b u ɲ ǐː ʋ a t i
pričiniti	p r i t͡ʃ ǐ n i t i
suzivati	s u z ǐː ʋ a t i
kreketavo	k r e k ě t a ʋ o
džoker	d͡ʒ ǒ k e r
сјеверац	s j e ʋ ěː r a t͡s
tržnica	t ř̩ ʒ n i t͡s a
ajatolah	a j a t ǒ l a x
negirati	n e ɡ ǐː r a t i
puštati	p ǔː ʃ t a t i
odmjeriti	ǒ d m j e r i t i
хазардни	x ǎ z a r d n iː
tužan	t ǔː ʒ a n
pomagač	p o m ǎ ɡ aː t͡ʃ
naočale	n â o t͡ʃ aː l e
фриволно	f r î ʋ oː l n o
суџук	s ǔ d͡ʒ u k
obrazovni	ǒ b r a z oː ʋ n iː
дјелотворан	d j ê l o t ʋ oː r a n
носилац	n ǒ s i l a t͡s
bežati	b ě ʒ a t i
dikcija	d ǐ k t͡s i j a
оргија	ǒ r ɡ i j a
zavetrina	z ǎː ʋ e t r i n a
нејасно	n ě j a s n o
sinteriranje	s i n t e r ǐː r aː ɲ e
јурта	j ûː r t a
омот	ǒ m o t
antropologija	a n t r o p o l ǒ ɡ i j a
Bosna	b ô s n a
флуктуирати	f l u k t u ǐː r a t i
једнодушан	j e d n ǒ d u ʃ a n
златник	z l âː t n iː k
нетактичан	n e t ǎ k t i t͡ʃ a n
композитор	k o m p ǒ z iː t o r
razilazak	r a z ǐ l a z a k
бувљак	b ǔ ʋ ʎ aː k
Fenicija	f e n ǐː t͡s i j a
мјесечина	m j ê s e t͡ʃ i n a
filc	f î l t͡s
филогенија	f i l o ɡ ěː n i j a
импутирати	i m p u t ǐː r a t i
neredovit	n e r e d ǒ ʋ i t
мултипликатор	m u l t i p l ǐ k aː t o r
sliv	s l îː ʋ
uzburkati	ǔ z b u r k a t i
