جریان	d͡ʒ r i ɑ n
کمې	k m eː
سروه	s r oː h ə
قومن	q o m n
پراخې	p r ɑ x e
ټینګار	ʈ i n ɡ ɑ r
آیایا	ɑ i ɑ i ɑ
نو	n o
کوه	k uː h
باکتریاوې	b aː k t r iː aː w eː
مرګاويا	m ə ɾ ɣ ɑ w j ɑ
خرسیو	x r s i w
اېسټونيا	e s ʈ o n j ɑ
اص	ɑ s
ګولساتونکی	ɡ o l s ɑ t o n k i
پلم	p ɪ l m
بوډا	b o ɖ ɑ
ساینسپوهانو	s ɑ i n s p o h ɑ n o
وياړي	w i ɑ ɽ i
حل	h ə l
اورېدل	a w r e d ə l
ويورکې	w i j o r k e
عقل	ʕ q l
وړانګې	w r ɑ n ɡ e
انسانانو	a n s a n a n o
ملیون	m l iː uː n
مطالعه	m t ɑ l e
وشي	w s i
پدی	p ə d i
اوشه	o ʃ a
بابد	b ɑ b d̪
ګرمدیځ	ɡ r m d i ʐ
کوزی	k oː z iː
بیه	b i h e
کولای	k ʊ l ɑ i
راوړه	r ɑ w ɻ a
دوسته	d o s t ə
رنګونه	r n ɡ w n ə
دروبوټ	d r w b w ʈ
ګټورې	ɡ ʈ o r e
انتخاب	ɪ n t ɪ x ɑː b
ټولو	ʈ o l o
دواړه	d̪ o ɑ ɽ e
دوبي	d̪ o b i
ننه	n ə n ə
کښتاندونیزیا	k ʂ t ɑː n d o n iː z iː ɑː
مېښه	m e x a
کېدای	k eɪ d aɪ
ټاکلي	ʈ ɑ k l i
کرون	k ɾ o n
حرارت	x ɾ ɑ ɾ ə t̪
بغری	b a ɣ a r a ɪ
واټن	w ɑ t n
پیروي	p i r o i
ووایم	w o ɑ i m
وکولیشم	w k o l i ʃ m
ډکه	ɖ k h
دوی	d̪ o ɪ
راستنه	r a s t n a
اورلوبه	o r l o b a
ورو	w r o ʊ
اسانۍ	ɑː s ɑː n ə iː
ساعتونو	s ɑ ʕ t u n u
نیشکیبی	n iː ʃ k iː b i
اوارخطاوه	ɑ w ɑ r x t ɑ w ə
غوړ	ɣ oː ɖʐ
انګور	a ŋ ɡ u r
ووایم	w o w ɑ i m
عقلۍ	ʕ q l ə i̯
هوښيار	h u x j ɑ r
ووایم	w o ɑ j m
مساح	m s ɑː ħ
نوي	n a w i
رامینځته	r ɑː m iː n ʈ ə
ډیرو	ɖ i r o
نشئ	n ʂ ə i
اوږدو	ɑ w ʒ d o
پیړیو	p iː ɽ iː w
پوښل	p o ʂ l
شکر	ʂ k r
غوښتنې	ɣ o x t ə n e
خرسد	x r s d
مودې	m u d e
يوولس	j a w o l a s
توازنیی	t o ɑ z n i i
بند	b ə n d
دیوالونه	d i w a l u n h a
ګوره	ɡ o r a
عجبه	ʕ ə d͡ʒ b ə
ونشي	w n ʃ i
نېښ	n ɛ x
پاککیدی	p ɑ k k i d i
ګراوه	ɡ r ɑ w ə
شم	ʃ m
خوزه	x w o z ə
راوړئ	r a w ɽ ʔ
مایو	m ɑ j o
ویښتان	v iː ʂ t ɑː n
غپل	ɣ a p ə l
لاړې	l ɑ r ə
لامبل	l ɑ m b ə l
خورن	x w r n
حبوباتو	ħ b uː b ɑː t u
کوو	k o w
چوپړ	t͡ʃ o p ə ɻ
بیه	b i h
یوهلښته	j o h l ʂ t ə
بدنروغ	b ə d n r o ɣ
غپول	ɣ a p a w ə l
سوډان	s o ɖ ɑ n
داسې	d ɑ s e
يونی	y u n a i
اتيا	a t̪ j ɑ
وړاندې	w ɻ ɑ n d e
سړي	s ə ɽ i
خوبۍ	x o b ə i
څلورم	ʂ l o r m
ټوکه	ʈ o k a
مطالعه	m ʊ t ɑː l ʕ ə
ملګرې	m ə l ɡ ə r e
اوږه	e ʒ a
نيلي	n i l i
مودې	m o d ə i̯
درزونه	d ə r z u n ə
عرب	ʕ r b
احمده	ɑː h m ə d ə
ورولم	w a r w a l ə m
راته	r ɑ t ə
ووهي	w w ə h i
کان	k ɑː n
کسوویلزه	k s uː w iː l z h
ځواک	d͡z w ɑ k
باغ	b o ɣ
والونه	w ɑ l o n ə
قرآن	q ɾ ɑ n
پاڼه	p ɑ ɳ a
لرئ	l ə r ʔ
ترسره	t r s r ə
کړل	k ɻ ə l
انسانانو	ɑ n s ɑ n ɑ n o
سبزیو	s b z i w o
کسانو	k s ɑː n uː
دروازه	d r w ɑ z a
جکړ	d͡ʒ a k a ɽ
خوښشوم	x w ɔː ʂ w ə m
جوړې	ʤ o ɻ e
لرغونی	l ə r ɣ oː n iː
بوټپوهنه	b u ʈ p o h ə n a
لاسه	l ɑ s ə
پټي	p ʈ i
عین	ʕ i n
ډبلده	ɖ b ə l d ə h
مسموم	m ə s m o m
رسیدلی	r ə s i d ə l i
ځلانده	t͡s l ɑ n d a
بارکړې	b ɑː r k ɽ e
يوهنخيتار	j o h ə n x i t ɑ r
پیرودلو	p i r o d̪ l o
دويم	d̪ w a i m
اخيستل	a x i s t ə l
وچلوم	w ə t͡ʃ l o m
بریا	b r iː ɑː
اندیښنه	a n d i x n h
شدی	ʃ d i
سيلۍ	s i l ə i
تېر	t̪ ɛ r
ګل	ɡ w ə l
شنو	ʃ n w
بدنروغ	b d n r oː ɣ
توازن	t o ɑ z n
سورپوستکي	s o r p o s t k i
کشف	k ʃ f
خوامې	x w ɑ m e
سړییم	s ɽ i j m
وټاکي	w t ɑ k i
کتاب	k i t̪ ɑ b
لویو	l oː iː o
کلکوالى	k l a k w ɑ l a ɪ
سلطنت	s ə l t̪ n ə t
ډاډ	ɖ ɑ ɖ
تنظیموي	t n z i m o i
سورخالو	s o r x ɑ l o
ویې	w iː e
آسانۍ	ɑ s ɑ n ə i
دهلیزو	d̪ a h l i z o
ځنګل	d͡z ə ŋ ɡ ə l
لامبو	l ɑ m b o
نزدې	n i z d e
ونیسي	w ə n iː s i
شی	ʃ i
اوش	o ʃ
اوریالته	a u r iː ɑː l t ə h
شا	ʃ ɑː
دیخ	d iː x
اوښسپورو	ɑ w ə x s p ɔ ɾ w
اوریدلو	ɑ w r i d l o
ووینه	w o w i n ə
هڅې	h ə t͡s e
لنډ	l n ɖ
ذکر	z ɪ k ə r
خوښشوم	x w ɔ ʂ w o m
هڅکه	h a t͡s k a
ټبر	ʈ a b a r
ګنډل	ɡ a n ɖ ə l
څښتن	ʈʂ x t n
اړینه	ɑ ɽ i n ə h
يوه	j o h e
مرغۍ	m ɾ ɣ e
کېږ	k e ʐ
ښکاره	x k ɑ r a
اوږده	o ʊ ʐ d ə
کیفیت	k i f i t
نودا	n u d ɑ
جدي	ʤ ə d i
موندلو	m u n d ə l ə w
پېړۍ	p e ɻ ə i
موټرد	m o ʈ r d
ساتونکو	s a t o n k o
کېږ	k e ʐ
ډنډ	ɖ a n ɖ
وينم	w i n ə m
واورېد	w a w r e d
ریګ	r iː ɡ
سمندر	s ə m ə n d̪ ə r
پوهیږي	p o h i ʐ i
میاشتې	m j ɑ ʂ t e
اوسیده	ɑ o s i d a
هرحال	h ə ɾ h ɑ l
اشخاصو	ɑ ʃ x ɑ s ə w
وېښته	w e x t ə
کاګل	k ɑ ɡ ə l
بادول	b ɑ d a w ə l
هګۍ	h ə ɡ ə i
پرواۍ	p r w ɑ e
وياړي	w i j ɑ ɽ i
رسیږي	r s i ʐ i
خانو	x ɑ n o
رسنۍ	r ə s ə n a i
ورسید	w o r s i d
نېښ	n eɪ ʂ
ټاکلې	ʈ ɑ k ə l e
کړکۍ	k ə r k ə j
هوښیاره	h o x j ɑ r ə
زرګونو	z ə r ɡ uː n o
ماتيږي	m ɑː t̪ iː ʐ iː
څیړنې	ʂ i r n e
اويو	o w j o
محاسبې	m ħ ɑ s b ɛ
دلی	d̪ l iː
کوونکی	k o w o n k i
استراحت	ɑ s t r ɑ h ə t
هوښیارییب	h o ʂ j ɑ r i j b
سکه	s a k a
بدپوری	b ə d̪ p o r a ɪ
ولاړیم	w l ɑ r i m
څیړنې	ʂ iː r n e
ناروغۍ	n ɑ r w ɣ e
دواړه	d oː ɑː ɽ ə
سوله	s u l h a
پلورنځي	p ə l o ɾ n d͡z i
زڼکی	z ɘ ɳ k ɑ i
ککړ	k k ɻ
ژوپوهنه	ʒ o p o h ə n a
هوښيارزیرک	h ʊ x j ɑː r z iː r k
پرتوګ	p a r t̪ u ɡ
ځکمی	ʈʂ k ə m i
اورګاډی	o r ɡ ɑ ɖ a ɪ
وګټو	w ɡ ʈ w ə w
نیمه	n i m ə
دب	d ə b
ښخو	x x o
توده	t̪ a w d̪ a
قطب	q ʊ t b
بډایه	b ɖ ɑː j ə
بربنډ	b ə r b ə ŋ ɖ
چیغه	tʃ iː ɣ ə
خواشينی	x w ɑ ʃ i n a i
احمد	ɑː h m ə d
اېخ	e x
خپله	x p ə l ə
کابل	k ɑ b ə l
اوښاوخره	ɑ w ə x ɑ w x r a
ایستل	ɑ j s t l
کاپيوره	k ɑ p i w a r a
توان	t o ɑ n
ویښتان	w iː x t aː n
شاته	ʃ ɑ t ə
نفرت	n ʊ f r ʊ t
شهزادګۍ	s h z a d g e
مدیر	m d i r
کینم	k iː n ʊ m
وېښتان	w e ʃ t̪ ɑ n
اسانه	a s ɑ n a
کالنی	k ɑ l a n a i
دوسته	d ʊ s t ə
ګڼي	ɡ ə ɳ i
ګازونه	ɡ ɑ z u n e
شامل	ʃ ɑː m l
پايله	p ɑ i l a
موټر	m o ʈ r
لا	l ɑ
پناه	p ə n ɑː h
پلورنځي	p l o r n ʐ i
منټ	m ɪ n ə ʈ
راټولیږي	r ɑː ʈ oː l iː ʐ iː
ويلواه	w i l w ɑ h
اثر	ʔ ə θ r
واخیستلاړل	w ɑ x i s t l ɑ ɽ l
مطلب	m ə t̪ l ə b
خوخرغمجن	x w x r ɣ m ʤ n
لهشکه	l h ʂ k ə
ناوړه	n ɑ w ɽ ə
میرزا	m i r z ɑ
درېيمه	d ə r e j m ə
زېږېدل	z e ɡ e d ə l
لاړل	l ɑ r ə l
نیمه	n i m ə
قطر	k a t ə r
مړشو	m ɔ r ʃ ʊ
څلور	t͡s a l o r
کیمیاوي	k i m i ɑ w i
یاد	j ɑː d
کو	k o
بيا	b j ɑ
زهرجن	z ə h r j ə n
چلولو	t͡ʃ l w l w
بېړۍ	b e ɽ ə i
وهي	w ə h i
ډا	ɖ ɑ
اويم	o j ə m
تادل	t aː d l
انتقال	a n t q a l
دلیلونه	d ə l iː l oː n ə
موږ	m i ʒ
کالي	k ɑ l i
اغږم	a ɣ a ʐ ə m
ویج	w i ʤ
شهزادګۍ	ʃ ə h z ɑ d ɡ e
ټوکو	ʈ oː k oː
آزاد	ɑ z ɑ d
واقعادا	w ɑ q e ɑ d ɑ
ګرځول	ɡ ə r d͡z a w ə l
خوندي	x o n d i
بندول	b a ŋ d̪ ə w ə l
همبرداشت	h ə m b ə r d ɑ ʂ t
نشوه	n ʃ o a
کانټینرونه	k ɑː n ʈ iː n r w n ə
بهېږم	b a h e ɡ ə m
راتلونکی	r a t l w n k i
څښم	ʦ ʊ m
ډډه	ɖ ɖ ə h
کار	k ɑ ɾ
ویجاړونکی	w iː d͡ʒ ɑː ɻ o n k i
حیرانتیا	ħ iː r ɑː n t iː ɑː
کونج	k w ə n̪ d͡ʒ
شی	ʃ i
ملګريه	m l ɡ r iː ə
غوړ	ɣ o ɽ
حلدینود	ħ l d i n o d
تړلکیدی	t ɖʐ l k iː d iː
اوږ	o ʊ ʐ
اورېدلي	ɑ o r e d l i
شالي	ʃ ɑ l i
ستړیا	s t ɻ i ɑ
څښاک	t͡s x ɑ k
دماغکې	d ə m ɑ ɣ k e
نیشکیبی	n i ʂ k i b i
هټۍ	h t e
ملګری	m ə l ɡ ə r a i
ټینګار	t̪ i ŋ ɡ ɑ ɾ
شونیه	ʃ o n iː a
مسله	m ə s l ə
زړونو	z r uː n uː
ویښته	w iː x t ə
جوړې	j o ɻ ə i̯
وکړئیا	w k ɽ ə i ɑ
غټ	ɣ a ʈ
شیشې	ʃ i ʃ e
اخ	a x
اومامي	u m ɑ m i
خبرې	x b ʊ r ə i
نوم	n o m
زیانمنوي	z i ɑ n m ə n o w i
میرمن	m i r m ə n
ثابته	θ ɑː b ə t ə
ونه	w ə n a
نړۍ	n ə ɽ ə i
ماشین	m ɑ ʃ i n
تادې	t ɑː d ə
ماته	m ɑ t ə
تېروتل	t̪ e r w a t̪ ə l
ګوړه	ɡ w ə ɽ a
اخلم	a x l ə m
ماشی	m ɑ ʃ i
بحر	b ħ r
ځمکه	t͡s m k e
ډکتاج	ɖ k t a ʒ
راغلی	r ɑ ɣ l i
آرام	ɑ r ɑ m
تودوخي	t ə w d u x i
لوبغاړې	l o b ɣ ɑ ɽ ɛ
لاريون	l ɑ r j u n
نجونې	n ə d͡ʒ uː n e
بخښل	b a x ə l
بونا	b o n ɑ
بيه	b i j e
مياشت	m j ɑ ʃ t̪
ډګرونو	ɖ ə ɡ ɾ o n o
غوږ	ɣ w a ɡ
پوښتلڅه	p w x t l ʂ ə h
مخوېينه	m ə x w e j ə n a
ډک	ɖ a k
همبرداشت	h m b r d ɑ ʂ t
جګړه	d͡ʒ ə ɡ ə ɺ ˞ a
کړو	k ɽ u
دکار	d k ɑ r
مطالعه	m ə t̪ ɑ l ɛ h ə
چیغې	t͡ʃ i ɣ ɛ
خوبي	x uː b i
وي	w i
نیم	n i m
وړيا	w ə ɻ j ɑ
کتلرامين	k ə t ə l ə r ɑ m i n
خوښي	x o ʂ i
حرارت	x r ɑː r ʊ t
غږېدل	ɣ a ɡ e d̪ ə l
بدمخی	b ə d m ə x a i
لاندیښمن	l ɑː n d i x m ə n
اوسېدونکې	o s e d̪ u n k e
اواز	ɑ w ɑ z
اوږد	u ɡ d̪
راټولیږي	ɾ a ʈ u l i ʐ i
خرس	x r s
پتنګ	p a t̪ a ŋ ɡ
هیڅوک	h iː ʈ͡s w ə k
اوږ	o ʐ
حکیم	h k i m
بلکانټینر	b l k ɑː n t iː n r
ملیون	m l iː w n
ګډېدل	ɡ a ɖ e d ə l
اواز	ɑ w ɑ z
استراحت	a s t r a h t
طبیعي	ʈ b iː ʔ iː
او	a w
ګټل	ɡ a ʈ ə l
اووه	u w ə
لوڅ	l u t͡s
مترو	m ə t r oː
سرو	s r o
بازو	b ɑ z u
وګوره	w ə ɡ u r ə
وترنرۍ	w t r n r ɛ
ویلو	w iː l uː
بدي	b ə d i
ماتی	m ɑː t iː
روغتون	r o ɣ t̪ u n
زرګونو	z ə r ɡ u n o
کڅوړو	k ʈʂ oː ɖʐ oː
ښکار	x k ɑ r
ویلزه	w i l z ə
روښانه	r o x ɑ n a
غواړي	ɣ o ɑ ɽ i
نوخر	n o x ə r
منځنی	m ə n d͡z ə n ə i
مونږ	m u n ɡ
منشي	m n ʂ i
راغله	r ɑː ɣ l ə
حللار	h l l ɑː r
افرادو	ɑ f r ɑ d o
لوري	l uː r i
بولم	b o l ə m
خوا	x w ɑ
تکیه	t̪ ə k i j ə
ملکه	m l k ɛ
یوربشې	j o r b ə ʂ e
کوبا	k u b ɑ
برابر	b a r ɑ b a r
غنمو	ɣ n ə m o
هاضمې	h ɑ ʕ m ə i̯
ناروغ	n ɑ r o ɣ
ميليون	m i l j u n
ماښامه	m ɑː x ɑː m a
کنګل	k n ɡ l
مننې	m ə n ə n e
کلمبیا	k l m b i ɑ
ولېږل	w o l e ʐ l
کونه	k w ə n a
لمن	l a m ə n
سورلنډی	s u r l ə n ɖ a i
سپنج	s p ə ŋ d͡ʒ
بهېدل	b ə h e d ə l
کوچنی	k u t͡ʃ n a i
لوین	l w iː n
وساتی	w s ɑ t i
شډل	ʃ ə ɖ ə l
بڅرکی	b ə t͡s ə r k a ɪ
ماو	m a w
مشروباتو	m ə ʃ ɾ o b ɑ t̪ o
تقویم	t q w iː m
لوړوي	l o r o j
لړه	l ə ɽ a
وضعیت	w z ʕ i t
خل	x ə l
حیواناتو	h j w ɑ n ɑ t̪ o
انا	a n ɑ
کیند	k i n d
اخته	a x t̪ a
لږ	l ə ɡ
بزګرې	b z ɡ r e
کبانو	k b ɑ n o
معلومه	m a l o m h
میوې	m i w e
ټينګ	ʈ i ŋ ɡ
ډله	ɖ a l a
اپارتمان	ɑ p ɑ ɾ t̪ m ɑ n
اواز	o w ɑ z
اوربشې	ɑ w ɾ b ʃ ɛ
مغز	m ɣ z
بکس	b ə k s
پوستکی	p w s t k i
ډیرو	ɖ i r ʊ
اوړي	oː ɽ iː
شا	ʃ ɑː
اوښسپورچی	ɑ w x s ə p ə r t ʃ i
وويل	w o i l
ښکارکوونکو	x k ɑː r k w w n k w
دی	d̪ a i
جګړن	d͡ʒ ə ɡ ɺ ˞ ə n
دروغویلو	d̪ r o ɣ o w i l o
شپې	ʃ p eː
مرګ	m a r ɡ
دریم	d ə r i m
سلطنت	s ə l t ə n ə t
پامیی	p ɑː m iː j
مطلب	m ə t̪ l ə b
دلیلونه	d l iː l uː n ə
مشرانو	m ʃ r ɑ n o
بيول	b i w ə l
درنه	d̪ r ə n a
کوه	k o h
بلې	b l e
بریالۍ	b ɾ j ɑ l ɛ
لام	l ɑː m
آرام	ɑː r ɑː m
ورسیده	w r s i d h
اونا	ɑ w n ɑ
پاکوونکو	p aː k uː w n k u
بېلولو	b e l o l o
همغږي	h ə m ɣ ʐ i
بارکړم	b ɑ r k ɻ m
شاته	ʃ ɑː t ə h
شاګردانو	ʃ ɑ ɡ ə r d ɑ n o
صنایعو	s n ɑ j ʕ o
خوبڅخه	x o b ʦ x ə
غوا	ɣ w ɑ
کوټ	k o ʈ
شاملیدو	ʂ ɑ m l i d w o
حوضڅخه	ħ o ʈ͡s ə x a
کیږم	k i ʂ m
لوبېدل	l o b e d ə l
اسانۍ	ɑ s ɑ n ə i̯
خوري	x o r i
قوماندانییر	q w m ɑ n d ɑ n i j r
سړییم	s ɻ i i m
بوټان	b u ʈ ɑ n
توازن	t w ɑː z n
ټاکلي	ʈ ɑː k l i
کتلرامين	k t l r a m i n
روسيه	r u s j a
سلطنت	s ə l t̪ n ə t
درلودله	d ə r l u d ə l ə
درلوده	d r l o d ə
ولاړیم	w ə l ɑ r i m
چونګښې	t͡ʃ o ŋ x e
مشرانوجرګه	m ə ʃ ə r ɑ n o d͡ʒ a r ɡ a
کړل	k ʊ r l
ورکړحمي	w o r k ɻ ħ m i
داتوازن	d ɑ t w ɑ z n
دادېوالو	d ɑː d e w ɑː l o
نړیوالو	n ɻ j w a l o
غاړې	ɣ a r e
حللاره	ħ l l ɑː r ɛ
غریب	ɣ r i b
میاشتې	m iː ɑː ʂ t e
غړی	ɣ ə ɽ a ɪ
ییه	j i ə
مينه	m i n a
رامين	r ɑ m i n
پوهنتونو	p o h n ə t o n o
پیښیږي	p i ʂ i ʐ i
راولې	r ɑ w ə l e
دادېوالو	d̪ ɑ d̪ e w ɑ l o
زمانېښد	z ə m ɑː n e x d
هلکغمجنشو	h l k ɣ m d͡ʒ n ʃ u
اشاره	ɑː ʃ ɑː r ə
زیاتې	z i ɑ t ɛ
ستاسې	s t ɑ s e
کبانو	k ə b ɑː n o
لوري	l o r i
خطبقه	x ə t̪ b ə q ə
ټماټر	ʈ a m ɑ ʈ ə r
ښکلی	x k w ə l a i
جالڅخه	d͡ʒ ɑ l ʈ͡s ə x ə
ناک	n ɑ k
وګړپوهنه	w ə ɡ ə ɻ p o h ə n a
توتي	t̪ u t̪ i
بنګېدل	b ə ŋ ɡ e d ə l
هوښیار	h ə w x i ɑ r
مطلب	m t l b
رسولی	r ə s u l i
اغیزمنه	ɑ ɣ i z m ə n ə
اوښسپورچی	ɑ w x s p o r t͡ʃ i
حوضپوری	ħ o s p o r i
لار	l ɑ r
ګۍ	ɡ e
نمونځ	ⁿm u ŋ d͡z
سړو	s ʊ r o
کوئ	k w ɑ i
قطارونو	q t ɑː r uː n uː
اتله	a t̪ ə l a
وکړم	w k ɻ m
تیروي	t i r o i
کسوویلزه	k s u w i l z a
آيرلنډ	ɑ j r l ə n ɖ
ښار	x ɑ r
برې	b ɾ e
ګلانو	ɡ l a n u
دروغویل	d ə r o ɣ o w i l
ځواب	ʣ w ɑ b
خواږه	x w ɑ ɡ ə
پیسې	p i s e
ګېنډی	ɡ e n ɖ a ɪ
كره	k a r a
مل	m ə l
لېونی	l e w a n a i
تقویم	t ɑ q w i m
دېګلی	d̪ e ɡ l a ɪ
ځایه	ʐ ɑː j ə
دریم	d ə r i m
یوازې	y o a z e
مخره	m x r ə
اپارتمان	ɑ p ɑ r t ə m ɑ n
درلودو	d r l o d o
زینو	z iː n o
ګورمنوکله	ɡ o r m n o k l e
نویمنځ	n o w i m n ʂ
ښاد	ʂ ɑ d
اېکوادور	e k w ɑ d o r
ام	ɑ m
مخالفت	m x ɑ l ə f t
مګردا	m ɡ r ə d ɑ
مارکیټ	m ɑ r k i ʈ
حمامیا	ħ m ɑ m i ɑ
بوتله	b oː t l ə
تولید	t uː l iː d
ډاکټرانو	ɖ ɑː k t r ɑː n o
یوسف	i o s f
ډولهمېږيان	ɖ o l ə m ʐ i ɑ n
پرانستل	p r ɑː n s t l
نفرتوز	n f r t o z
تاسوو	t aː s uː
غوښې	ɣ o x ɛ
کینم	k i n m
کېږ	k e ʐ
پوهیدم	p w h i d m
خاندي	x ɑ n d i
برېت	b r e t̪
ترمنځ	t ə r m ə n ʐ
غر	ɣ a r
تیریږي	t̪ i r i ʐ i
وئ	w ə i
وروسته	w o r o s t ə
ځواب	ʐ o ɑ b
پوهنه	p o h ə n a
وزن	w z n
نېغه	n e ɣ a
شا	ʃ ɑ
قاموس	k ɑ m o s
وړ	w ə ɻ
حوضته	ħ o z t ɑ
شو	ʃ oː
هیوادونه	h iː w ɑ d o n a
وزن	w z n
ګورې	ɡ o r e
تند	t ə n d
اوبوته	ɑ w b w t̪ ə
کیله	k i l ə
خپلیغوجلی	x p l iː ɣ uː d͡ʒ l i
خوه	x w ə h
داتمو	d ɑ t m o
لاملکیدی	l ɑ m ə l k i d i
انګړ	ɑ n g ɻ
ژبکۍ	ʒ a b a k ə i
غورځولې	ɣ o r ʒ o l e
کړئیا	k ɹ ə iː ɑː
سوټک	s o ʈ a k
سهارریما	s ə h ɑ r r i m ɑ
ډای	ɖ ɑ i
وهي	w h i
جګ	d͡ʒ ɪ ɡ
ورځې	w ə r ʒ e
شور	ʃ uː r
اوبه	o b ə
کڅوړو	k ʈ͡ʂ o ɽ o
سمیر	s ə m iː ɾ
دښته	d ʂ t ə
ویلز	w i l z
تنور	t̪ ə n u r
سوکالۍ	s o k ɑ l e
عجبه	ʕ ɪ ʤ b ə
ویده	w iː d ə
وه	w ə
اوری	a u r iː
مېخ	m e x
پخول	p a x a w ə l
لری	l ə r iː
کړي	k ə ɽ i
مغروره	m ə ɣ ɾ uː ɾ ə
ښکلیدیزه	ʂ k l i d i z ə
ونې	w n ɛ
بڼکی	b ə ɳ k a ɪ
ړومبی	ɺ ˞ u m b a i
یمنده	i m n d a
کړه	k ɻ ə
ناروغ	n a r w ɣ
ښځې	x ʈʂ e
ددې	d ə d e
تعقیبکړه	t ʕ ɑ q i b k ɽ ə
ويورکې	w j o r k e
فوټبال	f o ʈ b ɑ l
وخو	w o x o
غاړې	ɣ ɑː r ə
جنګيالی	d͡ʒ ə ŋ ɡ j ɑ l a i
انسان	ɑ n s ɑ n
سورپوستکي	s w r p w s t k i
کوی	k w i
شئ	ʃ ɑː iː
زهر	z ʊ h r
صنعت	ʂ n ʕ t
غوبه	ɣ o b a
ونيو	w n i w
خپلو	x p ə l o
کونج	k o u n d͡ʒ
ږغېدل	ʐ a ɣ e d ə l
سترګې	s ə t ə r ɡ e
مړینې	m ɽ i n ə
بدلاری	b a d l ɑ r a i
سور	s u r
زهرجن	z h ɾ d͡ʒ n
لور	l o r
ونیول	w ə n i o l
يم	j ə m
زرغون	z ə r ɣ u n
زوړ	z w r
اوښانله	ɑ o x ɑ n l a
ډریور	ɖ r ɪ j ə r
مشر	m ə ʃ r
دعوه	d̪ ɑ w a
پټي	p ʈ i
ښوونکی	x o w u n k a ɪ
خيدک	x a i d ə k
ښود	x u d
پايول	p ɑ y a w ə l
غله	ɣ l ə
ویښتانو	w i ʂ t a n o
ایستلو	ɑ j s t̪ l o
داد	d ɑ d
زهرا	z ə h r ɑ
ژر	ʐ ɾ
کلونو	k l o n o
تیریدو	t iː r iː d u
ډېرې	ɖ e r e
زیرمه	z i ɾ m h a
اندېښمن	ɑ n d̪ e x m n
لیده	l iː d ə
کول	k a w ə l
اوسیدونکو	ɑ w s i d w n k w
دېو	d̪ e o
زیانونو	z i ɑ n o n o
لیوالتیا	l j o w ɑ l t j ɑ
کېیو	k eɪ j oː
سبب	s ə b ə b
نشي	n ʃ i
همبرداشت	h m b r d ɑ ʃ t
لورته	l oː r t ə
چارې	t͡ʃ ɑ ɾ ɛ
کېو	k eː o
مترو	m ə t r o
نومونه	n o m u n e
ساعتونو	s ɑ ʕ t w n w
اسماني	a s m ɑ n i
منظم	m ə n z̪ ə m
ترشا	t ə r ʃ ɑ
خبرد	x b r d
زهرجن	z ɛ h r d͡ʒ n
تښتید	t ʂ t i d
نوۍ	n w ə i
ژغورلې	ʐ ɣ w r l e
تیریدو	t̪ iː r iː d w
راوړل	r ɑ w ɽ ə l
زبرګ	z b ə r ɡ
بیاګلختمي	b i ɑ ɡ l x t m i
والونه	w ɑ l o n ə
څونوټ	t͡s o n o ʈ
کلک	k l a k
شکایت	ʃ k ɑ j i t̪
ما	m ɑ
زغره	z ɣ a r a
غونډیو	ɣ o n ɖ i o
اشاره	a s a r h
شونیه	ʃ uː n iː ə
نښه	n x a
زړونو	z ə r o n o
پاککیدی	p ɑ k k i d i
لوبې	l uː b e
نه	n ə
وويل	w o i l
فاطمې	f ɑ t̪ m e
واد	w ɑː d
مدیر	m ə d i r
پوستکی	p o s t k i
مهربانه	m ə h r ə b ɑ n ə
بنده	b a n d̪ a
پرانستله	p r ɑː n ə s t ə l ə
سترطبیب	s t r ʈ b iː b
ښه	x a
کړئیا	k ɻ ʔ i ɑ
آیاسطل	ɑ i ɑ s t̪ l
لږوو	l ʐ w ə w
اتلس	a t̪ ə l a s
رت	r ə t
زوئلا	z w ʔ l a
لپه	l a p a
ویره	w iː r ə
ورکړ	w o r k ɻ
ونشي	v ə n ʃ iː
څاوار	t͡s ɑ w ɑ r
راغ	r a ɣ
همت	h ə m t̪
شګو	ʃ ɡ o
کاروان	k a r w a n
وړوکی	w a ɺ̢ u k a i
ترتیب	t ə r t i b
ننه	n ʊ n ə
ځار	d͡z ɑ r
سندرې	s n d r e
رسوي	r ə s w i
پاکوونکو	p ɑ k o w n k o
سرچینو	s ə r tʃ i n o
ثانيه	θ ɑː n iː ə
ماهم	m ɑ h m
وغواړی	w ɣ o ɑ ɽ i
مفکوره	m f k oː r ə
ناروغۍ	n ɑ ɾ o ɣ ɛ
ګرځیځکه	ɡ r ʐ i ʐ k ə
وموندلې	w m o n d l ə
نولسمې	n o l s ə m e
وساتی	w s a t i
خېټه	x e ʈ a
درنکړم	d r n k ɽ m
شرمیده	ʃ ə r m i d ə
مینه	m i n h a
ګواښوي	ɡ w ɑ ʂ o i
همیشه	h ə m iː ʃ ə
ریس	r iː s
سطل	s ʈ l
انګلستان	e ŋ ɡ l ɪ s t̪ ɑ n
مقدار	m q d a r
نجلۍ	n d ʒ ə l ə i
غلوله	ɣ l uː l ə
خپګان	x p ɡ ɑ n
چی	t͡ʃ iː
ریګنه	r iː ɡ ə n ə
ټول	t̪ o l
وېرېږه	w e ɾ e ʐ h a
بد	b ə d
غو	ɣ o
تودوخې	t o d o x e
اندېښمن	ɑ n d e x m ə n
ورزشته	w ə r ʒ ʃ t ə
ذهني	ð ə h n iː
قطارونو	q t aː r u n u
نظريه	n ə z ə r i j ə
سرطان	s r ʈ ɑ n
ازادۍ	a z a d ə i
چاينک	t͡ʃ ɑ i n ə k
قوي	q w i
امرونوان	a m r o n o ɑ n
دماغکې	d m ɑ ɣ k ɛ
موند	m u n d
فرانسه	p r ɑ n s a
زلیخا	z ʊ l a i x a
برج	b r a d͡ʒ
غور	ɣ o r
اوښلرم	a w ʈ͡ʂ l r m
خواړه	x w ɑ ɻ a
تودوخې	t o d o x e
څوارلس	t s w ɑ r l a s
انسان	ɑ n s ɑː n
اوسم	o s ə m
جګړول	d ʒ a ɡ ɺ ˞ a w ə l
شمسي	ʂ m s i
ولسوالۍ	w ə l ə s w ɑ l ə i
مسلې	m ə s l e
هوي	h oː iː
پرتله	p a r t̪ a l a
مۍ	m ə i̯
دود	d̪ o d̪
شغال	ʃ a ɣ ɑ l
هڅې	h ʦ e
بحر	b h r
ځیږ	z i ɡ
بلله	b ə l l ə
صنعت	s n ʕ t
ګړدود	ɡ ə ɻ d̪ o d̪
پاککړئ	p ɑ k k r ʔ
ښځينه	x ə z i n a
خورا	x oː r ɑː
املوک	a m l u k
دولتلیواله	d o l t l i w ɑ l a
به	b a
خړه	x ɹ ə
سندره	s n d r e
سبزيجاتو	s b z i d͡ʒ ɑ t̪ o
شک	ʃ ə k
کال	k ɑ l
ياله	j ɑ l ə
لهشکه	l h ʃ k a
ساعتونو	s ɑː ʕ t o n o
محاسبې	m ʊ h ɑː s b ə i
معاینه	m a y n h
تولید	t̪ o l i d̪
ټولنیزه	ʈ o l n i z a
ییوړی	j j w ɽ i
الوزم	a l w ə z ə m
غږواورېد	ɣ ʐ o ɑ w ə r ə d
حرکت	h r k t̪
توګه	t̪ o ɣ ə
اوريګامي	o r i ɡ ɑ m i
کیښودل	k i x o d ə l
تولیدیدل	t o l i d i d ə l
ساری	s a r i
پوهېږې	p w h ɛ ʐ ɛ
لاړل	l ɑ r ə l
ګړند	ɡ ʂ n d
زیرمه	z i r m ə
سړک	s ɖ k
سکالو	s k ɑ l o
بندي	b ə n d̪ i
ار	ɑ r
خړه	x r ə h
ځم	d z ə m
لاړو	l ɑ r ʊ
لوړ	l w a ɻ
ماشینونو	m ɑ ʃ i n u n u
بچیانو	b ʈ͡ʃ i ɑ n w
څرګند	t͡s ə r ɡ ə ŋ d̪
اپين	a p i n
څادر	t͡s ɑ d̪ a r
سوله	s o l a
زغمل	z ɣ a m ə l
کبنیونکو	k b n i w o n k w o
خونې	x uː n e
ډنګر	ɖ a ŋ ɡ ə r
بېل	b e l
لومړیتوب	l o m ɻ i t̪ o b
وصیت	w ə s i t
بیر	b i r
لکهګرم	l k h ɡ r m
آرامه	ɑː r ɑː m ə
کلتور	k ʊ l t̪ u r
زاګرېب	z ɑ ɡ r e b
وروڼو	w ə r uː n uː
ګردی	ɡ ə r d̪ a i
ابادول	a b ɑ d̪ a w ə l
ویزه	w i z h a
تخمونه	t ə x m u n ə
جهيل	d͡ʒ ə h i l
راښکته	r ɑ x k ə t ə
مېلوه	m e l a w a
وېره	w e r a
نږدې	n i ɡ d e
نمرکزونو	n m r k z o n o
تږی	t ʂ i
خدمتګار	x d m t ɡ ɑː r
داتمو	d ɑ t m w
کاف	k ɑː f
اورم	a w r ə m
باچا	b ɑ t͡ʃ ɑ
سیندونو	s i n d o n o
ورته	w o r t a
کاره	k ɑ r ə h
شامل	ʂ ɑ m l
ګاډۍ	ɡ ɑ ɖ e
کلمګ	k l m ɡ
ارما	ɑ r m ɑ
بیا۵	b i ɑ 5
ويده	w i d ə
راولي	r ɑ w ə l i
درنکړم	d ɾ n k ɽ m
والونه	w a l o n h
وصیت	w s i t
پلاره	p l aː r h
هغو	h ə ɣ o
وه	w h
دوام	d o ɑ m
ورځو	w o r ʐ o
شیانو	ʃ i ɑ n o
غرمې	ɣ r m e
بسکړل	b s k ɽ l
مختلفو	m x t l f o
وينګ	w a j a ŋ ɡ
بدنروغ	b d n r o ɣ
هسک	h a s k
ځایونو	ʐ ɑː j w n w
نجونې	n ə d͡ʒ u n e
نولسمې	n o l s m e
استراحتسره	a s t r a h t s r h
لوستل	l w ə s t̪ ə l
واده	w ɑ d ə
ککړونکي	k k ɚ o n k i
ولاړ	w o l ɑ ɻ
اوساتونکو	ɑ w s ɑ t u n k u
پتخ	p a t a x
اخیستلو	ɑː x iː s t l uː
ډکتاج	ɖ k t ɑ ʤ
اړول	a ɽ a w ə l
آسد	ɑː s d
بوى	b u j
کړم	k ɽ m
سپک	ʃ p a k
نیوه	n i o h e
پوهان	p o h ɑ n
ډیری	ɖ i r i
ژر	ʐ r
اچوي	a t͡ʃ o i
لیکچر	l iː k t͡ʃ ɾ
حبوباتو	ħ b o b ɑ t o
رڼا	r u ɳ ɑ
پاکستان	p ɑ k ɪ s t̪ ɑ n
ماما	m ɑ m ɑ
لکه	l k ə
خوړل	x w a ɽ ə l
مشرهوه	m ʂ r h w a
ودانۍ	w ɔ d ɑː n ə i
ګټوره	ɡ ʈ oː r ə
ویشي	v iː ʃ iː
خوندي	x oː n d iː
خدای	x u d ɑ j
ټولد	ʈ o l d
لمردی	l ə m r ə d i
غندل	ɤ a n d̪ ə l
خوښشوم	x w ʂ w m
ژوروالی	ʐ o r w a l i
شرمیده	ʃ r m i d a
تاسې	t ɑ s e
نېغه	n ə ɣ ə
داگر	d ɑː ɡ r
شکلو	ʃ k l o
غورځوي	ɣ o ɾ ʝ o j
ژبه	ʒ ə b ə
جالڅخه	d͡ʒ a l t͡s x a
ټوپکی	ʈ u p a k a i
ورڅخه	w o r t͡s x ə
وکړ	w k ɽ
دماتولو	d m ɑ t w l w
ای	ɑ i
غښتل	ɣ ə x t̪ ə l
نطفه	n ʊ t̪ f a
ښامار	x ɑ m ɑ r
مخهو	m x w
ومومي	w ə m o m i
زیاتکوی	z iː ɑ t k uː i
ونيو	w n i u
پایه	p aɪ ə
ورکوله	w r k u l h
ارزان	a r z ɑ n
بارول	b ɑ r a w ə l
زما	z m ɑ
شلتالو	ʃ a l t̪ ɑ l u
پوهیږم	p o h iː ʐ m
موندل	m u n d̪ ə l
خيرن	x i r ə n
چم	t͡ʃ ə m
جامو	d͡ʒ ɑ m o
سرو	s ə r o
نښتل	n x t̪ l
سیمې	s i m e
څرخیدو	ʂ r x iː d oː
ډېر	ɖ e r
لهشکه	l ə ʃ k ə
کمښت	k ə m ʂ t
څپېړه	t͡s a p e ɽ a
جې	d͡ʒ e
اېموجي	e m o d͡ʒ i
موادو	m w ɑ d w o
مزد	m z d
ژوند	ʒ w ə n d̪
هیله	h i l ə
الصحه	ɑ l s ʕ h ə
خوراکي	x o r ɑ k i
راختلو	r a x t l w
همت	h ə m t
منځ	m a n d z
ږمنځ	ɡ ə m ə n z
زیانهم	z i ɑ n ə h m
لمر	l a m a r
خاندي	x ɑː n̪ d i
مسله	m s ʊ l ə
فضا	f ə z ɑː
خوړنځی	x w ə ɻ ə n d͡z a ɪ
نوملړ	n u m l a ɻ
اوښانله	a w x ɑ n l ə h
موادو	m o ɑ d o
کرنه	k r ə n ə
دالتهاب	d ɑ l t ə h ɑ b
هډوکو	h ʈ w k w
ورزشته	w o r z ʃ t ə
ککړونکي	k ʊ k ɔ ɻ ʊ n k i
کیلوګرامه	k i l o ɡ r ɑ m a
نمرکزونو	n m r k z u n u
امرونوان	ɑ m r o n o ɑ n
معاشونه	m ʕ ɑ ʃ u n ə
هدف	a d ə p
سرونو	s ə r uː n o
سرطان	s r t̪ ɑ n
زیاتوي	z i ɑ t o w i
نولس	n u l a s
حشره	h ʃ r ə
پنجره	p ə n d͡ʒ r ə h
ته	t a
پدیده	p ə d i d ə h ə
واخلم	w ɑ x l m
پوله	p u l a
ایازه	i j ɑ z ə
آر	ɑ r
لارښوونې	l ɑː r x uː n e
اسکيمو	a s k i m o
کرنې	k ə r n ə i
کولاې	k o l ɑ e
دقیق	d ə q i q
هوښيارزیرک	h o ʈ͡ʂ j a r z i r k
بیرته	b i r t ə
زمری	z m a r a ɪ
کوټې	k o ʈ e
کېیخ	k eː j x
ډا	ɖ ɑ
څرخیدل	t͡s r x i d l
واورید	w ɑ w r i d
مابیا	m ɑ b i ɑ
لمریز	l ə m r i z
خلکو	x l k o
سو	s u
څکل	t s k a l
شپاړس	ʃ p ɑ ɺ ˞ ə s
راضي	r ɑ ʈ͡ʂ i
زوړ	z o ɻ
موږک	m u ɡ ə k
کوچني	k o t͡ʃ n i
اوتا	ɑ w t ɑ
دړد	d̪ ə ɺ ˞ d̪
ورکړاو	w ɔ ɾ k ɻ ɑ w
کړل	k ɽ l
څپلۍ	t͡s a p l ə i
روبوټونه	r u b ə ʈ ə w ə n ə
نن	n ə n
وباسي	w b ɑ s i
پوهیږئ	p o h i ʐ ʔ
مهربانه	m a h r b ɑ n a
سیوري	s i o r i
بلا	b ə l ɑ
ورځ	w r a d͡z
امريکايی	a m r i k ɑ j a ɪ
ومومئ	w ə m o m ə
یلد	j l d
نېغه	n e ɣ ə
سودا	s o d̪ ɑ
مسؤل	m s ʔ l
تنو	t n o
څنګه	ʈ͡s n ɡ ə
هوښیارتیا	h ʊ x j ɑː r t iː ɑ
لیدو	l i d w
پښتون	p a x t̪ u n
كوتره	k a w t̪ ə r a
چې	t͡ʃ e
منو	m a n o
مرخېړی	m a r x e ɺ̢ a i
ترلاسه	t r l ɑː s ə
ځغلول	d z ɣ ə l a w ə l
منځه	m n ʐ a
کب	k a b
وایم	w ɑ i m
زیاتې	z i j ɑ t e
مګرولې	m ɡ r uː l e
پنجره	p n ʤ r a
صنعتونو	ʂ n ʕ t uː n uː
پیل	p i l
غوړ	ɣ o r
کېږيو	k e ʐ i o
میاشت	m i ɑ ʃ t
افغانستان	a f ɣ ɑ n ɪ s t ɑ n
دښته	d x t h
زنه	z ə n a
وتښتېدل	w t x t eː d l
ولاړیم	w o l ɑ ɽ i m
کړي	k ə ɽ i
دملکې	d m l k ə i̯
زهرجنو	z h r ʒ n o
پورته	p ʊ r t ə
اور	o r
همېل	a m e l
بوتله	b u t ə l ə
وم	w ə m
زیان	z i ɑ n
حیوان	ħ i w ɑ n
پوڅه	p o t͡s a
څنګ	t s a n ɡ
وختي	w o x t i
باڼه	b ɑ ɳ ə
خردرلود	x ə r d̪ ə r l o d̪
مذهب	m a z a b
وچکړه	w t͡ʃ k ɻ a
جنګ	d͡ʒ ə ŋ ɡ
ریما	ɾ iː m ɑ
ورسیږي	w ə r s i ʐ i
بيزو	b i z o
ساینسپوهان	s ɑː j n s p w h ɑː n
مستعمری	m ə s t ʕ m ə r i
ستا	s t̪ ɑ
سړکونو	s ɻ k u n o
کېږيو	k e ʐ i o
وده	o d ə
وویله	w o w iː l ə
میبار	m iː b ɑː r
نجونې	n ə d͡ʒ o n e
اړتیاد	ɑ r t i ɑ d
طرف	t̪ ɾ ə f
سپینې	s p i n e
ننوست	n n o s t
پوښتلڅه	p o x t l ʦ ɑ
پوهې	p o h e
حکومت	h k ʊ m t
ماشین	m ɑ ʃ i n
لوړل	l o ɽ ə l
ایالاتو	a j a l a t o
منل	m a n ə l
ښارونه	x ɑ r o n a
نڅا	n ʂ ɑ
ډکدی	ɖ k d i
شومېر	ʃ u m e r
نخ	n ə x
داسطل	d ɑ s t ə l
میوې	m i w e
سبزيجاتو	s ə b z iː ʒ ɑː t w
افریقایي	ɑ f r i q ɑ i i
مرغان	m ə r ɣ ɑː n
تو	t o
اصلی	ɑ ʂ l i
تند	t̪ n d̪
قومن	q oː m n
تانوکی	t̪ ɑ n u k a ɪ
پخپله	p ə x p ə l ə
لري	l r i
كوي	k oː iː
ماشی	m a ʂ i
نوکرانو	n uː k r ɑː n u
مليکنه	m l i k n h a
ناخوښبوید	n ɑ x o ʂ b o ɪ d
سپورکس	s p ʊ r k s
غوول	ɣ o w ə l
زنګونو	z ə ŋ w ə n ə w
یوروبایوازې	j o ɾ o b ɑ j w ɑ z e
اوسسطل	a w s s t l
نولسمې	n o l s ə m e
اسپانيا	ɑ s p ɑ n j ɑ
مصرف	m ʂ r f
معدې	m ʕ ə d e
لرغونپوهنه	l ə r ɣ u n p o h ə n a
شرمښ	ʃ ə r m ə x
ونیوله	w o n i o l ə
لورته	l o r t a
وټاکي	w ʈ ɑ k i
مټ	m ə ʈ
سپي	s p iː
وده	w ə d a
اچول	a t͡ʃ a w ə l
غلط	ɣ a l a t̪
سیمه	s iː m ə
نوکغوڅی	n u k ɣ w ə t͡s a i
ژررانه	ʒ r r ɑː n ə
اوربشې	ɑ w ə ɾ b ʃ i
ټوللاغمجن	ʈ uː l l ɑː ɣ m d͡ʒ n
نیول	n i j o l
کړئ	k ɻ ə
کوشلرغونی	k o ʂ l r ɣ o n i
نېښو	n e ʂ o
نيمبو	n i m b u
ابنسینایو	ɑ b n s i n ɑ j o
پرانیستله	p r ɑ n i s t l ə
نهو	n h o
زر	z a r
کښتاندونیزیا	k ʂ t ɑ n d o n i z i ɑ
زامنو	z ɑ m n o
مړې	m ə ɽ e
دښته	d ʂ t ə
مړۍ	m a ɺ̢ ə i̯
بیلګه	b i l ɡ a
ژېړ	z j a ɻ
مشهور	m ʃ h o ɾ
پارسیوان	p ɑ r s i w ɑ n
ناسته	n ɑ s t ə
معنی	m uː ʕ n iː
تيپي	t̪ i p i
ډاډ	ɖ ɑ ɖ
ايسلنډ	a i s l æ ŋ ɖ
خوښۍ	x o ʂ ə i
جن	d͡ʒ ɑ n
بېلتون	b e l t̪ u n
کوې	k o e
وویل	w w iː l
خوبه	x o b a
ورځده	w ɾ z d a
غوړي	ɣ w a ɺ̢ i
وڅښي	w t͡s ʂ i
اسلام	ɪ s l ɑ m
شانراست	ʃ ɑ n r ɑ s t
بارکزی	b ɑ r ə k z a i
غرڅنی	ɣ a r t͡s ə n a i
معدن	m ɑ d̪ ə n
بده	b ə d a
بلې	b ə l e
چیو	t͡ʃ i o
ډاډ	ɖ ɑ ɖ
زهرجن	z ə h r ʤ n
تبا	t ə b ɑ
ماشومان	m ɑ ʂ o m ɑ n
قوماند	q o m ɑː n d
ځېل	d͡z e l
واټن	w ɑ t̪ n
تیږو	t i ʐ w
راتلونکی	r ɑ t̪ l o n k i
اپارتمان	ɑː p ɑː r t m ɑː n
مني	m a n i
غونډاری	ɣ u n ɖ ɑ r a i
لوند	l u n d̪
نویمنځ	n ɔ j iː m ə n ʈ͡s
نیولیوو	n i u l i u w
نيا	n j ɑ
سبزیو	s b z i ʊ
هغه	h a ɣ ə
اوریدو	o r i d o
ناوخ	n ɑː w x
دبولو	d b o l o
څیرې	t͡s i r e
روغتیا	r o ɣ t i ɑ
زیرکۍ	z iː ɾ k e
پې	p e
بڼ	b a ɳ
پشۍ	p ə ʃ ə i̯
زمونږ	z ə m u n ɡ
ډبل	ɖ a b ə l
ګرمدیځ	ɡ r m d i ʝ
لهشکه	l h ʃ k h
ډانډ	ɖ ɑ ŋ ɖ
ژوندی	ʒ w ə n d̪ a i
ګاڼه	ɡ ɑ ɳ a
خوشې	x o ʂ e
څنګل	t͡s ə ŋ ɡ ə l
اوساتونکو	a w s a t u n k u
وسایلو	w s aː j l u
مېجی	m e ʒ a i
چیر	t͡ʃ i r
ښوونکې	x o w u n k e
بې	b e
وویو	w o i o
راوړې	r ɑ w ɽ e
رسېدل	r ə s e d ə l
ورزشته	w ə r z ʂ t ə h
لوڼو	l o ɳ o
ییوړی	iː j o ɻ i
ژره	ʐ r ə
پړانګ	p ɽ ɑ ŋ ɡ
دوامداره	d oː ɑː m d ɑː r ə
درملنه	d ə r m ə l ə n ə
غورځول	ɣ o r d͡z a w ə l
تلویزیونریکارډرسپیکر	t ʊ l w iː z i ʊ n r iː k ɑː r ɖ r s p iː k r
مټونګى	m ə ʈ u n ɡ a i
ځای	d͡z i
سیمې	s ɪ m e
وران	w r ɑː n
ښخو	x x o
ګړندي	ɡ ɻ n d i
بیرته	b i r t a
مليکنه	m ə l i k ə n ə h
کلمګ	k l m ɡ
مورې	m w r e
اتل	a t̪ ə l
همت	h ə m t
سبزي	s b z i
په	p ə
حجم	ħ ə d͡ʒ m
پښه	p x a
چیو	tʃ iː oː
سيند	s i n̪ d̪
ځکه	d͡z ə k a
ددې	d d e
کوي	k o w i
تخمونه	t x m o n ə
نوی	n ə w a i
توپیر	t oː p iː r
یلد	j l d
ورکړل	w ə r k ɽ ə l
تصفیه	t ə s f i h ə
ساتونکی	s ɑː t oː n k iː
مدیریت	m ə d iː r iː t
همدې	h ʌ m d eɪ
خوښي	x w ʈ͡ʂ i
یلد	j ə l d̪
راوړي	r ɑ w ɽ i
کرکره	k a r k a r a
پوليس	p o l i s
خواړه	x w ɑ ɽ a
کولوومور	k o l o w o m o r
انار	a n ɑ r
کوچني	k o t͡ʃ n i
شدت	ʃ d t
کافی	k ɑ f i
کیږی	k iː ʒ iː
ډیرو	ɖ iː r o
ژګاګ	ʒ ɪ ɡ ɑ ɡ
همتوانیدلي	h m t oː ɑː n iː d l iː
چا	tʃ aː
راشي	r ɑ ʃ i
نښه	n x ə
ډولونه	ɖ o l o n h
زامبه	z ɑ m b a
غیر	ɣ a i r
بدلېدل	b a d l e d ə l
لوردر	l o r d ə r
شدت	ʃ ə d ə t
بهر	b h r
امريکا	a m r i k ɑ
تاسورښتونیوی	t ɑ s o r ʂ t o n i j o ɪ
هرصورت	h ə r s u r ə t
سپیننسواري	s p i n n s w ɑ r i
وشي	w ʂ i
تياره	t̪ iː ɑ ɾ ə
حیواناتو	ħ i w ɑ n ɑ t o
کونج	k uː n d͡ʒ
بل	b ə l
ماهم	m ɑ h m
کوچنیڅ	k o t͡ʃ n i t͡s
تويول	t o j a w ə l
دې	d̪ e
نړیواله	n r j w ɑ l ə
اړتیا	ɑ ɻ t i ɑ
اوربشې	a w r b ʃ e
درملپوهنه	d̪ ə r m ə l p o h ə n a
يوازېتو	j o ɑ z e t o
کیسه	k i s ə
ساعته	s ɑː ʕ ə t ə
سیټ	s iː ʈ
کوڅې	k o t͡s e
دقیق	d q i q
ننه	n ə n ə
خوبي	x o b i
شته	ʃ t̪ e
شامل	ʃ a m l
کیږي	k i ʂ i
پرېز	p a r e z
رامینځته	r ɑ m i n ʐ t ə
خولی	x o l i
ورځده	w o r z d ə
ساینس	s ɑ i n s
ليکوال	l i k w ɑ l
تیر	t i r
لویانو	l w j ɑ n w
شو	ʃ ʊ
تجارت	t d͡ʒ ɑ r ɑ t
انتقال	ɑ n t ɪ q ɑ l
خپګان	x p ɣ ɑ n
ورکول	w a r k a w ə l
ډیرو	ɖ iː r oː
خپور	x ə p o r
ډریور	ɖ r iː w ə r
نېښو	n e x o
خاندي	x ɑ n d i
کېښودې	k e x o d e
ساعته	s a a t h
شکل	ʃ k ə l
سټک	s a ʈ a k
مۍ	m ə iː
زامنود	z ɑː m n o d
اواقع	o w ɑ q ɛ ʕ
عدني	ʕ d n i
پرته	p ə r t ə h
مطالعه	m t ɑ l ʕ a
نویمنځ	n w i m n ʒ
بښنه	p o x t̪ ə n a
دبولو	d̪ b o l o
حللار	ħ l l ɑ r
ڼږ	ɳ ʒ
شیدې	ʃ i d e
ژبپوهنه	ʒ ə b p o h ə n a
دکار	d k ɑ r
ستونزې	s t o u n z e
نس	n a s
چاکلیټ	t͡ʃ a k l i t
سړکونو	s ɾ k u n u
تاسو	t ɑ s o
لیدلې	l i d ə l e
المانيا	a l m ɑ n j ɑ
هڅو	h ə ʂ o
خولې	x o l e
پوهیږي	p oː h iː ʐ iː
شينو	ʃ i n o
دیچی	d i c i
ځنګلونو	ʣ ə ŋ g l w n w
پوهېږې	p o h e ʐ e
اوبوته	ɑ w b o t ɑ
توکي	t o k i
مخه	m x a
اړتیا	ɑ ɽ t j ɑ
اوسې	ɑː u s e
وتلو	w ʊ t l ʊ
له	l ə
نرکاشه	n ə r k ɑ ʃ a
پلاله	p a l ɑ l a
ناسم	n ɑ s ə m
وړتیاوو	w ɽ t i ɑ w o
غویي	ɣ w ə j i
ناوخ	n ɑ w x
خوله	x w l ə
کوس	k w ə s
مخنیوي	m x n i o i
هنرونو	h n r o n o
ښیي	x iː i
قانون	q ɑː n uː n
راغلی	r ɑː ɣ l iː
جن	d͡ʒ n
څاروى	t͡s ɑ r w a ɪ
چاقور	t͡ʃ ɑː q ʊ r
خوخرغمجن	x ʊ x r ɣ m d͡ʒ n
مختلف	m x t l f
غلام	ɣ l ɑː m
تیز	t iː z
سبب	s ə b b
زام	z ɑ m
سرو	s ə r o
توګه	t̪ o ɡ e
صورت	s o r a t
تیرید	t iː r iː d
بوټو	b o ʈ o
نا	n ɑ
پراخې	p r ɑː x e
سمیر	s m iː r
نوکرانو	n w k r ɑː n uː
اخیستلو	a x i s t l u
ستر	s t ə r
ګړند	ɡ ə ɾ n d
ویلد	w i l d
سپیننسواري	s p iː n n s w ɑ r i
ځړول	t͡s ɽ u l
کېښودې	k e x o d e
نجونې	n d͡ʒ o u n e
آسولید	ɑ s o l i d
پوستکي	p o s t̪ k i
ډولهمېږيان	ɖ o l ə m e ʐ i ɑ n
داسطل	d ɑː s t ə l
نیشکیبی	n i ʃ k i b i
دونه	d̪ o n a
کثافات	k ə s ɑ f ɑ t
سره	s ə r a
اندازه	ɑ n d ɑ z ə
وړاندې	w r ɑ n d e
شنو	ʃ n oː
کافیی	k ɑ f i j
کښتاندونیزیا	k ə t ɑ n d o n i z i ɑ
رسولی	r s o l i
عمر	ʕ u m r
لارې	l ɑ r e
لی	l i
ميېر	m j e r
اثر	ɑ s ə r
لس	l a s
هیڅکله	h ɪ ʈ ʂ k ə l ə
طبیعت	t̪ ə b iː ʕ ə t̪
بدلول	b ə d̪ l a w ə l
ننو	n n u
انسان	ɑː n s ɑː n
وکولای	w o k o l ɑ j
پیښه	p iː x a
توان	t̪ o ɑ n
ايستل	i s t ə l
ویښتان	w i ʂ t ɑ n
لامل	l ɑ m ə l
وله	w a l a
تر	t r
وڅښي	w ə ʈ ʂ ə x i
ننوځي	n ʊ n w ʊ d͡ʒ iː
غورځ	ɣ oː r ʒ
دروغویل	d̪ r o ɣ o w i l
اوړم	a w ɺ ˞ ə m
واکمن	w ɑ k m a n
نړیوالو	n ə ɻ iː w ɑː l o
سرونو	s r o n o
هېلۍ	h e l ə i
درلودلو	d r l uː d l u
لمسی	l m a s a i
توازنیی	t o a z n i i
غړومبل	ɣ ɺ̢ u m b ə l
وضاحت	w ə z ɑ h ə t
ښودلې	ʂ o d l e
هرکله	h ə r k ə l ə
وکاروي	w o k ɑ r o i
هڅوي	h ə t͡s o j
مساوي	m s ɑ w i
غونډ	ɣ w ə ŋ ɖ
انصاف	ɑ n ʂ ɑ f
سندرې	s ə n d ɾ e
ولېږ	w o l e ʒ
مه	m ə h
کو	k o
ارمان	a r m ɑ n
پلازمېنه	p l ɑ z m e n a
ومومئ	w m u m ʔ i
کولومیتود	k o l o m i t o d
تازه	t ɑ z a
پخوراکي	p x o r ɑ k i
توکي	t̪ w k iː
کمپیوټر	k m p i w ʈ r
واحد	w ɑ h d
تماله	t̪ a m ɑ l a
پښتنه	p a x t̪ a n a
غمی	ɣ a l m a i
اړیکه	ɑː ɖʐ iː k ə
اوښخر	ɑ w x kʰ r
زامنر	z ɑ m n ə r
شوه	ʃ uː h
یخپوښول	j x p o ʂ o l
خورئ	x o r ʔ
ولېږل	w l e ʐ l
تجربې	t j r b e
پوستکی	p uː s t k iː
خنډ	x n ɖ
ستوری	s t̪ o r a ɪ
ورځندا	w r z n d ɑ
ښځه	x ə d͡z a
تخریب	t x r iː b
دلته	d̪ ə l t̪ a
اوولس	u w ə l a s
لږه	l ʐ ə
اورېدلو	o r ə i̯ d l o
څټک	t͡s a ʈ a k
ښايي	x ɑ y i
رنډۍ	r ə n ɖ ə i̯
وروسته	w ə r uː s t ə h
وريژې	w r i ʒ e
روانه	r w a n h
وريجې	w r i d͡ʒ e
پایه	p ɑ j e
مالکینو	m ɑ l k i n o
کسانو	k s ɑ n u
بهرنی	b ə h r n i
سړی	s a ɺ̢ a ɪ
خويندو	x w i n d o
ګروه	ɡ r o h
ال	ɑ l
ځانه	ʐ ɑ n a
شلو	ʃ l o
کندهار	k a n d̪ a h ɑ r
وایم	w ɑ j m
خطبقه	x t b q ə h
رحم	r a h ə m
اړين	ə ɻ i n
مسله	m ə s l ə
اوربشې	ɑ w r b ʂ e
کښت	k x t
کېهګۍ	k ɛ h ɡ ɛ
ډګه	ɖ a ɡ a
ځکمی	t͡s k m i
شمېرپوهنه	ʃ m e r p o h ə n a
څارویو	t͡s ɑ r o v i o
پلاره	p l ɑ ɾ ə
لویاهد	l uː j aː h d
ویښتهیی	w iː ʂ t ə h iː
درزو	d ə r z o
کوونکې	k o w u n k e
واخلي	w ɑ x l i
اوارخطاوه	o ɑː r x ʊ t ɑː w ə
لرم	l r m
تهو	t ə w o
کړک	k ɻ k
وړل	w ɻ l
ما	m ɑ
مېړۀ	m e ɻ ə
ګودر	ɡ u d̪ a r
پوهیږي	p uː h iː ʒ iː
میزکې	m i z k e
کولای	k uː l ɑː j
مرغ	m r a ɣ
خپره	x p r h
هل	h ə l
ساتنه	s ɑ t n e
ازادیم	a z aː d iː m
درد	d ɾ d
سمنټو	s ə m ə n t o
ندی	n d i
لورده	l o r d ə
وپوښت	w ə p o x t
شګو	ʃ ɡ o
دروغویلو	d ə r o ɣ o i l o
وېرېدل	w e r e d ə l
وویلدا	w o i l d̪ ɑ
موافقه	m w ɑ f ɪ q ə
څښتن	ʦ ɑː t n
وييپانګه	w ə j i p ɑ ŋ ɡ a
کس	k ə s
تنفسي	t ə n f s i
پاي	p a i
درجې	d r ə d͡ʒ e
اوږده	ɑ w ʒ d ə
لوړې	l o ɻ e
زهر	z ə h r
ډکدی	ɖ k ə d i
ور	w a r
زړه	z ɻ ə
مودې	m o d e
وګټو	w ɡ ʈ o
کوڼ	k u ɳ
پنير	p a n i r
تاوول	t ɑ w a w ə l
غڼه	ɣ ə ɳ a
شاید	ʃ ɑː j ə d
دوولس	d w o l a s
له	l a
خپلیغوجلی	x p l i ɣ w d͡ʒ l i
ویده	w i d h a
اورید	ɑ w r i d
غاړی	ɣ ɑ ɻ a i
تعقیبکړه	t ʕ ə q iː b k ə ɻ ə
وفا	w f ɑ
ناسته	n ɑː s t ə
اورېدونکی	a w r e d u n k a i
ثانيه	θ ɑ n i e
ووړکی	w o ɺ̢ k a i
بايلل	b ɑ i l ə l
لوري	l oː r iː
کښې	k x e
مرغړی	m a r ɣ a ɺ̢ a i
اړم	ɑ ʂ m
ګيټۍ	ɡ i ʈ ə i
موټرو	m w ʈ r w
کرنې	k ə r n eɪ
عدني	ʕ d̪ n i
که	k ə
ماو	m ɑ w
معاشونه	m ʕ ɑ ʃ o n ə
اړه	ɑ ɻ ə
زیانونو	z i ɑ n o n o
تبا	t b ɑ
المانی	a l m ɑ n a i
يوم	j u m
دانګ	ɖ ɑ ŋ ɡ
مل	m ʊ l
تیروي	t i ɾ o j
پوه	p o h
بييی	b i j a ɪ
رسیدلی	r s iː d l i
کوونکې	k o w u n k ə
ماهم	m ɑː h m
څیړنو	ʈ͡s iː ɖ n o
اوښانه	ɑ w x ɑ n ə
غوږونه	ɣ w ʐ w n ə
شاوخوا	ʃ ɑ w x w ɑ
زوړ	z o ɻ
شیان	ʃ i ɑ n
درې	d̪ r e
بلل	b a l ə l
قانعکړي	q ɑ n ʕ k ə ɽ i
مسلمانو	m ə s l i m ɑ n w
خورن	x o r n
چم	t͡ʃ m
زیور	z i j o r
زهرجندی	z ə h r ʤ ə n d i
کسوویلزه	k s o w i l z ə
زیانمنه	z i ɑ n m ə n ə
سيمه	s i m a
ټولګي	ʈ o l ɡ i
موافقه	m o ɑ f ɪ q a
خرسبیا	x r s b i ɑ
غنمو	ɣ n m o
وموند	uː m uː n d
ویرهیی	w iː r ə h iː
مدیریت	m ə d i r i t
سخت	s x t
څو	t͡s o
پیغام	p i ɣ ɑ m
خاص	x ɑː s
سړه	s ə ɻ a
خل	x l
مصر	m i s a r
ولیده	w l i d h a
اپريدی	a p r i d̪ a ɪ
سبزيجاتو	s ə b z i d͡ʒ ɑ t o
خت	x ə t̪
وکړم	w k ɽ m
شتون	ʃ t̪ w n
اوبوته	o b o t ə
لوړې	l o ɻ e
څاروي	t͡s a r w i
البانيا	a l b ɑ n j ɑ
وغواړی	w ɣ w ɑː r i
اوسسطل	a w s s t̪ l
هل	h ə l
افریقایي	ɑ f r i q ɑ j i
ټوټه	ʈ o ʈ ə
لومړی	l u m ɺ ˞ a i
هالنډیانو	h ɑ l n ɖ i ɑ n o
ځلانده	ʐ l ɑ n d ə
غوږونه	ɣ o ʐ o n a
ټوکو	ʈ ə w k o
ویلي	w i l i
راوړې	r ɑ w r ə
بند	b ə n d̪
اوښسپورو	ɑ w ə x s p o r o
هګیو	h ɡ i o
فوټبال	f o ʈ b ɑ l
ستونزو	s ə t u n z ə w
درملتون	d̪ ə r m ə l t̪ u n
قه	q ə
سلفراسید	s ʊ l f r ɑ s i d
زیاتوي	z i ɑ t o i
تګنه	t ɡ ə n ə
منشي	m n ʃ i
باید	b ɑ j i d̪
ستاینه	s t̪ ɑ j n ə
کچالو	k ʊ t͡ʃ ɑː l o
وټه	w ə ʈ a
بام	b ɑ m
بیاګلختمي	b i ɑ ɡ l x t ə m i
دانو	d ɑ n o
هرڅه	h ə r ʂ ə
مصرتمدن	m ə s ɾ t ə m d ə n
حیواناتو	x i w ɑ n ɑ t o
نفرتوز	n f r t w z
اخیست	ɑː x iː s t
درولم	d a r w a l ə m
ورسره	w ə r s r ə
ساتونکو	s ɑ t o n k o
زهرجندی	z ə h r d͡ʒ n d i
اوویې	ɑ w o v e
ښوویل	x o w i l
کوټې	k ʊ ʈ ə i
باور	b ɑ w ə r
غله	ɣ l a
تمرین	t̪ ə m ɾ iː n
رسولی	r ə s u l i
شل	ʃ ə l
آفریند	ɑː f r iː n d
ګاونډیو	ɡ ɑː w n ɖ iː w
اويا	a w j ɑ
بریالۍ	b r ɪ j ɑ l ə i
طبقه	t ɑ b q ə
زیانهم	z j ɑ n ɛ h m
ډز	ɖ a z
ګورم	ɡ o r ə m
کیږی	k i ʝ i
خام	x ɑ m
خدمتګارانې	x ə d̪ m ə t̪ ɡ ɑ r ɑ n e
وختوه	uː x t uː h
منشي	m ə n ʃ i
وضاحت	w ə d͡z ɑː h ə t
اوسسطل	oː s s ʈ l
منظم	m n ʐ m
پسهٔ	p s ə
هڅې	h ʊ ʦ e
ځی	d͡z a i
وشي	w o ʂ i
مور	m o r
سو	s o
آسته	ɑː s t ə h
ستړییم	s t̪ ɻ i j i m
ورځو	w o r ʐ o
پمنکی	p a m a n k a ɪ
مرغان	m ə r ɣ ɑ n
شګو	ʃ ɡ w
هیوادونو	h iː w ɑː d ə w ə n ə w
زمانېښد	z m ɑ n e x d̪
لوبډلو	l o b ɖ l o
جام	d͡ʒ ɑ m
ديارلس	d̪ j ɑ r l ə s
ویده	v iː d ə
وږی	w ə ɡ a i
سپوږمۍ	s p o ɡ m ə i
ناوړه	n ɑ w ɽ a
مېشت	m e ʃ t̪
کوئ	k w ʔ
ناروغۍ	n ɑ r o ɣ ə i
سیوري	s iː j uː r iː
حافظې	ħ a f i z e
کور	k o r
يهک	j h a k
عثمانیانو	ʕ o s m ɑ n i ɑ n o
ناړولی	n ɑ ɻ a w ɘ l a i
مهمه	m ɛ h m ɛ
وتلو	uː t l u
کینخي	k i n a x i
ګاونډیو	ɡ ɑ w n ɖ i w o
ګنده	s x ɑ
مقدار	m q d ɑː r
جیب	d͡ʒ iː b
لرغوني	l r ɣ u n i
سل	s ə l
تېروتنه	t̪ e r w a t̪ ə n a
معلومه	m ɑ l u m ə
بلوک	b l u k
غوښتونکی	ɣ o ʂ t o n k i
سوځولو	s o ʐ o l o
وایي	w ɑ j i
راضي	r aː z i
غونډیو	ɣ o n d i o
تاوتریخجنټکونه	t ɑː w t r i x d͡ʒ n ʈ k uː n ə
ګلابي	ɡ w ə l ɑ b i
اوړېدل	a w ɽ e d ə l
وکړی	w k ɽ i
تخریب	t̪ ə x r iː b
اخلي	ɑ x l i
چونګښې	t͡ʃ uː ŋ x e
غويی	ɣ w a j a ɪ
تاوتریخجنټکونه	t ɑ w t r i x d͡ʒ n ʈ k o n ə
شک	ʃ k
بکاڼه	b a k ɑ ɳ a
ځمکپوهنه	d͡z m ə k p o h ə n a
راوتلی	r aː w t ə l iː
احمد	ɑ ħ m ə d
موروه	m o r o w ə h
مخالفت	m x a l f t
توازن	t o ɑ z n
پوهې	p o h e
سمبال	s ə m b ɑ l
مختلف	m x t l f
خوامې	x w ɑ m e
بچیان	b ə t͡ʃ iː ɑː n
راځی	r ɑː ʒ iː
دوو	d w w
خورن	x ʊ r n
پیغام	p i ɣ ɑ m
وړنه	w r n a
واخلئ	w ɑ x l ə
پوخ	p o ʊ x
زه	z ə
بیا۵	b i ɑ 5
نولسمې	n w l s ə m e
شور	ʃ o r
نهو	n ɛ h o
ویینیسو	w i i n i s o
سو	s o
بوځي	b u ʐ i
ورکولې	w ə r k uː l e
اص	ɑ s
تیرې	t iː r e
کړک	k ɚ k
ابن	ɑ b n
شاګردانو	s a ɡ r d a n o
ځې	d͡z e
خبر	x b ə r
ایښودل	ɑ i x u d ə l
رت	r ə t
پړسوب	p a ɻ s o b
نشي	n ʂ i
در	d a r
نيوکه	n i w ə k a
خپلک	x p ə l k
حل	h l
توپان	t̪ o p ɑ n
وخه	w x ə
یوې	j o e
ممکن	m m k n
خوبه	x o b e
څاښکه	s ɑ x k a
تودوخې	t̪ o d̪ o x e
کتل	k a t ə l
پلورونکې	p l w r u n k e
خورم	x o r m
ککړونکي	k ə k ɽ o n k i
کبنیونکو	k b n i u n k u
زباتل	z b ɑ t̪ ə l
کوشلرغونی	k w ʃ l r ɣ w n iː
دغه	d̪ ə ɣ a
زده	z d̪ a
واټن	w ɑ t̪ n
شوي	ʃ o w i
پنځه	p i n d z ə
واخلئ	w ɑ x l ʔ
ریس	r i s
خرد	x r d
نارنجي	n ɑ r ə n d͡ʒ i
وړلی	w ɻ l i
ښکنځل	x k ə n d͡z ə l
خونه	x u n a
منظم	m ʊ n z ə m
ورځي	w o r ʒ i
خون	x o n
پروسې	p ɾ u s e
درنده	d r n d ə h
کریم	k r iː m
ړنګې	ɽ n ɡ e
ولاړ	w l a ɽ
والونه	w ɑ l uː n ə
څاروی	ʂ ɑ r w i
پوهیږي	p o h i ʐ i
اغیزمنه	ɑ ɣ i z m ʊ n ə
يوهنخيتار	j u h n x iː t ɑː r
هېر	e r
سخی	s x a ɪ
پخېدل	p ə x e d ə l
ضایع	z ɑ i ə ʕ
رامين	r ɑ m i n
حیواناتو	x i j w ɑ n ɑ t̪ o
همبرداشت	h ə m b r d ɑ ʂ t
لږوو	l ə ʒ ə w
دولتلیواله	d o l t l i w ɑ l ə
فرانسوي	f ə r ɑ n s ə w i
مېوه	m e w e
ننوست	n n oː s t
ويشتل	w i ʃ t ə l
ډا	ɖ ɑ
لوی	l o i
سویلي	s o w i l i
يې	j e
والي	w ɑ l i
خېل	x e l
وغوښتل	w ɣ o x t ə l
زموږګرانې	z ə m o ʒ ɡ r ɑ n e
دن	d ə n
باد	b ɑ d
اندیښنه	ɑ n d i x n ə
ټو	ʈ o
ماڼۍ	m ɑ ɳ ə i
بوین	b o w i n
موند	m o n d
څراغولری	t͡s ə ɾ ɑ ɣ o l ə ɾ i
روښانه	r o ʂ ɑ n a
غنماو	ɣ n m ɑ w
جلا	d ʒ ə l ɑ
ډکه	ɖ k ə
یمنده	j m n d h
فایبر	f ɑ j b ɾ
نظر	n ʕ ə r
هیرنکړو	h i r n k ɻ o
شرکت	ʂ r k t
لېور	l e w a r
دایمي	d ɑ i m i
فاطمې	f a t m e
شپږ	ʃ p a ɡ
ونډه	w ʊ n ʈ ə
طرف	t r f
ویلو	w i l o
حبشې	h ə b ʃ e
کېښوده	k e x u d a
انسانیت	ɑ n s ɑ n i t
ډاډ	ɖ ɑː ɖ
ګلختمي	ɡ l x t m iː
اپيم	a p i m
دیو	d i w
روغتانۀ	r o ɣ t̪ ɑ n ə
اوبو	ɑ w b o
ځانګړي	ʐ ɑ n ɡ ə r i
دروزه	d̪ r u z a
کړې	k ə ɽ e
هریو	h ə r i j o
ځینې	ʣ i n e
ويې	w iː ə
ورکړحمي	w ɾ k ɾ ʔ h m i
هيله	h i l a
ترڅنګ	t r ʈ͡s n ɡ
ټولساتونکي	ʈ w l s a t w n k i
دماغکې	d m ɑ ɣ k e
پلاز	p l ɑ z
بابد	b ɑ b d
سلطنت	s ə l t ə n ə t
نیشکیبی	n i ʃ k i b i
است	a s t
روان	r w ɑ n
سړى	s ʊ r i
اوښبار	ɑ w x b ɑː ɾ
بیلګه	b i l ɡ a
رنګونه	r ə ŋ ɡ u n ə
ګډی	ɡ ə ɖ a ɪ
درکول	d a r k a w ə l
پایله	p ɑ j l ə
لرل	l a r ə l
هو	h o
ګاډی	ɡ ɑ ɖ a ɪ
شپه	ʃ p a
سبزيجاتو	s b z i d͡ʒ a t u
ډولو	ɖ o l o
اوړی	o ɻ a ɪ
ونډه	w n ɖ a
دوبی	d̪ o b a i
همده	h ʌ m d ə
یادیږی	j ɑ d i ʐ i
آیا	ɑ j ɑ
نولسمې	n uː l s m e
څلوېښت	t s a l w e x t
۷۳۰	s ɛ v ɛ n θ r i z ɛ r o
مشورې	m ʂ o r e
پسرلی	p ə s ə r l a i
اې	a e
وه	w ə
پاي	p ɑ j
پروت	p r o t̪
بابل	b ɑː b l
حکیم	h k i m
کېیی	k e i i
مصرف	m ʂ r f
دشګو	d ʂ ɡ o
وروستل	w a r w a s t ə l
غنم	ɣ a n ə m
بدبختي	b ə d b x t i
خل	x ə l
ځینو	ʐ i n o
ستنه	s t ə n ə
دادی	d ɑ d i
کثافات	k ə s ɑ f ɑ t
میږیان	m i ʐ i ɑ n
راکول	r ɑ k a w ə l
اري	a r i
اصلي	a s l i
څنډه	t s ə n ɖ a
بوخت	b o x t̪
ارزانه	a r z ɑ n a
ګډوډۍ	g ɖ w ɖ ə i
زیرکۍ	z iː r k ə
ډکیو	ɖ k iː oː
موټک	m u ʈ a k
مهمه	m h m a
نیول	n iː u l
باکتریاوې	b ɑ k t r i ɑ w e
زمااندازه	z m ɑ ɑ n d ɑ z ə
وویو	w o i o
شوني	ʃ w n i
ګړندی	ɡ ə ɺ̢ a n ɖ a i
ودان	w ə d̪ ɑ n
کېدای	k e d ɑ i
لیرې	l i r e
شوې	ʃ o w e
ومومي	w o m o m i
دوبي	d o b i
راولې	r ɑ w ə l e
انصاف	ɑ n s ɑ f
ولسوالي	w ə l ə s w ɑ l i
ګېډه	ɡ e ɖ a
طباوانجینرۍ	t ə b ɑ w ɑ n j i n ə r e
ماشی	m ɑ ʃ i
ګڼ	ɡ a ɳ
پنځلس	p i n d z ə l a s
چاقور	t͡ʃ aː q u r
حسکوونکی	h ə s k uː w ə n k i
لېونۍ	l e w ə n ə i
روبوټونه	r o b o ʈ o n a
اجزا	ɑː d͡ʒ z ɑː
اخښی	a x a i
لړم	l a ɻ a m
ټپاکی	ʈ u p ɑ k a i
مخامخ	m ə x ɑ m x
پوهاند	p o h ɑ n d
لګولو	l ɡ o l o
هیل	h i l
ګرمدیځ	ɡ ə r m d i ʐ
ستايل	s t̪ ɑ j ə l
اوبدل	o b d̪ ə l
غمجن	ɣ a m d͡ʒ a n
ځوان	d͡z w ɑ n
بارکړم	b ɑː r k ɹ ə m
ګرځېدل	ɡ ə r d͡z e d̪ ə l
وویلنه	w w i l n a
وګړی	w ə ɡ ə ɻ a i
تږییی	t̪ ʐ iː iː iː
سوداګر	s u d ɑ ɡ ə r
اورې	ɑː w r e
غوښه	ɣ w a x a
دد	d d
خو	x o
اوربشې	o r b ə ʃ e
تږییی	t ʒ i i i
تود	t̪ o d̪
ځيرک	d͡z i r a k
وو	w o
آرام	ɑ r ɑ m
اف	ɑː f
هرکار	h ə r k ɑ r
مالک	m ɑ l ɪ k
غورځولې	ɣ o ɾ ʐ o l e
خوخرغمجن	x o x r ɣ m ʤ n
لمونځ	l m u n d͡z
کڅوړوبارکول	k t͡s o ɽ o b ɑ r k u l
تور	t̪ o r
پاڅیدم	p ɑ ʈ͡s i d ə m
چاکلیټ	t͡ʃ ɑ k l i ʈ
مازدیګر	m ɑ z d̪ i ɡ ə r
اوښسپورچی	ɑ w x s p o r t͡ʃ i
شين	ʃ i n
رګونو	r ɡ uː n u
ګبين	ɡ a b i n
رېبز	r e b ə d͡ʒ
يوازېتو	j o ɑ z e t o
زاڼه	z ɑ ɳ a
مختلفو	m ʊ x t l ɪ f o
ګاونډیولید	ɡ ɑ w n ɖ i o l i d
نولسمې	n o l s ə m e
بحر	b h r
پرځای	p r z aː j
څومره	t͡s u m r a
څرخول	t s a r x a w ə l
پسې	p ə s e
کتلرامين	k t ʊ l r ɑː m i n
یوسي	j u s i
ګرانو	ɡ ə ɾ ɑ n o
څېړنه	t͡s e ɻ ə n a
سبب	s ə b ə b
هره	h ə r ə
ماشییو	m ɑ ʃ i j o
رسېږئ	r s e ʐ ʔ
زوئلا	z w ə l ɑ
کرنې	k r n e
ښاد	x ɑ d
ماښامندا	m ɑ ʂ ɑ m n d ɑ
عقل	ɑ q l
اغیزه	ɑː ɣ iː z ə
ماهر	m ɑː h ə r
مرستونی	m r a s t̪ u n a ɪ
اختلالات	ʔ x t l ɑ l ɑ t
زیانهم	z iː ɑː n ə h m
وی	w iː
ژامه	ʒ ɑ m a
وخه	w ə x ə
دروغویلو	d r uː ɣ w iː l u
ولټوله	w ʊ l t uː l ə
پلورونکي	p l o r o n k i
ویشي	w i ʂ i
ما	m ɑː
سترګه	s t̪ ə r ɡ a
لیرې	l i ɻ e
زموږ	e m i ʒ
تېرۀ	t̪ e r ə
اورونه	ɑ o r u n e
انځورګر	a n d͡z o r ɡ a r
آيات	ɑ j ɑ t̪
لومړي	l o m ʊ r i
سزا	s z ɑː
جګتيا	d͡ʒ ə ɡ t̪ j ɑ
کاره	k ɑː r ə
هوکړه	h o k ɻ a
ساړه	s ɑ ɺ̢ ə
خپه	x ə p a
بی	b i
واورتون	w ɑ w r a t̪ u n
کنوه	k ɪ n w a
صنعتونو	s n ʕ ə t̪ o n o
لکهګرم	l ə k ə ɡ r m
نشو	n ə ʃ o
مزری	m z a r a ɪ
پلی	p l iː
لاسي	l ɑ s i
دا	d̪ ɑ
کوشلرغونی	k o ʃ l ə r ɣ o n i
چاپیریال	t͡ʃ ɑ p i ɾ j ɑ l
ویلد	w i l d
زامنر	z ɑ m n r
خپله	x p ə l ə
ویښتانو	w i ʂ t ɑ n o
واورې	w ɑ o r e
شیه	ʃ i h
رنګونه	r n ɡ w n ə
ايغلو	i ɣ l u
لاړې	l ɑː ɾ e
سیمه	s ɪ m ə
وړئ	w ə r ə j
لږوو	l ʈ͡ʂ o w
باکتریا	b ɑ k t ə r i ɑ
خل	x ə l
سفر	s f r
کیمیاوی	k i m i ɑ w i
انسانانو	ɑ n s ɑ n ɑ n o
ساتئ	s ɑ t e
زیرمه	z i r m ə
مرغان	m r ɣ ɑ n
مسموم	m ə s m u m
هلکغمجنشو	h ə l k ɣ ə m d͡ʒ n ə ʃ o
شومنو	ʂ o m n o
پسرل	p s r l
تللو	t ə l l o
اوروبوټو	ɑ w ɾ o b o t̪ o
پامه	p ɑː m ə
ژغورلې	ʐ ɣ o r l ə i̯
قانعکړي	q ɑː n ʕ k ə ɻ i
نرمه	n r m ə
آسولید	ɑ s o l i d
حجم	ħ ə ʤ m
توت	t̪ u t̪
وخندل	w x n d l
غپېدل	ɣ a p e d ə l
چاکلیټ	t͡ʃ ɑː k l iː ʈ
خدمتګار	x d m t ɡ ɑ r
چوڼيا	t͡ʃ u ɳ j ɑ
بوره	b u r a
اوورته	ɑ w o r t ə
ګرمي	ɡ a r m i
کاربن	k ɑ r b ə n
بیه	b iː h
غوښتنه	ɣ w ɔ x t ə n ə
یوه	j o ə
هي	h i
بابل	b ɑ b ə l
آسد	ɑ s d
پکان	p a k ɑ n
درجې	d ə r d͡ʒ e
اويو	oː iː oː
موقعیت	m o q ɑ i t
قیمتيملغلرې	q i m t̪ i m l ɣ l ə r e
ویښته	w i ʂ t ə
یوازې	j o ɑ z e
سمد	s m d
ښکارکوونکو	x k a ɾ k u w u n k u
روانه	ɾ w a n h a
اولس	u l ə s
پارسه	p ɑ r s a
ډاډه	ɖ ɑ ɖ a
هرصورت	h ə r s o r t
باغوان	b ɑ ɣ w ɑ n
ديار	d i ɑ r
اندازه	ɑ n d ɑ z a
اکسیجن	ɑ k s i d͡ʒ n
غنمبه	ɣ n ə m b ə
وترنرۍ	w t r n r ə i
ګهيځ	ɡ ə h i d͡z
میلیونو	m i l i w o n w o
تقویمونه	t ɑː q w iː m uː n ə
دروازې	d r uː ɑ z e
صنایعو	ʂ n ɑ i̯ ʕ o
غن	ɣ n
پاړو	p ɑ ɻ u
هوايي	h w ɑ j i
پرېکړه	p r e k ɻ a
څرخیدو	ʈ͡s r x i d w
جېبوتي	j e b u t̪ i
کړل	k ɽ l
پلورونکي	p l ɔ ɾ w ə n k ə i
موقعیت	m oː q ɑː ʕ iː t
چلوله	t͡ʃ l ʊ l ə
جنګول	d ʒ a ŋ ɡ a w ə l
کڅوړوبارکول	k ʈʂ ʊ ɽ ʊ b ɑ r k ʊ l
کونړ	k u n a ɻ
کنګال	k a n ɡ ɑ l
وران	w o r ɑː n
غونډیو	ɣ o n ɖ iː o
دونو	d o n o
پیژندلو	p i ʒ n d l ʊ
بابل	b ɑ b l
چيچل	t ʃ i t ʃ ə l
مړشهیا	m r ʂ ə h j ɑ
ملکه	m ə l k ə
باندې	b ɑ n d e
یوروباټ	j o r o b ɑ ʈ
زمرۍ	z m a r ə i
نشت	n ə ʃ t̪
تیږو	t i ʐ u
موټرد	m oː ʈ r d
ټاکلي	ʈ ɑ k l i
ترتیب	t ə r t iː b
اسطل	ɑ s t l
یوسي	j o w s i
کمزوری	k m z uː r i
بوزېدل	b u z e d ə l
پلورونکو	p l ɔ r ʊ n k ʊ
شوتالو	ʃ a w t̪ ɑ l u
آسانۍ	ɑ s ɑ n ə i
ځله	ʈʂ l ə
اړخ	a ɺ̢ x
وړه	w ɾ a
ُته	ʔ t̪ ə
وګړواکي	w ə ɡ ə ɻ w ɑ k i
پوښتلڅه	p o x t̪ ə l t͡s ə
اوم	u m
غونډیو	ɣ o n ɖ i o
ژو	ʐ o
ساري	s ɑː r i
بلکې	b ə l k e
ورشي	w r ʂ i
کېهګۍ	k ə i̯ h ɡ ə i̯
راننوتې	r ɑ n n o t e
ګډوډۍ	ɡ ɖ w ə ɖ e
اتڼ	a t̪ a ɳ
مخنیوي	m x n iː u i
ناورین	n ɑ w ɾ iː n
راځي	r a ʒ i
سورپوستکي	s o r p o s t k i
وييونه	w i j u n a
