janine	d͡ʒ ə n iː n
mashup	m æ ʃ ʌ p
eco	iː k ə ʊ
privilege	p ɹ ɪ v ɪ l ɪ d͡ʒ
dally	d æ l i
daimyo	d a ɪ m j o ʊ
conceptional	k ə n s ɛ p ʃ ə n ə l
xoanon	z o ʊ ə n ɑ n
masterly	m æ s t ɚ l i
reversionary	ɹ ə v ɝ ʒ ə n ɛ ɹ i
serpentine	s ɝ p ə n t a ɪ n
grandezza	ɡ ɹ æ n d ɛ t s ə
vecuronium	v ɛ k j ə ɹ o ʊ n i ə m
whatnot	w ʌ t n ɑ t
croupier	k ɹ u p i e ɪ
septicaemic	s ɛ p t ɪ s iː m ɪ k
gleams	ɡ l iː m z
schatz	ʃ æ t s
yiff	j ɪ f
leman	l iː m ə n
clit	k l ɪ t
spatialism	s p e ɪ ʃ ə l ɪ z ə m
undulant	ʌ n d͡ʒ ʊ l ə n t
adorableness	ə d ɔː ɹ ə b ə l n ə s
glorify	ɡ l ɔ ɹ ɪ f a ɪ
retransfer	ɹ iː t ɹ æ n s f ə ɹ
flapping	f l æ p ɪ ŋ
osage	o ʊ s e ɪ d͡ʒ
perplexity	p ə ɹ p l ɛ k s ə d i
seguin	s ə ɡ iː n
incapacitation	ɪ n k ə p æ s ɪ t e ɪ ʃ ə n
savagery	s æ v ɪ d͡ʒ ɹ ɪ
influencer	ɪ n f l u ə n s ə ɹ
confit	k ɒ n f iː
scotchka	s k ɑ t͡ʃ k ə
antiquity	æ n t ɪ k w ə t i
nodulus	n ɑ d͡ʒ ə l ə s
boiler	b ɔ ɪ l ɚ
injections	ɪ n d͡ʒ ɛ k ʃ ə n s
imbongis	ɪ m b ɔ ŋ ɡ i s
legally	l iː ɡ ə l i
amazingly	ə m e ɪ z ɪ ŋ l i
pegloticase	p ə ɡ l ɑ t ə k e ɪ s
dissension	d ɪ s ɛ n ʃ ə n
echo	ɛ k o ʊ
arraigning	ə ɹ e ɪ n ɪ ŋ
pyrrha	p ɪ r ə
remission	ɹ ə m ɪ ʃ ə n
watchlist	w ɔ t͡ʃ l ɪ s t
killer	k ɪ l ɚ
fink	f ɪ ŋ k
glyceride	ɡ l ɪ s ə ɹ a ɪ d
pledged	p l ɛ d͡ʒ d
kittlish	k ɪ t ə l ɪ ʃ
pultaceous	p ʌ l t e ɪ ʃ ə s
liraglutide	l ɪ ɹ æ ɡ l ʊ t a ɪ d
fountain	f a ʊ n t n̩
risorius	ɹ ɪ s ɔ ɹ i ə s
absorptive	æ b s ɔ ɹ p t ɪ v
ascorbate	ə s k ɔː ɹ b e ɪ t
furnished	f ɝ n ɪ ʃ t
geoglyph	d͡ʒ iː ə ɡ l ɪ f
scorpio	s k ɔː ɹ p ɪ o ʊ
billet	b ɪ l ɪ t
url	j u ɑ ɹ ɛ l
glyptology	ɡ l ɪ p t ɒ l ə d͡ʒ i
mascle	m æ s k ə l
berniecrat	b ɝ n i k ɹ æ t
dropped	d ɹ ɑ p t
cricoarytenoidei	k ɹ a ɪ k o ʊ æ ɹ ə t i n ɔ ɪ d i a ɪ
accentual	æ k s ɛ n t͡ʃ u ə l
landover	l æ n d o ʊ v ə ɹ
literature	l ɪ t ɚ t͡ʃ ɚ
anglo	æ ŋ ɡ l o ʊ
polished	p ɑ l ɪ ʃ t
gustable	ɡ ʌ s t ə b ə l
burgeo	b ɜː ɹ d͡ʒ o ʊ
anniversary	æ n ə v ɝ s ə ɹ i
kontor	k ɑ n t ɔ ɹ
crowings	k ɹ o ʊ ɪ ŋ z
biggs	b ɪ ɡ z
volvelle	v ɑ l v ɛ l
gurge	ɡ ɜ ɹ d ʒ
complains	k ə m p l e ɪ n z
worldly	w ɜː ɹ l d l i
thieves	θ iː v z
medalist	m ɛ d ə l ɪ s t
rustacean	ɹ ʌ s t e ɪ ʃ ə n
cork	k ɔ ɹ k
austin	ɔ s t ɪ n
delate	d ə l e ɪ t
attrit	ə t ɹ ɪ t
belly	b ɛ l i
teak	t iː k
question	k w ɛ s t j ə n
theophilus	θ iː ɒ f ɪ l ə s
yangon	j ɑ ŋ ɡ o ʊ n
amma	ʌ m ə
babs	b æ b z
glazes	ɡ l e ɪ z ɪ z
governed	ɡ ə v ɚ n d
anomic	ə n o ʊ m ɪ k
litterateur	l ɪ t ə ɹ ə t ʊ ɚ
revertent	ɹ ɪ v ɜː ɹ t ə n t
hank	h æ ŋ k
pierced	p ɪ ə ɹ s t
tones	t o ʊ n z
vaward	v ɑː w ə d
problemo	p ɹ ɑ b l e ɪ̯ m o ʊ̯
panay	p ə n a ɪ
completely	k ə m p l iː t l i
bulge	b ʊ l d͡ʒ
tender	t ɛ n d ə
debugger	d i b ʌ ɡ ə ɹ
roseate	ɹ o ʊ z i ə t
clotrimazole	k l o ʊ t ɹ a ɪ m ə z o ʊ l
elytron	ɛ l ɪ t ɹ ɒ n
cruised	k ɹ uː z d
newport	n u p ɔ ɹ t
kitty	k ɪ t i
slavi	s l ɑ v i
absurdly	æ b s ɝ d l i
dematerialize	d i m ə t ɪ ɹ i ə l a ɪ z
bears	b ɛ ɹ z
y'ave	j æ v
palingeneses	p æ l ɪ n d͡ʒ ɛ n ə s i z
jarp	d͡ʒ ɑ ɹ p
infringement	ɪ n f ɹ ɪ n d͡ʒ m ə n t
stood	s t ʊ d
changchun	t͡ʃ æ ŋ t͡ʃ ʊ n
presses	p ɹ ɛ s ɪ z
monotreme	m ɒ n ə t ɹ iː m
fluorate	f l o ɹ e ɪ t
catamaran	k æ t ə m ə ɹ æ n
halfness	h æ f n ə s
farcical	f ɑː ɹ s ɪ k ə l
quartet	k w ɔː ɹ t ɛ t
dinorwig	d ɪ n ɔ r w ɪ ɡ
glastonbury	ɡ l æ s t ə n b ɹ i
pigtail	p ɪ ɡ t e ɪ l
invent	ɪ n v ɛ n t
brooke	b ɹ ʊ k
appear	ə p ɪ ɹ
dissertation	d ɪ s ɚ t e ɪ ʃ ə n
problem	p ɹ ɑ b l ə m
khata	k ɑ t ɑ
outburst	a ʊ t b ɝ s t
aknee	ə n iː
trientine	t ɹ a ɪ ɛ n t iː n
rigging	ɹ ɪ ɡ ɪ ŋ
gibbet	d͡ʒ ɪ b ɪ t
kuchen	k u k ə n
whatsoever	h w ʌ t s o ʊ ɛ v ɚ
danicize	d e ɪ n ɪ s a ɪ z
tearful	t ɪ ɹ f ə l
thorough	θ ɜ ɹ o ʊ
adage	æ d ɪ d͡ʒ
handiwork	h æ n d i w ɝ k
emanate	ɛ m ə n e ɪ t
uric	j ʊ ɹ ɪ k
menhaden	m ɛ n h e ɪ d ə n
sokushinbutsu	s ɒ k u ʃ ɪ n b ʊ t s uː
pecuniary	p ə k j u n i ɛ ɹ i
zizania	z ɪ z e ɪ n i ə
haecceitist	h iː k s iː ə t ɪ s t
drawings	d ɹ ɔ ɪ ŋ z
faugh	f ɔː
whacks	w æ k s
bill	b ɪ l
throwendish	θ r ə ʊ ə n d ɪ ʃ
pitjantjatjara	p ɪ t͡ʃ ə n t͡ʃ ə t͡ʃ aː r ə
floyd	f l ɔ ɪ d
thaxted	θ æ k s t ɪ d
bagels	b e ɪ ɡ ə l z
flexed	f l ɛ k s t
suva	s uː v ə
frenchness	f ɹ ɛ n t͡ʃ n ə s
ceremonial	s ɛ ɹ ɪ m o ʊ n i ə l
overweather	ə ʊ v ə ɹ w ɛ ð ə ɹ
maybe	m e ɪ b i
claps	k l æ p s
zooplankton	z o ʊ ə p l æ ŋ k t ə n
sequelae	s ɪ k w iː l i
ravine	ɹ æ v ɪ n
hadder	h æ d ə ɹ
artifice	ɑː ɹ t ɪ f ɪ s
dysprosium	d ɪ s p ɹ o ʊ z i ə m
gymnastics	d͡ʒ ɪ m n æ s t ɪ k s
cameron	k æ m ə ɹ ə n
militiate	m ɪ l ɪ ʃ i e ɪ t
fengqiu	f ʌ ŋ t͡ʃ j o ʊ
try	t ɹ a ɪ
brethren	b ɹ ɛ ð ɹ ə n
impetuous	i m p ɛ t͡ʃ u ə s
eponychium	ɛ p ə n ɪ k i ə m
khedive	k ə d iː v
telepathy	t ə l ɛ p ə θ i
foolings	f uː l ɪ ŋ z
bowtie	b o ʊ t a ɪ
spell	s p ɛ l
celtomania	k ɛ l t o ʊ m e ɪ n i ə
aznavour	ɑː z n ə v ʊ ɚ
mses	m ɪ z ə z
albanian	æ l b e ɪ n i ə n
douchebag	d uː ʃ b æ ɡ
meaningful	m i n ɪ ŋ f ʊ l
bristly	b ɹ ɪ s l i
pavis	p ɑ v ɪ s
rusyn	r uː s ɪ n
marmoset	m ɑ ɹ m ə s ə t
prosodies	p ɹ ɑ s ə d i z
infinitesimal	ɪ n f ɪ n ɪ t ɛ s ɪ m ə l
epicaricacy	ɛ p ɪ k æ ɹ ɪ k ə s i
illabiality	ɪ l e ɪ b i æ l ɪ t i
cumin	k j u m ɪ n
touchy	t ʌ t͡ʃ i
tegmen	t ɛ ɡ m ə n
minigun	m ɪ n i ɡ ʌ n
solum	s o ʊ l ə m
xeriscape	z ɛ ɹ ə s k e ɪ p
illegal	ɪ l i ɡ ə l
accordionist	ə k ɔ ɹ d i ə n ə s t
timur	t ɪ m ʊ ə ɹ
apoaequorin	æ p ə ʊ iː k w ɔː ɹ ɪ n
nunation	n ʌ n e ɪ ʃ n̩
fandub	f æ n d ʌ b
supplying	s ə p l a ɪ ɪ ŋ
barometz	b æ ɹ ə m ɛ t s
viviane	v ɪ v i æ n
altman	ɔː l t m ə n
nagual	n ə ɡ w ɑː l
clutched	k l ʌ t͡ʃ t
sotol	s o ʊ t o ʊ l
sulfolipid	s ʌ l f ə l ɪ p ə d
weeper	w i p ɚ
buckaroo	b ʌ k ə ɹ u
disputatious	d ɪ s p j ə t e ɪ ʃ ə s
illness	ɪ l n ə s
pestling	p ɛ s ə l ɪ ŋ
uncountability	ʌ n k a ʊ n t ə b ɪ l ɪ t i
waterwork	w ɔ t ɚ w ɚ k
fazzolet	f æ z ə l ɛ t
throat	θ ɹ o ʊ t
rutch	ɹ ʊ t͡ʃ
pubes	p j uː b i z
capacify	k ə p æ s ɪ f a ɪ
aliter	æ l ɪ t ɚ
connective	k ə n ɛ k t ɪ v
yarn	j ɑ ɹ n
emma	ɛ m ə
desmond	d ɛ z m ə n d
abrase	ə b ɹ e ɪ z
powldoody	p a ʊ l d uː d i
beads	b iː d z
tokanui	t ɒ k ɑː n uː iː
ruckus	ɹ ʌ k ə s
which've	w ɪ t͡ʃ ə v
prof	p ɹ ɑ f
comprehension	k ɑ m p ɹ ɪ h ɛ n ʃ n̩
diomedes	d a ɪ ə m iː d iː z
snares	s n e ɚ z
eisteddfodau	a ɪ s t ɛ ð v ɒ d a ɪ
diagenesis	d a ɪ ə d͡ʒ ɛ n ə s ɪ s
stallon	s t æ l ə n
pasithea	p ə s ɪ θ ɪ ə
drover	d ɹ o ʊ v ə ɹ
piecemeal	p iː s m iː l
espresso	ɛ k s p ɹ ɛ s o ʊ
nize	n a ɪ z
determinant	d ɪ t ɝ m ɪ n ə n t
recite	ɹ ɪ s a ɪ t
politique	p ɑ l ə t ɪ k
sympiezometer	s ɪ m p i ɪ z ɒ m ɪ t ə
munificence	m j uː n ɪ f ɪ s ə n s
tyranny	t ɪ ɹ ə n i
prequel	p ɹ iː k w ə l
spelunk	s p iː l ʌ ŋ k
garboil	ɡ ɑː ɹ b ɔ ɪ l
cane	k e ɪ n
senioritis	s i n j ɚ ɑ i t ɪ s
tornedalen	t ɔː ɹ n ə d ɑː l ə n
veriest	v ɛ ɹ i ə s t
slack	s l æ k
cruising	k ɹ uː z ɪ ŋ
bacchant	b æ k ə n t
globin	ɡ l ə ʊ b ɪ n
afterward	æ f t ɚ w ɚ d
dotard	d o ʊ t ɑ ɹ d
crimp	k ɹ ɪ m p
animadversion	æ n ɪ m æ d v ɝː ʃ ə n
freshes	f ɹ ɛ ʃ ɪ z
yerkish	j ɜː r k ɪ ʃ
ink	i ŋ k
clotho	k l o ʊ θ o ʊ
roomth	ɹ uː m θ
haskell	h æ s k ə l
trichrome	t ɹ a ɪ k ɹ ə ʊ m
continue	k ə n t ɪ n j uː
straitjacketing	s t ɹ e ɪ t d͡ʒ æ k ɪ t ɪ ŋ
acrolect	æ k ɹ ə l ɛ k t
cast	k æ s t
skeezy	s k iː z i
gift	ɡ ɪ f t
nuxálk	n uː h ɒ l k
tobiano	t ə ʊ b i ɑː n ə ʊ
bins	b ɪ n z
bangalore	b æ ŋ ɡ ə l o ɹ
muntjac	m ʌ n t d͡ʒ æ k
bergsonian	b ɜː ɹ ɡ s ə ʊ n ɪ ə n
kielbasa	k i l b ɑ s ə
ricochetted	ɹ ɪ k ə ʃ ɛ t ɪ d
boughten	b ɔː t ə n
duality	d j uː æ l ɪ t i
ethane	ɛ θ e ɪ n
tucson	t uː s ɒ n
quittor	k w ɪ t ɚ
donnean	d ʌ n i ə n
quadriplegia	k w ɑ d ɹ ɪ p l i d͡ʒ ə
apartheid	ə p ɑ ɹ t a ɪ d
numberous	n ʌ m b ə ɹ ə s
irenic	a ɪ ɹ i n ɪ k
information	ɪ n f ɚ m e ɪ ʃ ə n
tyne	t a ɪ n
stook	s t ʊ k
slowth	s l o ʊ θ
nivolumab	n ɪ v ɒ l j ʊ m æ b
linsheng	l ɪ n ʃ ɛ ŋ
despotat	d ɛ s p ə t æ t
continental	k ɑ n t ɪ n ɛ n t l̩
pressed	p ɹ ɛ s t
richness	ɹ ɪ t͡ʃ n ə s
baggage	b æ ɡ ɪ d͡ʒ
punks	p ʌ ŋ k s
suppawn	s ə p ɔː n
judd	d͡ʒ ʌ d
kumara	k uː m ə ɹ ə
bentwood	b ɛ n t w ʊ d
louth	l a ʊ ð
culminate	k ʌ l m ə n e ɪ t
anaptyxis	æ n ə p t ɪ k s ɪ s
permanence	p ɜ ɹ m ə n ə n s
convinces	k ə n v ɪ n s ɪ z
reservoir	ɹ ɛ z ə ɹ v w ɑ ɹ
wiles	w a ɪ l z
skirl	s k ɜː l
abacate	æ b ə k ɑ t i
leady	l ɛ d i
restful	ɹ ɛ s t f ə l
forgot	f ɚ ɡ ɑ t
elam	iː l ə m
genizah	ɡ ɛ n i z ə
a'n't	æ n t
pudge	p ʌ d͡ʒ
welwood	w ɛ l w ʊ d
miniature	m ɪ n i ə t͡ʃ ə ɹ
overstudious	o ʊ v ɚ s t j uː d i ə s
seriousness	s ɪ ɹ i ə s n ə s
bacup	b e ɪ k ʌ p
esmolol	ɛ z m ə l ɔ l
ily	ɪ l i
sussultatory	s ʌ s ə l t e ɪ t ə ɹ i
deistically	d e ɪ ɪ s t ɪ k l i
pasadena	p æ s ə d iː n ə
horrendous	h ə ɹ ɛ n d ə s
abductor	æ b d ʌ k t ɚ
spic	s p ɪ k
macaulay	m ə k ɔː l i
cooch	k uː t͡ʃ
fran	f ɹ æ n
howdah	h a ʊ d ə
breakdown	b ɹ e ɪ k d a ʊ n
nill	n ɪ l
cnemides	n ɛ m ɪ d iː z
puffling	p ʌ f l ɪ ŋ
ethionamide	ɛ θ a ɪ ɑ n ə m a ɪ d
niobe	n a ɪ o ʊ b i
beneke	b ɛ n ə k i
totality	t o ʊ t æ l ɪ t i
animus	æ n ɪ m ə s
obey	o ʊ b e ɪ
picturesquely	p ɪ k t͡ʃ ə ɹ ɛ s k l i
internally	ɪ n t ɝ n ə l i
galoshes	ɡ ə l ɒ ʃ ɪ z
plaice	p l e ɪ s
kate	k e ɪ t
hypostatize	h a ɪ p ɒ s t ə t a ɪ z
arty	ɑː ɹ t i
abandoner	ə b æ n d ə n ɚ
spetchel	s p e t͡ʃ l
piers	p ɪ ɹ z
shleps	ʃ l ɛ p s
optofluidics	ɑ p t o ʊ f l u ɪ d ɪ k s
brotastic	b ɹ ə ʊ t æ s t ɪ k
seized	s iː z d
hallucinogen	h ə l uː s ɪ n ə d͡ʒ e n
emery	ɛ m ə ɹ i
mylar	m a ɪ l ɑ ɹ
methicilin	m ɛ θ ɪ s ɪ l ɪ n
analgesias	æ n ə l d͡ʒ iː z ɪ ə z
permeable	p ɜː ɹ m i ə b ə l
blokes	b l o ʊ k s
developmentals	d ɪ v ɛ l ə p m ɛ n t ə l z
caused	k ɔ z d
canaigre	k ə n a ɪ ɡ r i
rectum	ɹ ɛ k t ə m
luminescence	l uː m ə n ɛ s ə n s
valuable	v æ l j u ə b l̩
hark	h ɑː ɹ k
blackguard	b l æ ɡ ɚ d
requisite	ɹ ɛ k w ɪ z ɪ t
artificial	ɑː ɹ t ə f ɪ ʃ ə l
dialectician	d a ɪ ə l ɛ k t ɪ ʃ n
misconceit	m ɪ s k ə n s iː t
sowl	s a ʊ l
conclude	k ə n k l uː d
dentro	d ɛ n t ɹ o ʊ
quiche	k iː ʃ
attendment	ə t ɛ n d m ə n t
relentlessness	ɹ ɪ l ɛ n t l ə s n ə s
qataban	k ɑ t ə b ə n
dipstick	d ɪ p s t ɪ k
evapotranspirational	ɪ v æ p o ʊ t ɹ æ n s p ɪ ɹ e ɪ ʃ ə n ə l
manifestation	m æ n ɪ f ə s t e ɪ ʃ ə n
gymnasium	d͡ʒ ɪ m n e ɪ z i ə m
tickets	t ɪ k ɪ t s
synoecious	s ɪ n iː ʃ ə s
dissemination	d ɪ s ɛ m ɪ n e ɪ ʃ ə n
purdah	p ɝ d ə
regulator	ɹ ɛ ɡ j u l e ɪ t ɚ
interfrastically	ɪ n t ɚ f ɹ æ s t ɪ k ʌ l i
saccharide	s æ k ə ɹ a ɪ d
imply	ɪ m p l a ɪ
dipole	d a ɪ p o ʊ l
bulletproof	b ʊ l ɪ t p ɹ uː f
hubby	h ʌ b i
zzzs	z iː z
croggle	k ɹ ɒ ɡ ə l
ectasis	ɛ k t ə s ɪ s
squeenix	s k w iː n ɪ k s
supraclavicular	s u p ɹ ə k l æ v ɪ k j ə l ɚ
kelvin	k ɛ l v ə n
opry	ɒ p ɹ i
disinherit	d ɪ s ɪ n h ɛ ɹ ɪ t
intricate	ɪ n t ɹ ɪ k e ɪ t
israelite	ɪ z ɹ e ɪ ə l a ɪ t
perform	p ɚ f ɔ ɹ m
taciturn	t æ s ɪ t ɝ n
bale	b e ɪ̯ l
armiger	ɑː ɹ m ɪ d͡ʒ ɚ
askance	ə s k æ n s
laryngitis	l ɛ ɹ ɪ n d͡ʒ a ɪ t ɪ s
orinoco	o ʊ ɹ ɪ n o ʊ k o ʊ
virtue	v ɝ t͡ʃ u
pistole	p ɪ s t o ʊ l
malm	m ɑː l m
machinist	m ə ʃ iː n ɪ s t
poise	p ɔ ɪ z
oganesson	o ʊ ɡ ə n ɛ s ɒ n
oneironaut	o ʊ n a ɪ ɹ o ʊ n ɔ t
kakemono	k ɑ k e ɪ m o ʊ n o ʊ
perjury	p ɜː ɹ d͡ʒ ə ɹ i
setup	s ɛ t ʌ p
semeion	s ɪ m a ɪ ɒ n
ululate	j uː l j u l e ɪ t
pizzazz	p ɪ z æ z
cohesive	k o ʊ h iː s ɪ v
avian	e ɪ v i ə n
shocking	ʃ ɑ k ɪ ŋ
wanton	w ɑ n t ə n
cowslip	k a ʊ s l ɪ p
secs	s ɛ k s
walnut	w ɑ l n ə t
painted	p e ɪ n t ɪ d
swadeshi	s w ə d ɛ ʃ i
attire	ə t a ɪ ɚ
permission	p ɚ m ɪ ʃ ə n
besought	b ɪ s ɔː t
poliorcetics	p o ʊ l i ɔ ɹ s ɛ t ɪ k s
astrand	ə s t ɹ æ n d
squirmy	s k w ɝ m i
fungi	f u n d͡ʒ i
incumbent	ɪ n k ʌ m b ə n t
unwittingly	ʌ n w ɪ t ɪ ŋ l i
commitment	k ə m ɪ t m ə n t
madeline	m æ d ə l ɪ n
unmerited	ʌ n m ɛ ɹ ɪ t ɪ d
readily	ɹ ɛ d ɪ l i
eschatology	ɛ s k ə t ɔ l ə d͡ʒ i
desnuda	d ɛ s n u d ɑ
shivering	ʃ ɪ v ə ɹ ɪ ŋ
derich	d i ɹ ɪ t͡ʃ
baulk	b ɔ k
najis	n ɑ d͡ʒ ɪ s
subpoena	s ə p iː n ə
rorty	ɹ ɔː t i
kittitas	k ɪ d ɪ t æ s
longsword	l ɔ ŋ s ɔ ɹ d
hunnish	h ʌ n ɪ ʃ
roaming	ɹ o ʊ m ɪ ŋ
quetiapine	k w ɪ t a ɪ ə p i n
peaceful	p iː s f ə l
leicester	l ɛ s t ɚ
bespawl	b ɪ s p ɔ l
maim	m e ɪ m
adieu	ə d j u
lardiner	l ɑ ɹ d ə n ɚ
flimsy	f l ɪ m z i
pasch	p æ s k
amain	ə m e ɪ n
sandwich	s æ n d w ɪ d͡ʒ
concordant	k ə ŋ k ɔː ɹ d ə n t
hitched	h ɪ t͡ʃ t
reterritorialization	ɹ iː t ɛ ɹ ɪ t ɔː ɹ i ə l a ɪ z e ɪ ʃ ə n
maybach	m a ɪ b ɑː k
keene	k iː n
visceral	v ɪ s ɚ ə l
ratio	ɹ e ɪ ʃ i o ʊ
bolster	b o ʊ l s t ɚ
blin	b l ɪ n
resubject	ɹ iː s ə b d͡ʒ ɛ k t
foist	f ɔ ɪ s t
spirochetolytic	s p a ɪ r o ʊ k i t ə l ɪ t ɪ k
gauge	ɡ e ɪ d͡ʒ
ivanovna	ɪ v æ n ə v n ə
gracilis	ɡ r æ s ə l ɪ s
skein	s k e ɪ n
naively	n a ɪ i v l i
oats	o ʊ t s
slushee	s l ʌ ʃ i
fragility	f ɹ ə d͡ʒ ɪ l ɪ t i
optime	ɒ p t ɪ m e ɪ
enslave	ɪ n s l e ɪ v
figgy	f ɪ ɡ i
prepotent	p ɹ ɪ p o ʊ t ə n t
dinnet	d ɪ n ə t
hummel	h ʌ m ə l
epics	ɛ p ɪ k s
alludes	ə l uː d z
kilton	k ɪ l t ə n
stabilization	s t e ɪ b ə l a ɪ z e ɪ ʃ ə n
cupe	k j u p i
ackee	æ k iː
superinstantaneous	s uː p ɚ ɪ n s t ə n t e ɪ n i ə s
report	ɹ ɪ p ɔ ɹ t
hates	h e ɪ t s
pledging	p l ɛ d͡ʒ ɪ ŋ
reciprocal	ɹ ɪ s ɪ p ɹ ə k ə l
immoved	ɪ m uː v d
sensical	s ɛ n s ɪ k ə l
starven	s t ɑ ɹ v ə n
horrible	h ɒ ɹ ɪ b ə l
pleas	p l iː z
lessen	l ɛ s ə n
firth	f ɝ θ
perf	p ɜː ɹ f
honoree	ɑ n ɚ i
jiggle	d͡ʒ ɪ ɡ ə l
congeniality	k ə n d͡ʒ iː n i æ l ɪ t i
responsiveness	ɹ ɪ s p ɒ n s ɪ v n ɪ s
tanuki	t ɑ n u k i
diiodohydroxyquinoline	d a ɪ a ɪ ə d o ʊ h a ɪ d ɹ ɑ k s ɪ k w ɪ n ə l i n
calmer	k ɑː m ə
unionization	j uː n j ə n a ɪ z e ɪ ʃ ə n
lever	l iː v ɚ
galápagos	ɡ ə l æ p ə ɡ o ʊ s
delirate	d ɛ l ɪ ɹ e ɪ t
jeepney	d͡ʒ iː p n i
lob	l ɒ b
vexillology	v ɛ k s ə l ɑ l ə d͡ʒ i
pittance	p ɪ t ə n s
homeless	h o ʊ m l ə s
grimly	ɡ ɹ ɪ m l i
biokinesis	b a ɪ o ʊ k ɪ n i s ɪ s
cephalopod	s ɛ f a l a p ɑ d
viable	v a ɪ ə b ə l
hizouse	h ɪ z a ʊ s
bathylimnetic	b æ θ i l ɪ m n ɛ t ɪ k
wat	w æː t
diphone	d a ɪ f ə ʊ n
tumbril	t ʌ m b ɹ ɪ l
cockle	k ɒ k l̩
helve	h ɛ l v
airport	ɛ ɹ p ɔ ɹ t
tait	t e ɪ t
misguilt	m ɪ s ɡ ɪ l t
oversevere	ə ʊ v ə s ɪ v ɪ ɹ
trip	t ɹ ɪ p
soup	s u p
tombal	t uː m b ə l
streetlet	s t ɹ iː t l ə t
panipuri	p ɑ n i p ʊ ɹ i
converted	k ə n v ɝ t ɪ d
premarin	p ɹ ɛ m ə ɹ ɪ n
cosmopolite	k ɑ z m ɑ p ə l a ɪ t
bellburns	b ɛ l b ɝ n z
pitchfork	p ɪ t͡ʃ f ɔ ɹ k
matador	m æ t ə d ɔ ɹ
inwit	ɪ n w ɪ t
merde	m ɛː ɹ d
balrog	b æ l ɹ ɑ ɡ
trioecious	t r a ɪ iː ʃ ɪ ə s
feiseanna	f ɛ ʃ ə n ə
jamoke	d͡ʒ ə m ə ʊ k
blasphemy	b l æ s f ə m i
weazen	w iː z ə n
obtain	ə b t e ɪ n
waul	w ɔː l
cuajo	k w a h o
gimble	ɡ ɪ m b ə l
arriving	ə ɹ a ɪ v ɪ ŋ
fascial	f e ɪ ʃ ə l
galwegian	ɡ ɔ l w i d͡ʒ ə n
wenis	j uː n ə s
cannon	k æ n ə n
jbiebs	d͡ʒ e ɪ b i b s
wylie	w a ɪ l i
andersen	æ n d ə ɹ s ə n
aramaic	æ ɹ ə m e i ɪ k
ramification	ɹ æ m ə f ə k e ɪ ʃ ə n
reaction	ɹ i æ k ʃ ə n
belts	b ɛ l t s
rovibrational	ɹ ə ʊ v a ɪ b ɹ e ɪ ʃ ə n ə l
han	h e ɪ n
remigrate	ɹ iː m a ɪ ɡ ɹ e ɪ t
grog	ɡ ɹ ɑ ɡ
grim	ɡ ɹ ɪ m
gravid	ɡ ɹ æ v ɪ d
seeking	s iː k ɪ ŋ
crumple	k ɹ ʌ m p ə l
deluded	d ɪ l uː d ɪ d
hydraulics	h a ɪ d ɹ ɔː l ɪ k s
accelerometer	æ k s ɛ l ə ɹ ɑ m ə t ɚ
phantasm	f æ n t æ z ə m
broiler	b ɹ ɔ ɪ l ɚ
prior	p ɹ a ɪ ɚ
adianoeta	e ɪ d a ɪ ə n ə ʊ iː t ə
sunbathe	s ʌ n b e ɪ ð
montezuma	m ɒ n t ɪ z uː m ə
wench	w ɛ n t͡ʃ
thermometer	θ ɚ m ɑ m ɪ t ɚ
distorted	d ɪ s t ɔ ɹ t ɪ d
holofernes	h ɑː l ə f ɝː n iː z
banes	b e ɪ n z
extensively	ɛ k s t ɛ n s ɪ v l i
missend	m ɪ s s ɛ n d
lingual	l ɪ ŋ ɡ j u ə l
clock	k l ɑ k
anemia	ə n i m i ə
kelleher	k ɛ l ə h ɚ
lumen	l u m ə n
fictional	f ɪ k ʃ ə n ə l
condescending	k ɑ n d ə s ɛ n d ɪ ŋ
krakatoa	k ɹ æ k ə t o ʊ ə
after	æ f t ɚ
besmirch	b ɪ s m ɝː t͡ʃ
handless	h æ n d l ə s
finical	f ɪ n ɪ k ə l
hypospadias	h a ɪ p ə s p e ɪ d i ə s
gloomiest	ɡ l u m i ə s t
utonian	j uː t o ʊ n i ə n
eep	i p
recreancy	ɹ ɛ k ɹ i ə n s i
maftir	m ɑː f t iː ɹ
ratisbon	ɹ æ t ɪ z b ɑ n
todd	t ɑ d
prosecco	p ɹ o ʊ s ɛ k o ʊ
chieftain	t͡ʃ iː f t ə n
convoluted	k ɑ n v ə l u t ə d
bearable	b ɛ ə ɹ ə b ə ɫ
nogai	n o ʊ ɡ a ɪ
ganguro	ɡ ɑː n ɡ u ɹ ə ʊ
effected	ɪ f ɛ k t ɪ d
danwei	d ɑː n w e ɪ
hexapod	h ɛ k s ə p ɑ d
stardom	s t ɑ ɹ d ə m
ortiz	ɔ ɹ t i s
succame	s ə k e ɪ m
obsign	ə b s a ɪ n
climb	k l a ɪ m
swelt	s w ɛ l t
tteokbokki	t ɒ k b ə ʊ k i
silhouette	s ɪ l uː w ɛ t
hope	h o ʊ p
irritated	ɪ ɹ ɪ t e ɪ t ɪ d
faiths	f e ɪ θ s
hettotype	h ɛ t ə t a ɪ p
vaguened	v e ɪ ɡ ə n d
rheumy	ɹ uː m i
adaptable	ə d æ p t ə b ə l
observed	ə b z ɝ v d
encyclopediae	ɪ n s a ɪ k l ə p iː d i a ɪ
rested	ɹ ɛ s t ə d
pallium	p æ l i ə m
scamp	s k a m p
polygynandry	p ɑ l i d͡ʒ ɪ n æ n d ɹ i
tabby	t æ b i
treyf	t ɹ e ɪ f
chic	ʃ i k
nipple	n ɪ p ə l
caib	k e ɪ b
versipel	v ɜː s ɪ p ɛ l
spread	s p ɹ ɛ d
skive	s k a ɪ v
dawlish	d ɔː l ɪ ʃ
publicly	p ʌ b l ɪ k l i
ablepharous	æ b l ɜ f ə ɹ ʌ s
pilates	p ɪ l ɑː t iː z
mésalliance	m e ɪ z ə l a ɪ ə n s
seedtime	s iː d t a ɪ m
adenines	æ d ɪ n ɪ n z
knew	n j u ʊ̯
quim	k w ɪ m
ado	ə d uː
sever	s ɛ v ɚ
play	p l e ɪ
adirondack	æ d ɪ ɹ ɑ n d æ k
relic	ɹ ɛ l ɪ k
arthur	ɑ ɹ θ ɚ
supercollider	s u p ɚ k ə l a ɪ d ɚ
bacn	b e ɪ k ə n
dorothy	d ɔ ɹ ə θ i
misfortune	m ɪ s f ɔ ɹ t͡ʃ ə n
kinney	k ɪ n i
assess	ə s ɛ s
demonstrate	d ɛ m ə n s t ɹ e ɪ t
dewey	d uː i
flaneur	f l ɑ n ʊ ɚ
quibble	k w ɪ b ə l
manner	m æ n ɚ
coquette	k o ʊ k ɛ t
chomp	t͡ʃ ɑ m p
inhabitiveness	ɪ n h æ b ɪ t ɪ v n ə s
lpwan	ɛ l p iː w æ n
drought	d ɹ a ʊ t
quartararo	k w ɔ ɹ t ə ɹ ɑː ɹ o ʊ
cried	k ɹ a ɪ d
corporate	k ɔ ɹ p ə ɹ e ɪ t
juridicial	d͡ʒ ʊ ɹ ɪ d ɪ ʃ ə l
pactless	p æ k t l ə s
pudor	p j uː d ɔː
tufty	t ʌ f t i
nomenclature	n o ʊ m ə n k l e ɪ t͡ʃ ɚ
clinical	k l ɪ n ɪ k ə l
abdominocardiac	æ b d ɑ m ɪ n o ʊ k ɑ ɹ d i æ k
concave	k ɑ n k e ɪ v
audrey	ɔː d ɹ i
juniper	d͡ʒ u n ɪ p ɚ
paraparaumu	p a ɹ ə p a ɹ ə uː m uː
kellion	k ɛ l iː ɑ n
buddhist	b u d ɪ s t
galangal	ɡ ə l æ ŋ ɡ ə l
parterre	p ɑː ɹ t ɛ ɚ
abstinently	æ b s t ə n n̩ t l i
nictitate	n ɪ k t ɪ t e ɪ t
potency	p ə ʊ t ə n s i
shitting	ʃ ɪ t ɪ ŋ
tiggerish	t ɪ ɡ ə ɹ ɪ ʃ
planetary	p l æ n ə t ɛ r i
clitoral	k l ɪ t ɔ ɹ ə l
banker	b æ ŋ k ɚ
ensue	ɪ n s uː
antecedent	æ n t ɪ s iː d ə n t
cannoli	k ə n o ʊ l i
nippon	n ɪ p ɑ n
renaldo	ɹ ɪ n æ l d ə ʊ
tentacular	t ɛ n t æ k j uː l ə ɹ
pentetrazol	p ɛ n t ɛ t ɹ ə z ɒ l
hohenzollern	h o ʊ ə n z ɑ l ə ɹ n
taxi	t æ k s i
rerefief	ɹ ɪ ə ɹ f iː f
whicker	h w ɪ k ɚ
pacifism	p æ s ɪ f ɪ z ə m
hexings	h ɛ k s ɪ ŋ z
ingravidate	ɪ ŋ ɡ ɹ æ v ɪ d e ɪ t
nasus	n e ɪ s ə s
gums	ɡ ʌ m z
scoop	s k uː p
aroint	ə ɹ ɔ ɪ n t
morris	m ɒ ɹ ɪ s
mineralogize	m ɪ n ə ɹ æ l ə d͡ʒ a ɪ z
maniacally	m ə n a ɪ ə k l i
schwa	ʃ w ɑ
hearthstone	h ɑ ɹ θ s t o ʊ n
phenoxypropazine	f ə n ɒ s k i p ɹ ə ʊ p ə z iː n
sailor	s e ɪ l ɚ
redie	ɹ iː d a ɪ
cumbric	k ʌ m b ɹ ɪ k
authorized	ɔ θ ə ɹ a ɪ z d
nationwide	n e ɪ ʃ ə n w a ɪ d
colposcope	k ɒ l p ə s k ə ʊ p
termini	t ɝ m ə n a ɪ
crewkerne	k ɹ uː k ə ɹ n
indifferent	ɪ n d ɪ f ə ɹ ə n t
vali	v ɑː l ɪː
casey	k e ɪ s i
afresh	ʌ f ɹ ɛ ʃ
lain	l e ɪ n
brand	b r æ n d
statutory	s t æ t͡ʃ ə t ɔ ɹ i
towards	t o ʊ ɚ d z
kiang	k i æ ŋ
adusk	ə d ʌ s k
nuqta	n ʊ k t ə
folger	f o ʊ l d͡ʒ ə r
ludomusicologist	l u d o ʊ m j u z ɪ k ɑ l ə d͡ʒ ɪ s t
floss	f l ɔ s
polyzoan	p ɒ l i z ə ʊ ə n
brits	b ɹ ɪ t s
crumbs	k ɹ ʌ m z
uncial	ʌ n s i ə l
ultravast	ʌ l t ɹ ə v æ s t
tunnel	t ʌ n ə l
cradle	k ɹ e ɪ d ə l
cardiganshire	k ɑː ɹ d ɪ ɡ ə n ʃ ə ɹ
hella	h ɛ l ə
finely	f a ɪ n l i
nulled	n ʌ l d
apraxia	ə p ɹ æ k s ɪ ə
phenylsilatrane	f ɛ n ɪ l s ɪ l ə t ɹ e ɪ n
medicaster	m ɛ d ə k æ s t ɚ
putid	p j uː t ɪ d
hagiographer	h æ ɡ i ɑ ɡ ɹ ə f ɚ
ciabatta	t͡ʃ ə b ɑː t a
arnaut	ɑ ɹ n a ʊ t
morpheus	m ɔ ɹ f j u s
trifles	t ɹ a ɪ̯ f l̩ z
panettone	p æ n ə t o ʊ n i
dearly	d ɪ ɹ l i
choral	k ɔ ɹ ə l
abasement	ə b e ɪ s m ə n t
ginnie	d͡ʒ ɪ n i
cissy	s ɪ s i
apparel	ə p æ ɹ ə l
pushpin	p ʊ ʃ p ɪ n
deliberate	d ɪ l ɪ b ə ɹ e ɪ t
noon	n uː n
gangnam	ɡ ɑ ŋ n ɑ m
satire	s æ t a ɪ ɹ
adorbs	ə d ɔ ɹ b z
reify	ɹ e ɪ ə f a ɪ
toxicant	t ɒ k s ɪ k ə n t
fairing	f ɛ ɹ ɪ ŋ
horses	h o ɹ s ə z
avaunce	ə v ɑː n s
computerette	k ə m p j u t ɚ ɹ ɛ t
shanxi	ʃ ɑ n ʃ i
zoledronate	z o ʊ l ɛ d ɹ ə n e ɪ t
unaccountable	ʌ n ə k a ʊ n t ə b l̩
sleekly	s l iː k l i
cardinal	k ɑ ɹ d n ə l
sanctimonious	s æ ŋ k t ə m o ʊ n i ə s
phrasebooks	f ɹ e ɪ z b ʊ k s
omega	o ʊ m e ɪ ɡ ə
commissions	k ə m ɪ ʃ ə n z
clumb	k l ʌ m
fledge	f l ɛ d͡ʒ
devs	d ɛ v z
vinblastine	v ɪ n b l æ s t iː n
bona	b ə ʊ n ə
wealy	w iː l i
linwood	l ɪ n w ʊ d
quixotry	k w ɪ k s ə t ɹ i
gazelle	ɡ ə z ɛ l
accretion	ə k ɹ i ʃ ə n
counsel	k a ʊ n s ə l
baritsu	b ɑː ɹ ɪ t s uː
feelings	f iː l ɪ ŋ z
fip	f ɪ p
cumming	k ʌ m ɪ ŋ
reneg	ɹ ɪ n e ɪ ɡ
jammy	d͡ʒ æ m i
atrichic	e ɪ t ɹ ɪ k ɪ k
papa	p ɑː p ə
redaction	ɹ ə d æ k ʃ ə n
deceives	d ɪ s iː v z
propice	p ɹ ə p a ɪ s
vada	v ɑː d ə
wandy	w ɒ n d i
eunice	j uː n ɪ s
henpeck	h ɛ n p ɛ k
ockendon	o k ɪ n d ə n
inkling	ɪ ŋ k l ɪ ŋ
blacon	b l e ɪ k ə n
is	ɪ z
fopdoodle	f ɑ p d u d ə l
inquest	ɪ ŋ k w ɛ s t
dilate	d a ɪ l e ɪ t
pasilla	p ə s iː j ə
hobart	h ə ʊ b ɑː t
precise	p ɹ ɪ s a ɪ s
recognition	ɹ ɛ k ə ɡ n ɪ ʃ ə n
popina	p ɒ p a ɪ n ə
quadriplegic	k w ɑ d ɹ ɪ p l i d͡ʒ ɪ k
whisk	h w ɪ s k
veny	v ɛ n i
fails	f e ɪ l z
jetsam	d͡ʒ ɛ t s ə m
jinn	d͡ʒ ɪ n
call't	k ɔː l t
that	ð æ t
reanimate	ɹ i æ n ə m e ɪ t
yawp	j ɔː p
militarily	m ɪ l ɪ t ɛ ɹ ə l i
beliven	b ə l ɪ v ə n
auxometer	ɔː k s ɒ m ɪ t ə
gimlet	ɡ ɪ m l ə t
comoros	k ɒ m ə ɹ o ʊ z
rolleston	ɹ ɒ l ə s t ə n
oligophrenia	ɒ l ɪ ɡ o ʊ f ɹ iː n ɪ ə
wan	w æ n
nonunion	n ɒ n j uː n i ə n
tampa	t æ m p ə
recurve	ɹ ɪ k ɜː ɹ v
jigging	d͡ʒ ɪ ɡ ɪ ŋ
lawn	l ɔ n
semicentenary	s ɛ m a ɪ s ɛ n t ə n ɛ r i
cairns	k ɛ ɹ n z
botryoid	b ɑ t ɹ i ɔ ɪ d
dern	d ɜː ɹ n
richard	ɹ ɪ t͡ʃ ɚ d
allied	æ l a ɪ d
release	ɹ iː l iː s
heathrow	h iː θ ɹ o ʊ
dre	d ɹ e ɪ
homsi	h ɒ m s i
temazepam	t ə m æ z ə p æ m
redowa	ɹ ɛ d ə v ə
yaldabaoth	j ɑː l d ə b e ɪ ɒ θ
acanthosoma	ə k æ n θ ə s o ʊ m ə
wreathe	ɹ iː ð
trailer	t ɹ e ɪ l ɚ
brine	b ɹ a ɪ n
hefemale	h i f i m e ɪ l
unbosom	ʌ n b ʊ z ə m
gaunt	ɡ ɔː n t
whorlton	w ɔː ɹ l t ə n
thanksgiving	θ æ ŋ k s ɡ ɪ v ɪ ŋ
irritate	ɪ ɹ ɪ t e ɪ t
climatic	k l a ɪ m æ t ɪ k
arousal	ə ɹ a ʊ z ə l
discussing	d ɪ s k ʌ s ɪ ŋ
bate	b e ɪ t
cuh	k ʌ
storie	s t ɔː ɹ i
geyser	ɡ a ɪ s ɚ
chickies	t͡ʃ ɪ k i z
brubru	b ɹ u b ɹ u
fafia	f æ f i ə
agnostic	æ ɡ n ɑ s t ɪ k
fieldwork	f i l d w ɝ k
estonia	ɛ s t o ʊ n i ə
mown	m o ʊ n
such	s ʌ t͡ʃ
admirers	æ d m a ɪ ɚ ɚ z
inclusionary	ɪ n k l uː ʒ ə n ɛ ɹ i
ordinary	ɔ ɹ d ɪ n ɛ ə ɹ i
chomophyte	k ə ʊ m ə ʊ f a ɪ t
carb	k ɑ ɹ b
welly	w ɛ l i
fire	f a ɪ ə ɹ
tatar	t æ t ɑː ɹ
pupal	p j uː p ə l
remediless	ɹ ɛ m ə d i l ɪ s
pleiades	p l a ɪ ə d i z
bedmas	b ɛ d m æ s
myiasis	m a ɪ a ɪ ə s ɪ s
thoughtlessly	θ ɔ t l ɪ s l i
prestigious	p ɹ ɛ s t i d͡ʒ ə s
arbitration	ɑ ɹ b ɪ t ɹ e ɪ ʃ ə n
acetin	ə s i t ɪ n
venue	v ɛ n j uː
reports	ɹ ɪ p ɔ ɹ t s
soteriology	s ə ʊ t ɪ ə ɹ ɪ ɒ l ə d͡ʒ i
existed	ɪ ɡ z ɪ s t ɪ d
taqueria	t ɑ k ə ɹ iː ə
orchid	ɔ ɹ k ɪ d
arenas	ə ɹ iː n ə z
meats	m iː t s
dulce	d ʌ l s
ivanhoe	a ɪ v ə n h o ʊ
handstand	h æ n d s t æ n d
pipradol	p ɪ p ɹ ə d ɒ l
snark	s n ɑː ɹ k
salak	s ə l æ k
inceptive	ɪ n s ɛ p t ɪ v
ungzip	ʌ n d͡ʒ iː z ɪ p
announcement	ə n a ʊ n s m ɛ n t
dissuade	d ɪ s w e ɪ d
beemer	b i m ɚ
guyanese	ɡ a ɪ ə n iː z
romanesque	ɹ o ʊ m ə n ɛ s k
mountainous	m a ʊ n t ə n ə s
civitas	k i w ɪ t ɑ s
sifter	s ɪ f t ɚ
yreka	w a ɪ r iː k ə
sparerib	s p ɛ ɚ ɹ ɪ b
conjurer	k ʌ n d͡ʒ ə ɹ ə ɹ
matitudinal	m æ t ə t j u d ə n l̩
slapdash	s l æ p d æ ʃ
tough	t ʌ f
embody	ɪ m b ɒ d i
clippers	k l ɪ p ɚ z
lyric	l ɪ ɹ ɪ k
couple	k ʌ p ə l
woolf	w ʊ l f
slight	s l a ɪ t
eldritch	ɛ l d ɹ ɪ t͡ʃ
extremities	ɪ k s t ɹ ɛ m ə t i z
aguise	ə ɡ a ɪ z
cicatrise	s ɪ k ə t ɹ a ɪ z
emerod	ɛ m ə ɹ ə d
diver	d a ɪ̯ v ə ɹ
gülenist	ɡ u l ə n ɪ s t
shawty	ʃ ɔː t i
ultrapure	ʌ l t ɹ ə p j ɔ ɹ
leucotome	l uː k ə t ə ʊ m
hieratic	h a ɪ ə ɹ æ t ɪ k
strikesthrough	s t ɹ æ ɪ k s θ ɹ u
sartorius	s ɑː ɹ t ɔː ɹ i ə s
psora	s ɔː ɹ ə
wireman	w a ɪ ə ɹ m æ n
benzonatate	b ɛ n z o ʊ n ə t e ɪ t
slovenian	s l ə v iː n i ə n
steady	s t ɛ d i
hunching	h ʌ n t͡ʃ ɪ ŋ
honest	ɑ n ɪ s t
cenesthopathy	s iː n ə s θ ɒ p ə θ i
argent	ɑ ɹ d͡ʒ ə n t
abelam	ə b ə l ə m
farsi	f ɑː ɹ s i
beechmast	b i t͡ʃ m æ s t
opal	o ʊ p ə l
redebug	ɹ iː d iː b ʌ ɡ
conley	k ɒ n l ɪ
suggestions	s ə ɡ d͡ʒ ɛ s t͡ʃ ə n z
pensive	p ɛ n s ɪ v
filet	f ɪ l e ɪ
orgy	ɔ ɹ d͡ʒ i
haking	h e ɪ k ɪ ŋ
cousin	k ʌ z ə n
eagre	e ɪ ɡ ə ɹ
acuity	ə k j uː ɪ t i
crosswind	k ɹ ɑː s w ɪ n d
wug	w ʌ ɡ
hyperbolize	h a ɪ p ɝ b ə l a ɪ z
shinola	ʃ ɪ n o ʊ l ə
technicality	t ɛ k n ɪ k æ l ɪ t i
gummings	ɡ ʌ m ɪ ŋ z
stealing	s t iː l ɪ ŋ
tatting	t æ t ɪ ŋ
bubonic	b j uː b ɒ n ɪ k
flagstaff	f l æ ɡ s t æ f
prima	p ɹ iː m ə
polack	p o ʊ l ɑ k
phac	p iː h æ k
percival	p ɜː ɹ s ɪ v ə l
scrofula	s k ɹ ɔ f j ə l ə
ingushetia	ɪ ŋ ɡ ʊ ʃ ɛ t i ə
runway	ɹ ʌ n w e ɪ
lamely	l e ɪ m l i
binds	b a ɪ n d z
ostensive	ɒ s t ɛ n s ɪ v
sheffield	ʃ ɛ f iː l d
functional	f ʌ ŋ k t͡ʃ n ə l
tarnish	t ɑ ɹ n ɪ ʃ
depressant	d ɪ p ɹ ɛ s ə n t
husks	h ʌ s k s
miscreate	m ɪ s k ɹ ɪ e ɪ t
collectible	k ə l ɛ k t ɪ b ə l
uniformal	j uː n ɪ f ɔː ɹ m ə l
overnumerousness	o ʊ v ɚ n u m ə ɹ ə s n ə s
wabamun	w ɑː b ə m ə n
meropic	m ɛ ɹ o ʊ p ɪ k
perissology	p ɛ ɹ ɪ s ɒ l ə d͡ʒ i
roadstead	ɹ o ʊ d s t ɛ d
accuses	ə k j uː z ɪ z
trees	t ɹ iː z
amicide	æ m ɪ s a ɪ d
polytheism	p ɒ l ɪ θ iː ɪ z ə m
terpenoid	t ɝ p ə n ɔ ɪ d
honeysuckle	h ʌ n iː s ʌ k ə l
eightieth	e ɪ t i ə θ
searce	s ɑ ɹ s
pastis	p æ s t iː s
acanthocephalid	ə k æ n t θ ə s ɛ f ə l ɪ d
me	m i
communist	k ɑ m j u n ɪ s t
climbed	k l a ɪ m d
myland	m a ɪ l ə n d
azymous	e ɪ z a ɪ m ə s
haudenosaunee	h o ʊ d ə n o ʊ ʃ o ʊ n i
stakes	s t e ɪ k s
dietetician	d a ɪ ə t ɪ t ɪ ʃ ə n
nerf	n ɝ f
contort	k ə n t ɔː ɹ t
obadiah	o ʊ b ə d a ɪ ə
intone	ɪ n t o ʊ n
adhocratically	æ d h ə k ɹ æ d ɪ k ə l i
ferryl	f ɛ ɹ ə l
shitty	ʃ ɪ t i
churchical	t͡ʃ ɝ t͡ʃ ɪ k ə l
rejoin	ɹ iː d͡ʒ ɔ ɪ n
diffident	d ɪ f ɪ d ə n t
frontales	f ɹ ʌ n t e ɪ l i z
coldham	k ə ʊ l d ə m
freyja	f ɹ e ɪ ə
revise	ɹ ɪ v a ɪ̯ z
misluck	m ɪ s l ʌ k
bulked	b ʌ l k t
digitigrade	d ɪ d͡ʒ ə t ə ɡ ɹ e ɪ d
fyrom	f ɪ ɹ ə m
nostril	n ɒ s t ɹ ə l
stomp	s t ɑ m p
halal	h ə l ɑː l
thimbling	θ ɪ m b l ɪ ŋ
kesteven	k ɛ s t ə v ə n
fact	f æ k t
conlanger	k ɑ n l æ ŋ ɚ
thole	θ o ʊ l
humvee	h ʌ m v iː
orchard	ɔ ɹ t͡ʃ ɚ d
related	ɹ ɪ l e ɪ t ɪ d
bull	b ʊ l
jerrie	d͡ʒ ɛ ɹ i
comfort	k ʌ m f ɚ t
stradivarius	s t ɹ æ d ə v ɛ ɹ i ə s
disbud	d ɪ s b ʌ d
gambol	ɡ æ m b ə l
australian	ɔ s t ɹ ɛ l i ə n
sting	s t ɪ ŋ
rupert	ɹ u p ɚ t
primitive	p ɹ ɪ m ɪ t ɪ v
keys	k iː z
volga	v o ʊ l ɡ ə
cletus	k l iː t ə s
tsunauchi	t s uː n ɑː uː t͡ʃ i
bloaty	b l o ʊ t i
wheedle	w iː d ə l
octane	ɒ k t e ɪ n
abundancy	ə b ʌ n d n̩ s i
stasi	s t ɑː z i
daemon	d e ɪ m ə n
yep	j ɛ p
bagger	b æ ɡ ɚ
diaphoneme	d a ɪ ə f o ʊ n i m
kerygma	k ə ɹ ɪ ɡ m ə
escitalopram	ɛ s ə t æ l ə p ɹ æ m
dressy	d ɹ ɛ s i
made	m e ɪ d
tomato	t ə m e ɪ t o ʊ
stringer	s t ɹ ɪ ŋ ɚ
leapfrog	l iː p f ɹ ɑ ɡ
ned	n ɛ d
granger	ɡ ɹ e ɪ n d͡ʒ ə ɹ
bixie	b iː ʃ e ɪ
classify	k l æ s ə f a ɪ
infliction	ɪ n f l ɪ k ʃ ə n
stubbington	s t ʌ b ɪ ŋ t ə n
biscotto	b ɪ s k ɑ t o ʊ
misère	m iː z ɛ ə ɹ
radioactive	ɹ e ɪ d i o ʊ æ k t ɪ v
destruction	d ɪ s t ɹ ʌ k ʃ ə n
unakas	j u n e ɪ k ə z
chewy	t͡ʃ uː i
hardscrabble	h ɑ ɹ d s k ɹ æ b ə l
mogwai	m ɒ ɡ w a ɪ
pethidine	p ɛ θ ɪ d iː n
miltefosine	m ɪ l t ɛ f ə s i n
diamagnetic	d a ɪ ə m æ ɡ n ɛ t ɪ k
wuss	w ʊ s
ancestral	æ n s ɛ s t ə ɹ ə l
ain'tcha	e ɪ n t͡ʃ ə
connects	k ə n ɛ k t s
mags	m æ ɡ z
exorbitancy	ɪ ɡ z ɔː ɹ b ɪ t ə n s i
tortfeasor	t ɔ ɹ t f iː z ɚ
crediting	k ɹ ɛ d ɪ t ɪ ŋ
runs	ɹ ʌ n z
engross	ɛ n ɡ ɹ o ʊ s
whally	w ɔː l ɪ
lapsarian	l æ p s ɛ ə ɹ ɪ ə n
enclave	ɑ n k l e ɪ v
single	s ɪ ŋ ɡ ə l
stairs	s t ɛ ɹ z
finalize	f a ɪ n ə l a ɪ z
abocclusion	æ b o ʊ k l u ʒ n̩
waily	w e ɪ l i
impresario	ɪ m p r ɪ s ɑː r ɪ ə ʊ
paganism	p e ɪ ɡ ə n ɪ z m̩
fuckings	f ʌ k ɪ ŋ z
acephalan	e ɪ s ɛ f ə l ə n
rejoicing	ɹ ɪ d͡ʒ o ɪ s ɪ ŋ
otolaryngologist	o ʊ t o ʊ l ɛ ɚ ɪ ŋ ɡ ɑ l ə d͡ʒ ɪ s t
football	f ʊ t b ɔ l
jarrah	d͡ʒ æ ɹ ə
cleverness	k l ɛ v ɚ n ə s
copter	k ɑ p t ɚ
petrology	p ə t ɹ ɑ l ə d͡ʒ i
preparative	p ɹ ə p æ ɹ ə t ɪ v
subtrahend	s ʌ b t ɹ ə h ɛ n d
glandular	ɡ l æ n d͡ʒ ə l ɚ
westrip	w ɛ s t ɹ ɪ p
aberdeen	æ b ɚ d i n
lote	l ə ʊ t
mucosoplasty	m j u k o ʊ z o ʊ p l æ s t i
festivus	f ɛ s t ɪ v ə s
declaring	d ɪ k l ɛ ɹ ɪ ŋ
auspice	ɔ s p ɪ s
insects	ɪ n s ɛ k t s
salicional	s ə l ɪ ʃ n ə l
woodstock	w ʊ d s t ɒ k
agartala	ə ɡ ə ɹ t ə l ə
sakes	s e ɪ k s
pondicherry	p ɒ n d ɪ t ʃ ɛ ɹ i
kirkheaton	k ə r k h iː t ə n
baking	b e ɪ k ɪ ŋ ɡ
disney	d ɪ z n i
misled	m ɪ s l ɛ d
xenopsychiatry	z ɛ n ə ɛ θ s a ɪ k a ɪ ə t ɹ i
chirurgical	k a ɪ ɹ ɜː ɹ d͡ʒ ɪ k ə l
ansa	æ n s ə
glossitis	ɡ l ɒ s a ɪ t ɪ s
granary	ɡ ɹ e ɪ n ə ɹ i
marginalness	m ɑ ɹ d͡ʒ ə n ə ɫ n ə s
green	ɡ ɹ i n
bushy	b ʊ ʃ i
blamable	b l e ɪ m ə b ə l
toughie	t ʌ f i
amassment	ə m æ s m ə n t
necessitous	n ə s ɛ s ə t ə s
besilesomab	b ɛ s ɪ l ɛ s ə m æ b
lasts	l æ s t s
candidate	k æ n d ɪ d e ɪ t
oleose	ə ʊ l i ə ʊ z
spicate	s p a ɪ k e ɪ t
pines	p a ɪ n z
postoperative	p o ʊ s t ɑ p ə ɹ ə t ɪ v
feastware	f iː s t w ɛ ə ɹ
yakky	j æ k i
brad	b ɹ æ d
frontonasal	f ɹ ʌ n t o ʊ n e ɪ z ə l
cheery	t͡ʃ ɪ ə ɹ i
parson	p ɑ ɹ s ə n
abducens	æ b d j u s ɛ n z
wavelength	w e ɪ v l ɛ ŋ k θ
too	t u
moschatel	m ɒ s k ə t ɛ l
abortionist	ə b ɔ ɹ ʃ ə n ɪ s t
factice	f æ k t ɪ s
micrometre	m a ɪ k ɹ ə m iː t ə ɹ
scrappy	s k ɹ æ p i
papyrus	p ə p a ɪ ɹ ə s
spivvery	s p ɪ v ə ɹ i
thrack	θ ɹ æ k
breathy	b ɹ ɛ θ i
regionally	ɹ iː d͡ʒ n ə l i
pseudopatient	s u d o ʊ p e ɪ ʃ ə n t
filatory	f ɪ l ə t ɔ ɹ i
invariance	i n v ɛ ə ɹ i ə n s
inman	ɪ n m ə n
waiver	w e ɪ v ɚ
waywode	w e ɪ w ə ʊ d
ankylosaur	æ ŋ k ə l o ʊ s ɔː r
disgruntlement	d ɪ s ɡ ɹ ʌ n t ə l m ɪ n t
carmel	k ɑ ɹ m l̩
completist	k ə m p l iː t ɪ s t
winkers	w ɪ ŋ k ɚ z
impatiently	ɪ m p e ɪ ʃ ə n t l i
ancle	æ ŋ k ə l
renegade	ɹ ɛ n ɪ ɡ e ɪ d
polytheistic	p ɒ l ɪ θ iː ɪ s t ɪ k
copier	k ɑ p i ɚ
asked	æ s k t
subterranean	s ʌ b t ə ɹ e ɪ n i ə n
oreo	ɔ ɹ i o ʊ
alces	æ l s iː z
paracosm	p æ ɹ ə k ɒ z ə m
surveyee	s ɜː ɹ v e ɪ iː
affluence	æ f l u ə n s
calumny	k æ l ə m n i
exultation	ɛ ɡ z ʌ l t e ɪ ʃ ə n
flux	f l ʌ k s
casting	k æ s t ɪ ŋ
workflow	w ɝ k f l o ʊ
govvy	ɡ ʌ v i
dunam	d ʊ n ə m
twelvemonth	t w ɛ l v m ʌ n θ
willpower	w ɪ l p a ʊ ɚ
sprite	s p ɹ a ɪ t
janken	d͡ʒ ɒ ŋ k ɛ n
custard	k ʌ s t ɚ d
dictate	d ɪ k t e ɪ t
bolder	b o ʊ l d ə ɹ
micronova	m a ɪ k ɹ o n o ʊ v ə
conurbation	k ɑ n ɚ b e ɪ ʃ ə n
romsey	ɹ ɒ m z i
hanky	h æ ŋ k i
cosmopoleis	k ɒ z m ɒ p ɒ l ɛ ɪ z
impoverished	ɪ m p ɑ v ə ɹ ɪ ʃ t
civility	s ɪ v ɪ l ɪ t i
woggle	w ɒ ɡ ə l
exteriorized	ɛ k s t ɪ ɹ i ə ɹ a ɪ z d
abaptiston	æ b æ p t ɪ s t ɑ n
germen	d͡ʒ ɝ m ə n
serpette	s ɜː ɹ p ɛ t
chark	t͡ʃ ɑː ɹ k
windward	w ɪ n d w ə ɹ d
peabody	p i b ɑ d i
howler	h a ʊ l ɚ
vint	v ɪ n t
vouchsafe	v a ʊ t͡ʃ s e ɪ f
numinous	n j u m ə n ə s
syllabary	s ɪ l æ b ə ɹ i
indinavir	ɪ n d ɪ n ə v ɪ ɹ
snug	s n ʌ ɡ
booger	b ʊ ɡ ɚ
argon	ɑː ɹ ɡ ɒ n
acrylate	æ k ɹ ɪ l e ɪ t
dessert	d ɪ z ɝ t
plateaux	p l æ t o ʊ z
anatoli	æ n ə t o ʊ l i
reprise	ɹ ɪ p ɹ a ɪ z
vilazodone	v ɪ l æ z ə d ə ʊ n
braked	b ɹ e ɪ k t
sizable	s a ɪ z ə b ə l
rockower	ɹ ɑ k a ʊ ɚ
pail	p e ɪ l
ostrichism	ɑ s t ɹ i t͡ʃ ɪ z ə m
gerontic	d͡ʒ ɛ ɹ ɑː n t ɪ k
balboa	b æ l b ə ʊ ə
sievert	s iː v ɚ t
moguled	m o ʊ ɡ ə l d
feud	f j uː d
fart	f ɑ ɹ t
polaris	p ɔ ʊ l ɑ ɹ ɪ s
driffield	d ɹ ɪ f iː l d
monetize	m ɒ n ə t a ɪ z
sickle	s ɪ k l̩
hemmel	h ɛ m ə l
subjacency	s ə b d͡ʒ e ɪ s ə n s i
jacksonian	d͡ʒ æ k s o ʊ n i ə n
science	s a ɪ ə n s
arun	ɑː ɹ ʊ n
clues	k l uː z
trannies	t ɹ æ n i z
stilton	s t ɪ l t ə n
fonio	f ə ʊ n j ə ʊ
complement	k ɑ m p l ə m ə n t
woohoo	w uː h uː
what	w ɑ t
duckling	d ʌ k l ɪ ŋ
treasure	t ɹ ɛ ʒ ɚ
refoulement	ɹ ə f u l m ɑ n
irrawaddy	ɪ ɹ ə w ɑ d i
culty	k ʌ l t i
tag	t æ ɡ
andromache	æ n d ɹ ɒ m ə k i
slaver	s l e ɪ v ɚ
abstinence	æ b s t ɪ n ə n s
leaching	l iː t͡ʃ ɪ ŋ
pictural	p ɪ k t͡ʃ ə ɹ ə l
echard	ɛ k ɑː ɹ d
thimbled	θ ɪ m b ə l d
avoided	ə v ɔ ɪ d ɪ d
fascinum	f æ s ɪ n ə m
petrine	p i t ɹ a ɪ n
infection	ɪ n f ɛ k ʃ ə n
banneret	b æ n ə ɹ e t
imprudence	ɪ m p ɹ uː d n̩ s
alif	a l ɪ f
solar	s o ʊ l ɚ
picul	p ɪ k ə l
accommodation	ə k ɑ m ə d e ɪ ʃ ə n
connote	k ə n o ʊ t
labefaction	l æ b ə f æ k ʃ ə n
gushes	ɡ ʌ ʃ ɪ z
cuts	k ʌ t s
rudy	ɹ uː d i
contraband	k ɑ n t ɹ ə b æ n d
abietene	æ b i ə t i n
zed	z ɛ d
staphylococcus	s t æ f ə l ə k ɔ k ə s
belarusian	b ɛ l ə ɹ uː s i ə n
whether	w ɛ ð ə ɹ
refurbish	ɹ i f ɝ b ɪ ʃ
twinge	t w ɪ n d͡ʒ
chromatic	k ɹ o ʊ m æ t ɪ k
hydrogenous	h a ɪ d ɹ ɑ d͡ʒ ə n ə s
speciesism	s p iː s iː z ɪ z ə m
tyrant	t a ɪ ɹ ə n t
breitschwanz	b ɹ a ɪ t͡ʃ v ɑː n t s
amalek	æ m ə l ɛ k
lazarus	l æ z ə ɹ ə s
accustomedness	ə k ʌ s t ə m d n ɪ s
dauber	d ɔː b ə ɹ
accentor	ə k s ɛ n t ɚ
willard	w ɪ l ə ɹ d
sied	s a ɪ d
bohunk	b o ʊ h ʌ ŋ k
workmanship	w ɜː k m ə n ʃ ɪ p
fallopian	f ə l o ʊ p i ə n
serum	s ɪ ɹ ə m
legwork	l ɛ ɡ w ɚ k
lixiviate	l ɪ k s ɪ v i e ɪ t
welk	w ɛ l k
penang	p ə n ɑ ŋ
snaked	s n e ɪ k t
preëmptory	p ɹ iː ɛ m p t ə ɹ i
subterfuge	s ʌ b t ə ɹ f j uː d͡ʒ
eclectic	ɛ k l ɛ k t ɪ k
boneseeker	b o ʊ n s i k ɚ
jumpered	d͡ʒ ʌ m p ɚ d
sibsey	s ɪ b z i
fiche	f iː ʃ
pulsate	p ʌ l s e ɪ t
countings	k a ʊ n t ɪ ŋ z
finishings	f ɪ n ɪ ʃ ɪ ŋ z
dentate	d ɛ n t e ɪ t
antiphon	æ n t ɪ f ɑ n
tignish	t ɪ ɡ n ɪ ʃ
compatriot	k ə m p e ɪ t ɹ i ə t
aphorism	æ f ə ɹ ɪ z ə m
femalia	f iː m e ɪ l i ə
theo	θ i o ʊ
blacktop	b l æ k t ɒ p
bloomed	b l uː m d
saturate	s æ t͡ʃ ə ɹ e ɪ t
alistair	æ l i s t ɚ
abstracted	æ b s t ɹ æ k t ɪ d
agoraphobia	æ ɡ ɚ ə f o ʊ b i ə
spender	s p ɛ n d ɚ
ryelage	ɹ a ɪ l ɪ d͡ʒ
bucha	b uː t͡ʃ ə
sirenomelia	s a ɪ ɹ ə n o ʊ m i l i ə
hewings	h j uː ɪ ŋ z
etesian	ɪ t iː z ɪ ə n
virgula	v ə ɹ ɡ j ʊ l ə
prince	p ɹ ɪ n s
perfusionist	p ə ɹ f j uː ʒ ə n ɪ s t
luxury	l ʌ k ʃ ə ɹ i
gaslight	ɡ æ s l a ɪ t
canakin	k æ n ə k ɪ n
competence	k ɒ m p ə t ə n s
camomile	k æ m ə m a ɪ l
frowned	f ɹ a ʊ n d
crust	k ɹ ʌ s t
specify	s p ɛ s ə f a ɪ
somewhile	s ʌ m w a ɪ l
wacko	w æ k ə ʊ
bundestag	b ʊ n d ə s t ɑː ɡ
quietly	k w a ɪ ɪ t l i
cantillation	k æ n t ɪ l e ɪ ʃ ə n
care	k ɛ ə ɹ
sureness	ʃ ʊ ɹ n ə s
nirvana	n ɚ v æ n ə
macaroni	m æ k ə ɹ o ʊ n i
blackfoot	b l æ k f ʊ t
i'm	a ɪ m
curate	k j ʊ ɹ e ɪ t
towering	t a ʊ ə ɹ ɪ ŋ
dastardly	d æ s t ɚ d l i
murray	m ɜ ɹ i
geophyte	d͡ʒ i o ʊ f a ɪ t
bowel	b a ʊ l
comparably	k ɒ m p æ ɹ ə b l̩ i
occipitalis	ɑ k s ɪ p ə t e ɪ l ɪ s
asweve	ə s w iː v
resonate	ɹ ɛ z ə n e ɪ t
herring	h ɛ ɹ ɪ ŋ
omad	o ʊ̯ m æ d
burundi	b ʊ ɹ ʊ n d i
priceless	p ɹ a ɪ s l ə s
stephanie	s t ɛ f ə n i
vie	v a ɪ
ritz	ɹ ɪ t s
cuddly	k ʌ d l i
diamide	d a ɪ e ɪ m a ɪ d
greatness	ɡ ɹ e ɪ t n ə s
dalmatian	d æ l m e ɪ ʃ ə n
embiggen	ɛ m b ɪ ɡ ə n
chance	t͡ʃ æ n s
astral	æ s t ɹ ə l
blunderbuss	b l ʌ n d ɚ b ʌ s
draw	d ɹ ɔ
bighead	b ɪ ɡ h ɛ d
monoecious	m ə n iː ʃ ə s
nucleus	n uː k l i ə s
refresher	ɹ ɪ f ɹ ɛ ʃ ɚ
karakalpakstan	k ɑ ɹ ə k ɑ l p ɑ k s t æ n
seesaw	s i s ɔ
abditory	æ b d ɪ t ə ɹ i
infrahyoid	ɪ n f ɹ ə h a ɪ ɔ ɪ d
anathema	ə n æ θ ə m ə
disgust	d ɪ s k ʌ s t
britannia	b ɹ ɪ t æ n ɪ ə
greeks	ɡ ɹ iː k s
condyle	k ɒ n d a ɪ l
boulogne	b ə l ɔ ɪ n
whichsoever	w ɪ t͡ʃ s o ʊ ɛ v ɚ
paycheck	p e ɪ t͡ʃ ɛ k
ghana	ɡ æ n ə
hypocretin	h a ɪ p o ʊ k ɹ iː t ə n
batavia	b ə t e ɪ v i ə
cerebel	s ɛ ɹ ə b ə l
spittoon	s p ɪ t uː n
serves	s ɝ v z
quoll	k w o ʊ l
fucus	f j uː k ə s
froze	f ɹ o ʊ z
shenyang	ʃ ɛ n j æ ŋ
dais	d e ɪ ɪ s
gingerism	d͡ʒ ɪ n d͡ʒ ɚ ɪ z m̩
chaste	t͡ʃ e ɪ s t
daw	d ɔː
humdinger	h ʌ m d ɪ ŋ ɚ
bass	b e ɪ s
skills	s k ɪ l z
bouctouche	b ʌ k t uː ʃ
scrab	s k ɹ æ b
aran	æ ɹ ə n
superseminate	s uː p ə ɹ s ɛ m ɪ n e ɪ t
absentment	ə b s ɛ n t m ə n t
mariah	m ə ɹ a ɪ ə
upward	ʌ p w ɜː ɹ d
salazar	s æ l ə z ɑ ɹ
kenspeckle	k ɛ n s p ɛ k ə l
casanova	k æ s ə n o ʊ v ə
bewelter	b ɪ w ɛ l t ɚ
hugely	h j uː d͡ʒ l i
gil	ɡ ɪ l
berg	b ɝ ɡ
knobbler	n ɑ b l ɚ
overran	o ʊ v ɚ ɹ a n
routine	ɹ uː t iː n
stancel	s t æ n s ə l
heathenesse	h iː ð ə n ə s
haggle	h æ ɡ ə l
hydrolysate	h a ɪ d ɹ ɒ l ɪ s ə t
latency	l e ɪ t ə n s i
zotepine	z o ʊ t ə p iː n
jipijapa	h i p i h ɑ p ə
captopril	k æ p t ə p ɹ ɪ l
jointed	d͡ʒ ɔ ɪ n t ɪ d
admin	æ d m ɪ n
annie	æ n i
ciliolate	s ɪ l i ə l ə t
chernobyl	t͡ʃ ɚ n o ʊ b ə l
cytarabine	s a ɪ t æ ɹ ə b i n
defamate	d ɛ f ə m e ɪ t
blood	b l ʌ d
pewing	p j uː ɪ ŋ
epistemic	ɛ p ə s t e m ɪ k
scrivening	s k ɹ ɪ v ɛ n ɪ ŋ
wodgil	w ɑ d͡ʒ ɪ l
inventor	ɪ n v ɛ n t ɚ
gosewehr	ɡ o ʊ z w ɛ ə ɹ
kendell	k ɛ n d ə l
nruling	n ɹ uː l ɪ ŋ
serac	s ɛ ɹ æ k
insular	ɪ n s j ə l ɚ
dreaded	d ɹ ɛ d ə d
profusely	p ɹ ə f j u s l i
grove	ɡ ɹ o ʊ v
bebless	b i b l ɛ s
childbed	t͡ʃ a ɪ l d b ɛ d
hermaphrodite	h ɝ m æ f ɹ ə d a ɪ t
baccarat	b æ k ə ɹ ɑː
sika	s iː k ə
beggings	b ɛ ɡ ɪ ŋ z
basutoland	b ə s u t ə ʊ l æ n d
necklace	n ɛ k l ə s
nietzscheanism	n i t͡ʃ i ə n ɪ z ə m
pubs	p ʌ b z
llandudno	l æ n d ɪ d n o ʊ
roc	ɹ ɒ k
pastime	p æ s t a ɪ m
jink	d͡ʒ ɪ ŋ k
hogmanay	h ɑ ɡ m ə n e ɪ
weakling	w iː k l ɪ ŋ ɡ
haunt	h æ n t
stylohyoid	s t a ɪ l o ʊ h a ɪ ɔ ɪ d
quinquagenary	k w ɪ ŋ k w æ d͡ʒ ə n ɛ ɹ i
pig	p ɪ ɡ
superomnipotence	s uː p ə ɹ ɒ m n ɪ p ə t ə n s
equalize	i k w ə l a ɪ z
flouting	f l a ʊ t ɪ ŋ
polypantheism	p ɒ l i p æ n θ i ɪ z ə m
goon	ɡ uː n
outwall	a ʊ t w ɔː l
festschrift	f ɛ s t ʃ ɹ ɪ f t
interception	ɪ n t ɚ s ɛ p ʃ ə n
cymbalist	s ɪ m b ə l ɪ s t
fascism	f æ ʃ ɪ z ə m
phub	f ʌ b
udall	j uː d ɔː l
atrophy	æ t ɹ ə f i
panga	p a ŋ ɡ ə
poontang	p uː n t æ ŋ
chippendale	t͡ʃ ɪ p n̩ d e ɪ l
prominence	p ɹ ɑ m ɪ n ə n s
saury	s ɔː ɹ i
dominical	d ə m ɪ n ə k ə l
metaphysics	m ɛ t ə f ɪ z ɪ k s
broadsword	b ɹ ɔ d s ɔ ɹ d
abscondence	æ b s k ɑ n d n̩ s
croggy	k ɹ ɑ ɡ i
pizzle	p ɪ z l̩
languid	l æ ŋ ɡ w ə d
greenspan	ɡ ɹ iː n s p æ n
haor	h ɑː ɒ ɹ
casually	k æ ʒ u ə l i
thorax	θ ɔ ɹ æ k s
wicked	w ɪ k t
downloading	d a ʊ n l o ʊ d ɪ ŋ
ciss	s ɪ s
cloning	k l o ʊ n ɪ ŋ
herpes	h ɚ p i z
uncovered	ʌ n k ʌ v ɚ d
wholly	h o ʊ l i
diamond	d a ɪ ə m ə n d
cisgender	s ɪ s d͡ʒ ɛ n d ɚ
trekkie	t ɹ ɛ k i
neolithic	n i o ʊ l ɪ θ ɪ k
cowbit	k a ʊ b ɪ t
hertz	h ɝ t s
vick	v ɪ k
euth	j u θ
pentateuch	p ɛ n t ə t j uː k
illation	ə l e ɪ ʃ ə n
esture	ɛ s t j ʊ ə ɹ
halifax	h æ l ɪ f æ k s
amogus	ə m o ʊ ɡ ə s
looter	l u t ɚ
outermost	a ʊ t ɚ m o ʊ s t
disparadise	d ɪ s p æ ɹ ə d a ɪ s
venality	v ɪ n æ l ɪ t i
sneeze	s n iː z
spangel	s p e ɪ n d͡ʒ ə l
alkalic	æ l k æ l ɪ k
ocarina	o ʊ k ə ɹ i n ə
evaluative	ɪ v æ l j u ə t ɪ v
norepinephrine	n ɔː ɹ ɛ p ɪ n ɛ f ɹ ɪ n
sapient	s e ɪ p i ə n t
osborne	ɒ z b ɔː ɹ n
transgression	t ɹ æ n s ɡ ɹ ɛ ʃ ə n
script	s k ɹ ɪ p t
joe	d͡ʒ o ʊ
paradoxical	p ɛ ɹ ə d ɑː k s ɪ k ə l
ankh	ɑ ŋ k
associations	ə s o ʊ s i e ɪ ʃ ə n z
châteaux	ʃ æː t o ʊ z
culantro	k uː l æ n t ɹ o ʊ
nosel	n ə ʊ z ə l
palaces	p æ l ɪ s ɪ z
hilding	h ɪ l d ɪ ŋ
romansch	ɹ o ʊ m æ n ʃ
advertiser	æ d v ɚ t a ɪ z ɚ
humanist	h j uː m ə n ɪ s t
stun	s t ʌ n
bunyip	b ʌ n j ɪ p
atrocity	ə t ɹ ɒ s ɪ t i
excandescence	ɛ k s k æ n d ɛ s ə n s
theater	θ i ə t ɚ
squoze	s k w o ʊ z
cancún	k ɑː n k uː n
tract	t ɹ æ k t
earwitness	ɪ ɹ w ɪ t n ə s
neutrophile	n uː t ɹ o ʊ̯ f a ɪ̯ ɫ
furl	f ɝ l
undertook	ʌ n d ə ɹ t ʊ k
trudeau	t ɹ uː d o ʊ
frown	f ɹ a ʊ n
abandoning	ə b æ n d ə n ɪ ŋ
boner	b o ʊ n ɚ
chloride	k l ɔ ɹ a ɪ d
maracanaço	m æ ɹ ə k ə n ɑː s ə ʊ
piano	p i æ n o ʊ
quadraturist	k w ɒ d ɹ ə t͡ʃ ə ɹ ɪ s t
mesquite	m ɛ s k iː t
gujari	ɡ u d͡ʒ ɑː ɹ i
danish	d e ɪ n ɪ ʃ
uotsuri	uː o ʊ t s ʊ ə ɹ i
cribbings	k ɹ ɪ b ɪ ŋ z
larve	l ɑː ɹ v
doo	d u
euphrates	j uː f ɹ e ɪ t iː z
hullock	h ʌ l ə k
bib	b ɪ b
parture	p ɑː ɹ t j ʊ ə ɹ
mampy	m æ m p i
synopsis	s ɪ n ɑ p s ɪ s
dove	d o ʊ v
ebbed	ɛ b d
seattle	s i æ t l̩
leicestrian	l ɛ s t ɹ ɪ ə n
conative	k o ʊ n ə t ɪ v
monoousian	m ɑ n o ʊ u z i ə n
netty	n ɛ t i
dalry	d æ l ɹ a ɪ
beckett	b ɛ k ɪ t
tach	t æ k
poon	p uː n
acanthopodous	æ k æ n θ ɑ p ə d ə s
disquisition	d ɪ s k w ə z ɪ ʃ ə n
shooter	ʃ uː t ə ɹ
bastes	b e ɪ s t s
maraca	m ə ɹ æ k ə
gazump	ɡ ə z ʌ m p
hyoidal	h a ɪ ɔ ɪ d ə l
clade	k l e ɪ d
inconsistent	ɪ n k ə n s ɪ s t ə n t
preposterous	p ɹ ə p ɑ s t ə ɹ ə s
rotherham	ɹ ɒ ð ə ɹ ə m
hexadecimal	h ɛ k s ə d ɛ s ɪ m ə l
dinkum	d ɪ ŋ k ə m
reduction	ɹ ɪ d ʌ k ʃ ə n
suave	s w e ɪ v
subscriber	s ə b s k ɹ a ɪ b ɚ
cyanose	s a ɪ ə n ə ʊ s
commotion	k ə m o ʊ ʃ ə n
winetrough	w a ɪ n t ɹ ɔ f
sicel	s ɪ k ə l
theme	θ iː m
arhat	ɑː h æ t
exchanged	ɛ k s t͡ʃ e ɪ n d͡ʒ d
flowrate	f l o ʊ ɹ e ɪ t
acetylcholine	ə s i t ə l k o ʊ l i n
epidermis	ɛ p ə d ɝ m ə s
voltage	v o ʊ l t ɪ d͡ʒ
thumbtack	θ ʌ m t æ k
ctab	s iː t æ b
attainments	ə t e ɪ n m ə n t s
goos	ɡ uː s
alicorns	æ l ɪ k ɔ ɹ n z
hey	h e ɪ
pettywhin	p ɛ t i w ɪ n
squeteague	s k w iː t iː ɡ
misotheist	m a ɪ s ə ʊ θ iː ɪ s t
loll	l ɑ l
bampot	b æ m p ɒ t
background	b æ k ɡ ɹ a ʊ n d
horizontal	h ɔː ɹ ə z ɑː n t ə l
containment	k ə n t e ɪ n m ə n t
adoxographer	e ɪ d ɑ k s ɑ ɡ ɹ ə f ɚ
sesquipedalian	s ɛ s k w ɪ p ɪ d e ɪ l ɪ ə n
acampsia	ə k æ m p s i ə
caw	k ɔː
shalt	ʃ æ l t
salary	s æ l ɚ i
daunt	d ɔ n t
sanguinolent	s æ ŋ ɡ w ɪ n ə l ə n t
water	w ɑ t ə ɹ
fantasy	f æ n t ə s i
decima	d ɛ s ɪ m ə
groyper	ɡ r ɔ ɪ p ɝ
stereoscopic	s t ɛ r i ə s k ɑː p ɪ k
tsushima	s uː ʃ iː m ə
decock	d i k ɔ k
flaccider	f l æ s ɪ d ɚ
bassooned	b ə s uː n d
unenabled	ʌ n ə n e ɪ b ə l d
tushker	t ʌ ʃ k ə ɹ
perturbate	p ɜː ɹ t ə ɹ b e ɪ t
redder	ɹ ɛ d ɚ
diloxanide	d a ɪ l ɑ k s ə n a ɪ d
sumptuous	s ʌ m p t͡ʃ u ə s
kinshasa	k ɪ n ʃ ɑː s ə
ara	e ɪ ɹ ə
jot	d͡ʒ ɑ t
puisne	p j u n i
noosed	n uː s t
bulgur	b ʊ l ɡ ə ɹ
verset	v ɚ s ə t
nausicaa	n ɔː s ɪ k i ə
advent	æ d v ə n t
jet	d͡ʒ ɛ t
hume	h j uː m
immerse	ɪ m ɝ s
leapt	l ɛ p t
delage	d ə l a ʒ
deliberately	d ə l ɪ b ə ɹ ə t l i
intimately	ɪ n t ɪ m ə t l i
stiver	s t a ɪ v ə
lately	l e ɪ t l i
western	w ɛ s t ɚ n
tsade	t s ɑː d e ɪ
baconic	b ə k ə ʊ n ɪ k
nief	n iː f
goety	ɡ o ʊ ɪ t i
crab	k ɹ æ b
godzilla	ɡ ɑ d z ɪ l ə
ternary	t ɝ n ə ɹ i
blumenthal	b l uː m ə n t ɑː l
anguine	æ ŋ ɡ w ɪ n
monaco	m ɑ n ə k o ʊ
needs	n i d z
geosmin	d͡ʒ i ɑ z m ɪ n
abdominogenital	æ b d ɑ m ɪ n o ʊ d͡ʒ ɛ n ɪ t l̩
thrilled	θ ɹ ɪ l d
ichnusaite	ɪ k n u s ə a ɪ t
phocaea	f o ʊ s iː ə
umich	j u m ɪ ʃ
colony	k ɑ l ə n i
matronymic	m æ t ɹ ə n ɪ m ɪ k
referee	ɹ ɛ f ə ɹ iː
suifenhe	s w e ɪ f ʌ n h ʌ
baddams	b æ d ə m z
amaranth	æ m ə ɹ æ n θ
ge'ez	ɡ iː ɛ z
copay	k o ʊ p e ɪ
abscision	æ b s ɪ ʒ n̩
executrix	ɪ ɡ z ɛ k j ə t ɹ ɪ k s
microbial	m a ɪ k ɹ o ʊ b i ə l
tarns	t ɑː ɹ n z
putz	p ʊ t s
absaroke	æ b s o ɹ k i
algedonic	æ l d͡ʒ ɪ d ɒ n ɪ k
uralic	j ʊ ə ɹ æ l ɪ k
grouchy	ɡ ɹ a ʊ t͡ʃ i
halts	h ɑ l t s
encierro	ɛ n s i ɛ ɹ o ʊ
xenia	z iː n i ə
artistic	ɑ ɹ t ɪ s t ɪ k
faciliatory	f ə s ɪ l i ə t o ɹ i
kitbag	k ɪ t b æ ɡ
drumslade	d r ʌ m s l e ɪ d
swire	s w a ɪ ə
omnivorous	ɑ m n ɪ v ɝ ə s
kyrgyzstan	k ɛː ɹ ɡ ɪ s t ɑː n
retrospective	ɹ ɛ t ɹ ə ʊ s p ɛ k t ɪ v
acetochlor	ə s iː t ə ʊ k l ɔː ɹ
tholeiite	θ o ʊ l i a ɪ t
gungy	ɡ ʌ n d͡ʒ iː
macroeconomic	m æ k ɹ o ʊ ɛ k ə n ɑː m ɪ k
legion	l iː d͡ʒ ə n
cuzco	k uː s k o ʊ
careworn	k ɛ ə ɹ w ɔ ɹ n
patten	p æ t ə n
residency	ɹ ɛ z ɪ d ə n s i
grows	ɡ ɹ o ʊ z
pyroxene	p a ɪ ɹ ɑ k s i n
enthronize	ɛ n θ ɹ o ʊ n a ɪ z
evans	ɛ v ə n z
debye	d ə b a ɪ
unnerving	ʌ n n ɜː v ɪ ŋ
amok	ə m ɒ k
whistle	w ɪ s l̩
shrapnel	ʃ ɹ æ p n ə l
volitation	v ɑ l ɪ t e ɪ ʃ ə n
fob	f ɒ b
stress	s t ɹ ɛ s
injuria	ɪ n d ʒ ʊ ə ɹ i ə
composure	k ə m p o ʊ ʒ ɚ
prosiopetic	p ɹ ɑ s i o ʊ p ɛ t ɪ k
calmy	k ɑː m i
gnostic	n ɑ s t ɪ k
milliner	m ɪ l ɪ n ɚ
vacationship	v ə k e ɪ ʃ ə n ʃ ɪ p
component	k ʌ m p o ʊ n ə n t
swamp	s w ɑ m p
dickies	d ɪ k i z
quaich	k w e ɪ k
finangle	f ɪ n æ ŋ ɡ ə l
hayward	h e ɪ w ə ɹ d
yourself	j ɔ ɹ s ɛ l f
chromate	k ɹ ə ʊ m e ɪ t
scrotum	s k ɹ o ʊ t ə m
viscacha	v ɪ s k ɑ t͡ʃ ə
whirled	h w ɝ l d
leigh	l iː
gamed	ɡ e ɪ m d
amylin	æ m ə l ɪ n
ferroconcrete	f ɛ ɹ o ʊ k ɑ n k ɹ i t
foulsome	f a ʊ l s ə m
bookstave	b ʊ k s t ɪ v
swatchel	s w ɒ t͡ʃ ə l
natal	n e ɪ t ə l
rhythmlessly	ɹ ɪ ð m̩ l ə s l i
comprises	k ə m p ɹ a ɪ z ɪ z
vow	v a ʊ
detrital	d i t ɹ a ɪ t ə l
liberate	l ɪ b ə ɹ e ɪ t
penglai	p ɛ ŋ l a ɪ
packs	p æ k s
centred	s ɛ n t ə ɹ d
interpellate	ɪ n t ə ɹ p ɛ l e ɪ t
equation	ɪ k w e ɪ ʃ ə n
codecs	k o ʊ d ɛ k s
livor	l a ɪ v ɔ ə ɹ
crosier	k ɹ o ʊ ʒ ɚ
flabellate	f l ə b ɛ l ə t
autumnal	ɔ t ʌ m n ə ɫ
chickie	t͡ʃ ɪ k i
borscht	b ɔ ɹ ʃ t
ypsiliform	ɪ p s ɪ l ɪ f ɔː ɹ m
compass	k ʌ m p ə s
roué	ɹ uː e ɪ
stigmatize	s t ɪ ɡ m ə t a ɪ z
denotation	d iː n o ʊ t e ɪ ʃ ə n
seliciclib	s ɛ l ɪ s ɪ k l ɪ b
roach	ɹ o ʊ t͡ʃ
colport	k ɒ l p ɔː ɹ t
chloral	k l ɔː ɹ æ l
ephedra	ɛ f ɪ d ɹ ə
stare	s t ɛ ɚ
boast	b o ʊ s t
varronian	v æ ɹ o ʊ n i ə n
cosmopolis	k ɒ z m ɒ p ɒ l ɪ s
backbone	b æ k b o ʊ n
luzon	l u z ɔ n
titles	t a ɪ t l̩ z
vworp	v w ɔ ɹ p
hasta	h æ s t ə
combatant	k ɑ m b ə t ə n t
sounding	s a ʊ n d ɪ ŋ
molar	m o ʊ l ɚ
trike	t ɹ a ɪ k
stagirite	s t æ d͡ʒ ɪ ɹ ʌ ɪ t
flavorsome	f l e ɪ v ɚ s ə m
elf	ɛ l f
namur	n ə m ʊ ə ɹ
gouges	ɡ a ʊ d͡ʒ ə z
deets	d iː t s
soda	s o ʊ d ə
blow	b l o ʊ
multifurcate	m ʌ l t i f ɝ k e ɪ t
this's	ð ɪ s ɪ z
pushful	p ʊ ʃ f ʊ l
asonant	e ɪ̯ s o ʊ̯ n ə n t
stupid	s t j u p ɪ d
byssine	b ɪ s iː n
caramel	k æ ɹ ə m ə l
stirred	s t ɝ d
ablaze	ə b l e ɪ z
vierkleur	f ɪ ɹ k l ɜ ɹ
petite	p ə t iː t
astrobleme	æ s t ɹ o ʊ b l i m
adherence	ə d h ɪ ɹ ə n s
punishing	p ʌ n ɪ ʃ ɪ ŋ
tog	t ɑ ɡ
equinoctial	iː k w ə n ɑ k ʃ ə l
tribulation	t ɹ ɪ b j ə l e ɪ̯ ʃ ə n
fbi	ɛ f b iː a ɪ
ballerino	b æ l ə ɹ iː n o ʊ
superhabitable	s u p ɚ h æ b ɪ t ə b l̩
argillaceous	ɑː d͡ʒ ɪ l e ɪ ʃ ə s
keriorrhea	k ɛ ɹ ɪ ə ɹ iː ə
slowpoke	s l o ʊ p o ʊ k
nanase	n a n a s e
shitkicker	ʃ ɪ t k ɪ k ə ɹ
sain	s e ɪ n
cervical	s ɝ v ɪ k l̩
gaff	ɡ æ f
absolvitory	æ b s ɑ l v ə t ɔ ɹ i
terrier	t ɛ ɹ i ə ɹ
garden	ɡ ɑ ɹ d ə n
acaricide	ə k ɛ ɹ ə s i d
rowlock	ɹ ɑ l ə k
khartoum	k ɑː ɹ t uː m
gaymer	ɡ e ɪ m ɚ
withhold	w ɪ ð h o ʊ l d
shadowy	ʃ æ d o ʊ i
attract	ə t ɹ æ k t
organisation	ɔ ɹ ɡ ə n ɪ z e ɪ ʃ ə n
holds	h o ʊ l d z
deidentify	d iː a ɪ d ɛ n t ɪ f a ɪ
foolscap	f uː l s k æ p
connascence	k ə n æ s ə n s
forefinger	f ɔ ɹ f ɪ ŋ ɡ ɚ
canadiens	k ə n e ɪ d i ə n z
snipelike	s n a ɪ p l a ɪ k
oniomaniac	ə ʊ n i ə ʊ m e ɪ n i æ k
acalculia	e ɪ k æ l k j uː l i ə
bday	b iː d e ɪ
wiradjuric	w ɪ r aː d͡ʒ u r iː k
tracks	t ɹ æ k s
emir	ɛ m ɪ ə ɹ
larynx	l æ ɹ ɪ ŋ k s
twelvetide	t w ɛ l v t a ɪ d
consonantal	k ɑ n s ə n æ n t ə l
won	w ɑ n
rosepetal	ɹ o ʊ z p ɛ t ə l
dilf	d ɪ l f
octavation	ɒ k t e ɪ v e ɪ ʃ ə n
canvass	k æ n v ə s
hounded	h a ʊ n d ɪ d
subliterate	s ʌ b l ɪ t ə ɹ ə t
steadiness	s t ɛ d i n ə s
jinhua	d͡ʒ ɪ n h w ɑː
indolency	ɪ n d ə l ə n s i
polylactide	p ɒ l i l æ k t a ɪ d
peeking	p iː k ɪ ŋ
privative	p r ɪ v ə t ɪ v
bandolero	b æ n d ə l e ə ɹ ə ʊ
demagogue	d ɛ m ə ɡ ɑ ɡ
reak	ɹ iː k
glitches	ɡ l ɪ t͡ʃ ɪ z
rizzuto	ɹ ɪ t s uː t ə ʊ
tetrylammonium	t ɛ t ɹ ə l ə m o ʊ n i ə m
fumed	f j uː m d
ventôse	v ɑ n t o ʊ z
almah	æ l m ə
redden	ɹ ɛ d n̩
ruritanian	ɹ ʊ ɹ ɪ t e ɪ n i ə n
babm	b ɔ ɑː b ɔ m u
ma	m ɑː
soupçon	s uː p s ɒ n
abnegation	æ b n ə ɡ e ɪ ʃ ə n
empire	ɛ m p a ɪ ɚ
mamash	m ɑː m ə ʃ
outlier	a ʊ t l a ɪ ə ɹ
sages	s e ɪ d͡ʒ ɪ z
zygomatic	z a ɪ ɡ ə m æ t ɪ k
clinopyroxene	k l a ɪ n o ʊ p a ɪ ɹ ɑ k s i n
morbihan	m ɔː ɹ b i ə n
couchee	k uː ʃ e ɪ
shunga	ʃ ʊ ŋ ə
unchaste	ʌ n t͡ʃ e ɪ s t
trumps	t ɹ a m p s
harpagon	h ɑː ɹ p ə ɡ ɒ n
naggy	n æ ɡ iː
celtic	k ɛ l t ɪ k
escrow	ɛ s k ɹ o ʊ̯
synonym	s ɪ n ə n ɪ m
maguire	m ə ɡ w a ɪ ɹ
whales	w e ɪ l z
brainy	b ɹ e ɪ n i
spurrier	s p ɝ ɹ i ɚ
mancipatory	m æ n s ɪ p e ɪ t ə ɹ i
sprightly	s p ɹ a ɪ t l i
trenches	t ɹ ɛ n t͡ʃ ɪ z
hatter	h æ t ə ɹ
sternocleidomastoidei	s t ɝ n ə k l a ɪ d ə m æ s t ɔ ɪ d i a ɪ
ragù	ɹ æ ɡ u
sully	s ʌ l i
pulpit	p ʊ l p ɪ t
gyle	ɡ a ɪ l
truculent	t ɹ ʌ k j ʊ l ə n t
apoxyomenos	ə p ɑ k s i ɑ m ə n ɑ s
hicking	h ɪ k ɪ ŋ
peril	p ɛ ɹ ɪ l
fleeing	f l iː ɪ ŋ
self	s ɛ l f
bumptious	b ʌ m p ʃ ə s
invoke	ɪ n v o ʊ k
legislature	l ɛ d͡ʒ ɪ s l e ɪ t͡ʃ ɚ
arachnophobia	æ ɹ æ k n ə f ə ʊ b ɪ ə
globus	ɡ l ə ʊ b ə s
ways	w e ɪ z
fus'ha	f ʊ s h ə
smiling	s m a ɪ l ɪ ŋ
aniseed	æ n ɪ s i d
populace	p ɑ p j ə l ə s
ecumenopoleis	ɛ k j u m ɛ n ɒ p ɒ l ɛ ɪ z
rules	ɹ u l z
particularity	p ə ɹ t ɪ k j ə l ɛ ɹ ə t i
mealer	m iː l ə ɹ
formalist	f ɔ ɹ m l̩ ɪ s t
ra	ɹ ɑː
crawshay	k ɹ ɔː ʃ e ɪ
lupercus	l uː p ɜː ɹ k ə s
turin	t ə ɹ ɪ n
teschenite	t ɛ ʃ ə n a ɪ t
outlet	a ʊ t l ɛ t
slimebucket	s l a i m b ʌ k ɪ t
grid	ɡ ɹ ɪ d
okie	o ʊ k i
fasces	f æ s iː z
foolhardy	f u l h ɑ ɹ d i
ante	æ n t i
favors	f e ɪ v ɚ z
rbar	ɹ iː b ɑ ɹ
foofaraw	f u f ə ɹ ɔ
clowns	k l a ʊ n z
clicking	k l ɪ k ɪ ŋ
hermeneutical	h ɝ m ə n j uː t ɪ k ə l
cringing	k ɹ ɪ n d͡ʒ ɪ ŋ
lavandin	l æ v ə n d ɪ n
putrefaction	p j uː t ɹ ə f æ k ʃ ə n
latecomer	l e ɪ t k ʌ m ɚ
yogh	j o ʊ ɡ
parthenon	p ɑː ɹ θ ə n ɑː n
accusatory	ə k j u z ə t ɔ ɹ i
rhinocerotes	ɹ a ɪ n ɑː s ə ɹ o ʊ t s
alphas	æ ɫ f ə z
fathead	f æ t h ɛ d
erythrocyte	ə ɹ ɪ θ ɹ ə s a ɪ t
hexacosichoron	h ɛ k s ə ɪ k o ʊ s ɪ k o ʊ ɹ ɔ n
blissfully	b l ɪ s f l i
resurrection	ɹ ɛ z ə ɹ ɛ k ʃ n̩
nsutite	ə n s uː t a ɪ t
outsourcing	a ʊ t s ɔː ɹ s ɪ ŋ
dzud	d z uː d
chillax	t͡ʃ ɪ l æ k s
ion	a ɪ o ʊ n
couch	k a ʊ t͡ʃ
nunavut	n j uː n ə v uː t
gibnut	ɡ ɪ b n ʌ t
puzzled	p ʌ z l̩ d
cabg	k æ b ɪ d͡ʒ
freeminer	f ɹ iː m a ɪ n ə
debug	d iː b ʌ ɡ
sherman	ʃ ɜː ɹ m ə n
oxidative	ɑ k s ə d e ɪ t ɪ v
dilucidation	d ɪ l j uː s ɪ d e ɪ ʃ ə n
intemperance	ɪ n t ɛ m p ɛ ɹ ə n s
preferred	p ɹ ɪ f ɝ d
wren	ɹ ɛ n
dactylology	d æ k t ə l ɑ l ə d͡ʒ i
soldanrie	s o ʊ l d ə n ɹ i
lhasa	l ɑː s ə
huffaz	h ʊ f ɑː z
petrarch	p i t ɹ ɑ ɹ k
function	f ʌ ŋ k ʃ ə n
pahari	p ə h ɑː ɹ i
cefozopran	s ə f ɑ z ə p ɹ æ n
sickening	s ɪ k ə n ɪ ŋ
carny	k ɑː ɹ n i
abaculus	ə b æ k j ə l ə s
hydrocele	h a ɪ d ɹ ə s iː l
recourse	ɹ iː k ɔ ɹ s
urged	ɝ d͡ʒ d
sclerotal	s k l ə ɹ ə ʊ t ə l
cacciatore	k ɑ t͡ʃ ə t ɔ ɹ i
fishhook	f ɪ ʃ h ʊ k
copyist	k ɑ p i ɪ s t
apoptosis	æ p ə p t o ʊ s ə s
scimitar	s ɪ m ɪ t ɑː ɹ
abound	ə b a ʊ n d
skoosh	s k u ʃ
peeping	p iː p ɪ ŋ
apostate	ə p ɔ s t e ɪ t
scious	s a ɪ ə s
grossly	ɡ ɹ o ʊ s l i
custodian	k ə s t o ʊ d i ə n
splooge	s p l uː d͡ʒ
signification	s ɪ ɡ n ɪ f ɪ k e ɪ ʃ ə n
wain	w e ɪ n
cognoscence	k ɒ ɡ n ə s ə n s
confidant	k ɑ n f ɪ d ɑ n t
odessa	ə ʊ d ɛ s ə
spatter	s p æ t ɚ
launch	l ɔ n t͡ʃ
incisiveness	ɪ n s a ɪ s ə v n ə s
raajmahal	r ɑː d͡ʒ m ə h ə l
lepid	l ɛ p ɪ d
ashplant	æ ʃ p l æ n t
weary	w ɪ ə ɹ i
union	j uː n i ə n
masturbatory	m æ s t ɚ b ə t ɔː r i
mesophyll	m iː s ə ʊ f ɪ l
lactulose	l æ k t j ʊ l o ʊ s
military	m ɪ l ɪ t ɛ ɹ i
resource	ɹ i s ɔ ɹ s
biotite	b a ɪ ə t a ɪ t
paralipomenon	p æ ɹ ə l ɪ p ɒ m ɪ n ɒ n
envoi	ɑ n v ɔ ɪ
lino	l a ɪ n ə ʊ
tsuba	s u b ə
knoll	n o ʊ l
askeses	ə s k i s i z
nullibiety	n ʌ l ɪ b a ɪ ɪ t i
application	æ p l ɪ k e ɪ ʃ ə n
jubile	d͡ʒ u b ə l
relapse	ɹ iː l æ p s
greater	ɡ ɹ e ɪ t ə ɹ
tetracycline	t ɛ t ɹ ə s a ɪ k l iː n
tweed	t w iː d
politure	p ɒ l i t j ʊ ə ɹ
remediate	ɹ ə m iː d i e ɪ t
deign	d e ɪ n
fenoldopam	f ɪ n o ʊ l d ə p æ m
ablush	ə b l ʌ ʃ
encounter	ɪ n k a ʊ n t ɚ
artel	ɑː ɹ t ɛ l
unartistic	ʌ n ɑ ɹ t ɪ s t ɪ k
thunderstruck	θ ʌ n d ɚ s t ɹ ʌ k
handwavium	h æ n d w e ɪ v i ə m
belongs	b ɪ l ɔ ŋ z
ethea	iː θ ɪ ə
lachesis	l æ k ɪ s ɪ s
ribaudequin	ɹ ɪ b ə ʊ d ɪ k ɪ n
foreholding	f ɔ ɹ h o ʊ l d ɪ ŋ
provident	p ɹ ɒ v ɪ d ə n t
teleophyte	t ɛ l iː ə ʊ f a ɪ t
automatons	ɑ t ɑ m ə t ɑ n z
hadleigh	h æ d l i
bending	b ɛ n d ɪ ŋ
croon	k ɹ uː n
diock	d a ɪ ɑ k
alabama	æ l ə b æ m ə
tetraeteris	t ɛ t r ə ɛ d ə r ə s
hygraulic	h a ɪ ɡ ɹ ɒ l ɪ k
cribble	k ɹ ɪ b ə l
interlanguage	ɪ n t ɜ ɹ l æ ŋ ɡ w ɪ d͡ʒ
cheating	t͡ʃ iː t ɪ ŋ
acclaims	ə k l e ɪ m z
spiracle	s p ɪ ɹ ə k ə l
bulky	b ʌ l k i
ignifluous	ɪ ɡ n ɪ f l u ə s
ebony	ɛ b ə n i
optics	ɑ p t ɪ k s
phocian	f ə ʊ s i ə n
heaumes	h ə ʊ m z
polynomial	p ɑ l i n o ʊ m i ə l
odorless	ə ʊ d ə l ə s
advancer	ə d v æ n s ɚ
abouts	ə b a ʊ t s
ammo	æ m o ʊ
shrining	ʃ ɹ a ɪ n ɪ ŋ
ampere	æ m p ɪ ə r
theanthropist	θ iː æ n θ ɹ ə p ɪ s t
keeler	k i l ɚ
kasundi	k ə s ʊ n d i
proleptical	p ɹ ə ʊ l ɛ p t ɪ k ə l
feigning	f e ɪ n ɪ ŋ
nodule	n ɑː d͡ʒ uː l
europe	j ɝ ə p
guillemet	ɡ i j ə m e ɪ
rasorial	ɹ ə s ɔː ɹ ɪ ə l
nicaragua	n ɪ k ə ɹ ɑ ɡ w ə
gerrit	ɡ ɛ ɹ ɪ t
kingdom	k ɪ ŋ d ə m
oxter	ɒ k s t ə ɹ
damned	d æ m d
jargle	d͡ʒ ɑː ɹ ɡ ə l
stutter	s t ʌ t ɚ
zoomies	z uː m i z
batdom	b æ t d ə m
operand	ɑ p ə ɹ æ n d
teas	t iː z
loot	l uː t
supershot	s u p ɚ ʃ ɑ t
crow	k ɹ o ʊ
conscience	k ɑ n ʃ ə n s
menobranch	m ɛ n ə b ɹ æ ŋ k
patch	p æ t͡ʃ
chute	ʃ j uː t
loppet	l o ʊ p ɛ t
incitement	ɪ n s a ɪ t m ə n t
banjouke	b æ n d͡ʒ ə ʊ j uː k
viga	v iː ɡ ə
superalmighty	s uː p ə ɹ ɔː l m a ɪ t i
inchoative	ɪ n k o ʊ ə t ɪ v
upsoar	ʌ p s ɔː ɹ
skens	s k ɛ n z
haze	h e ɪ z
oolith	o ʊ ə l ɪ θ
efforce	ɪ f ɔː ɹ s
maya	m a ɪ ə
tigger	t ɪ ɡ ɚ
pepcid	p ɛ p s ɪ d
sports	s p ɔ ɹ t s
axolotl	æ k s ə l ɑ t ə l
newel	n j u ə l
taro	t ɑ ɹ o ʊ
part	p ɑ ɹ t
indexes	ɪ n d ɛ k s ɪ z
affluent	æ f l u ə n t
donjon	d ɒ n d͡ʒ ə n
groundbreaking	ɡ ɹ a ʊ n d b ɹ e ɪ k ɪ ŋ
tends	t ɛ n d z
abelmosk	e ɪ b l m ɑ s k
zucc	z ʌ k
higgs	h ɪ ɡ z
dispenser	d ɪ s p ɛ n s ə
cloverleaf	k l o ʊ v ɚ l iː f
absently	æ b s n̩ t l i
tuff	t ʌ f
aquiline	æ k w ɪ l a ɪ n
retribution	ɹ ɛ t ɹ ɪ b j u ʃ ə n
centrosymmetricity	s ɛ n t ɹ ə ʊ s ɪ m ə t ɹ ɪ s ɪ t i
peta	p iː t ə
fusee	f j uː z i
academics	æ k ə d ɛ m ɪ k s
meadery	m i d ə ɹ i
spiced	s p a ɪ s t
orenda	o ʊ ɹ ɛ n d ə
gifting	ɡ ɪ f t ɪ ŋ
standfield	s t æ n d f iː l d
aevum	i v ə m
pastings	p e ɪ s t ɪ ŋ z
pest	p ɛ s t
lice	l a ɪ s
poking	p o ʊ k ɪ ŋ
prereq	p ɹ i ɹ ɛ k
monish	m ɒ n ɪ ʃ
instance	ɪ n s t ə n s
dudley	d ʌ d l i
lineages	l ɪ n i ɪ d ʒ ɪ z
kilos	k i l o ʊ z
desires	d ɪ z a ɪ ɹ z
naught	n ɔ t
sconce	s k ɑ n s
piezoelectricity	p i e ɪ z ə ʊ ɪ l ɛ k t r ɪ s ɪ t i
ballerina	b æ l ə ɹ iː n ə
whitster	h w ɪ t s t ə ɹ
understander	ə n d ɚ s t æ n d ɚ
prenuptual	p ɹ i n ʌ p t͡ʃ w ə ɫ
peachy	p iː t͡ʃ i
zeppola	t s ɛ p ə l ə
chard	t͡ʃ ɑ ɹ d
bowery	b a ʊ ə ɹ i
megapenny	m ɛ ɡ ə p ɛ n i
gridlock	ɡ ɹ ɪ d l ɑ k
humming	h ʌ m ɪ ŋ
dicky	d ɪ k i
silsden	s ɪ l z d ə n
ground	ɡ ɹ a ʊ n d
fibularis	f ɪ b j ə l ɛ ɹ ɪ s
makeless	m e ɪ k l ə s
mysoped	m a ɪ s ə ʊ p ɛ d
anyways	ɛ n i w e ɪ z
asceticist	ə s ɛ t ə s ɪ s t
vegeburger	v ɛ d͡ʒ iː b ɜː ɹ ɡ ə ɹ
unergatives	ʌ n ɜː ɹ ɡ ə t ɪ v z
flooding	f l ʌ d ɪ ŋ
massey	m æ s i
gooch	ɡ uː t͡ʃ
quarrel	k w ɔ ɹ ə l
bavaroy	b æ v ə ɹ ɔ ɪ
catamite	k æ t ə m a ɪ t
terrenceville	t ɛ ɹ ə n s v ɪ l
cueing	k j uː ɪ ŋ
taxes	t æ k s iː z
balearic	b æ l i æ ɹ ɪ k
nielle	n j ɛ l
apt	æ p t
yage	j ɑː h e ɪ
flintwork	f l ɪ n t w ɜː ɹ k
hornotine	h ɔː ɹ n ə t a ɪ n
crepuscular	k ɹ ɪ p ʌ s k j ə l ɚ
valeria	v ə l ɪ ə ɹ i ə
linearity	l ɪ n i æ ɹ ə t i
nack	n æ k
branch	b ɹ æ n t͡ʃ
debunk	d iː b ʌ ŋ k
maecenatism	m iː s iː n ə t ɪ z ə m
fembitch	f ɛ m b ɪ t͡ʃ
xenogenetic	z ɛ n ə ʊ d͡ʒ ə n ɛ t ɪ k
rigs	ɹ ɪ ɡ z
zolpidem	z o ʊ l p ɪ d ɛ m
correspondence	k ɒ ɹ ɪ s p ɒ n d ə n s
julian	d͡ʒ uː l i ə n
stigma	s t ɪ ɡ m ə
wert	w ɝ t
poussette	p uː s ɛ t
implements	ɪ m p l ə m ə n t s
insecure	ɪ n s ə k j ɔ ɹ
colón	k ə l o ʊ̯ n
deneisha	d ɪ n iː ʃ ə
cuissard	k w i s ɑ ɹ d
siglum	s ɪ ɡ l ə m
yardbird	j ɑ ɹ d b ɝ d
frontal	f ɹ ʌ n l̩
add	æ d
wares	w ɛ ɹ z
wrests	ɹ ɛ s t s
resinify	ɹ ɛ z ɪ n ə f a ɪ
scuppernong	s k ʌ p ə ɹ n ɑ ŋ
orthopedics	ɔ ɹ θ ə p i d ɪ k s
secure	s ə k j ɔ ɹ
innage	ɪ n ə d͡ʒ
gamaliel	ɡ æ m ə l iː ə l
statistic	s t ə t ɪ s t ɪ k
lop	l o ʊ p
dixy	d ɪ k s i
kerberos	k ɜ ɹ b ə ɹ ə s
pederast	p i d ə ɹ æ s t
driscoll	d ɹ ɪ s k ə l
macropsy	m æ k ɹ ɒ p s i
ecstatica	ɛ k s t æ t ɪ k ə
norgestrel	n ɔ ɹ d͡ʒ ɛ s t ɹ ə l
scrunge	s k ɹ ʌ n d͡ʒ
abbotcy	æ b ə t s i
reticulate	ɹ ə t ɪ k j u l e ɪ t
metharbital	m ə θ ɑ ɹ b ə t ɔ l
einstein	a ɪ n s t a ɪ n
turkey	t ɝ k i
oma	o ʊ m ɑ
adhocratic	æ d h ə k ɹ æ d ɪ k
antrum	æ n t ɹ ə m
manor	m æ n ə ɹ
kenora	k ə n ɔː r ə
supratrochlear	s u p ɹ ə t ɹ ɑ k l i ɚ
poppets	p ɒ p ɪ t s
maniac	m e ɪ n i æ k
foredispose	f ɔː ɹ d ɪ s p ə ʊ z
hold	h o ʊ l d
extrapsychic	ɛ k s t ɹ ə s a ɪ k ɪ k
belladonna	b ɛ l ə d ɑ n ə
sambuq	s æ m b u k
attractant	ə t ɹ æ k t ə n t
undeserving	ʌ n d ɪ z ɝ v ɪ ŋ
confronted	k ə n f ɹ ʌ n t ɪ d
rearview	ɹ i ɹ v j uː
fluvoxamine	f l uː v ɑ k s ə m iː n
frontlet	f ɹ ʌ n t l ə t
vility	v a ɪ l ɪ t i
blackings	b l æ k ɪ ŋ z
