تخلص	t a x a l l a sˤ a
فراء	f a r aː ʔ
محترف	m u ħ t a r i f
وردة	w a r d a
بوصير	b uː sˤ iː r
عادة	ʕ aː d a
فور	f a w r
كفالة	k a f aː l a
توسع	t a w a s s a ʕ a
صحح	sˤ a ħ ħ a ħ a
زربطانة	z a r b a tˤ aː n a
فرصاد	f i r sˤ aː d
سعال	s u ʕ aː l
رصاصة	r a sˤ aː sˤ a
كمثراة	k u m m a θ r aː h
أشيب	ʔ a ʃ j a b
ملاقاة	m u l aː q aː h
النمسا	a n n a m s aː
جزع	d͡ʒ a z a ʕ a
سلوى	s a l w aː
السودان	a s s uː d aː n
انتشار	i n t i ʃ aː r
باقلاء	b aː q i l aː ʔ
أشابة	ʔ u ʃ aː b a
انكتاب	i n k i t aː b
حسناء	ħ a s n aː ʔ
بورسودان	b uː r s uː d aː n
استقلال	i s t i q l aː l
وثيق	w a θ iː q
أغسطس	ʔ a ɣ u s tˤ u s
ورشنوفة	w a r ʃ a n uː f a
أنتم	ʔ a n t u m
برقية	b a r q i j j a
مقارنة	m u q aː r a n a
مقدار	m i q d aː r
أذاع	ʔ a ð aː ʕ a
فرفيري	f i r f iː r i j j
مساواة	m u s aː w aː h
استمارة	i s t i m aː r a
عزيز	ʕ a z iː z
معبر	m a ʕ b a r
تاريخ	t aː r iː x
قذيفة	q a ð iː f a
فتة	f a t t a
شبح	ʃ a b a ħ
صخف	sˤ a x a f a
سمكة	s a m a k a
خسارة	x a s aː r a
سرنديب	s a r a n d iː b
مباراة	m u b aː r aː h
خزز	x u z a z
تسريب	t a s r iː b
افتخر	i f t a x a r a
الصين	a sˤ sˤ iː n
يرقة	j a r a q a
ناعورة	n aː ʕ uː r a
ليلتذاك	l a j l a t a ð aː k a
صاج	sˤ aː d͡ʒ
اتهم	i t t a h a m a
جنطيانا	d͡ʒ a n tˤ i j aː n aː
متسول	m u t a s a w w i l
تصوير	t a sˤ w iː r
اضطهاد	i dˤ tˤ i h aː d
مقاس	m a q aː s
شاشية	ʃ aː ʃ i j j a
هيبة	h a j b a
مغلق	m i ɣ l a q
بيوت	b u j uː t
شعبية	ʃ a ʕ b i j j a
تشهل	t a ʃ a h h a l a
صأكة	sˤ a ʔ k a
مستنقع	m u s t a n q a ʕ
قندهار	q u n d u h aː r
إقامة	ʔ i q aː m a
صخيد	sˤ a x iː d
غالب	ɣ aː l i b
ميز	m a j j a z a
عنى	ʕ a n aː
تلم	t a l a m
غرفة	ɣ u r f a
شيء	ʃ a j ʔ
هطلس	h a tˤ a l l a s
خنزير	x i n z iː r
مخطئ	m u x tˤ i ʔ
نادل	n aː d i l
غلب	ɣ a l a b
آسيوي	ʔ aː s i j a w i j j
لبوس	l a b uː s
استحضر	i s t a ħ dˤ a r a
دردق	d a r d a q
فلو	f a l u w w
حرمان	ħ i r m aː n
رأسمال	r a ʔ s m aː l
أنتما	ʔ a n t u m aː
برمج	b a r m a d͡ʒ a
أنبوب	ʔ u n b uː b
واحدة	w aː ħ i d a
عقدة	ʕ u q d a
كهنوت	k a h a n uː t
هدار	h a d d aː r
اختصر	i x t a sˤ a r a
تراخوما	t a r aː x uː m aː
فحم	f a ħ m
حوجلة	ħ a w d͡ʒ a l a
سلبي	s a l b i j j
إسكتلندا	ʔ i s k u t l a n d aː
رضائع	r a dˤ aː ʔ i ʕ
وأد	w a ʔ a d a
أوراق	ʔ a w r aː q
محجوب	m a ħ d͡ʒ uː b
براغ	b r aː ɣ
عاب	ʕ aː b a
ألهى	ʔ a l h aː
بيد	b a j d a
هدس	h a d a s
شطر	ʃ a tˤ a r a
كرنيب	k a r n iː b
دستوري	d u s t uː r i j j
زحزح	z a ħ z a ħ a
ملبس	m a l b a s
ماجد	m aː d͡ʒ i d
مكحلة	m u k a ħ l a
سلطانية	s u l tˤ aː n i j j a
دهس	d a h a s a
ارتاح	i r t aː ħ a
عنبروت	ʕ a n b a r uː t
زحمة	z a ħ m a
احترق	i ħ t a r a q a
ديسمبر	d iː s a m b a r
تدثر	t a d a θ θ a r a
راكب	r aː k i b
أريكا	ʔ a r iː k aː
أوحد	ʔ a w ħ a d
دحرج	d a ħ r a d͡ʒ a
اعتقل	i ʕ t a q a l a
انتبه	i n t a b a h a
زغاية	z a ɣ aː j a
سافانا	s aː f aː n aː
بندق	b u n d u q
دجلة	d i d͡ʒ l a
بارزد	b aː r z a d
سعد	s u ʕ d
اختلال	i x t i l aː l
سليلة	s a l iː l a
رزتاق	r u z t aː q
بغلة	b a ɣ l a
لطم	l a tˤ a m a
عدمية	ʕ a d a m i j j a
أفرط	ʔ a f r a tˤ a
ملف	m i l a f f
صراع	sˤ i r aː ʕ
آتون	ʔ aː t uː n
أناغلس	ʔ a n aː ɣ a l i s
دجاجة	d a d͡ʒ aː d͡ʒ a
طاف	tˤ aː f a
لهيب	l a h iː b
ارتياع	i r t i j aː ʕ
لكن	l aː k i n
توفيق	t a w f iː q
تغريدة	t a ɣ r iː d a
أميرة	ʔ a m iː r a
بخص	b a x a sˤ
قسوة	q a s w a
تورم	t a w a r r a m a
يهوه	j a h w a h
البهاما	a l b a h aː m aː
أطفال	ʔ a tˤ f aː l
فوذنج	f uː ð a n a d͡ʒ
مضيرة	m a dˤ iː r a
بارز	b aː r a z a
هجوم	h u d͡ʒ uː m
محجمة	m i ħ d͡ʒ a m a
حماس	ħ a m aː s
نباهة	n a b aː h a
بابل	b aː b i l
تأميم	t a ʔ m iː m
سيخي	s iː x i j j
لهجة	l a h d͡ʒ a
عربن	ʕ a r b a n a
تلفاف	t i l f aː f
سقمونيا	s a q a m uː n i j aː
حنان	ħ a n aː n
عيدية	ʕ iː d i j j a
طأطأ	tˤ a ʔ tˤ a ʔ a
ناسور	n aː s uː r
عظم	ʕ a ðˤ m
مغلاق	m i ɣ l aː q
ضاجع	dˤ aː d͡ʒ a ʕ a
عفت	ʕ a f a t a
يقظة	j a q a ðˤ a
مذكرة	m u ð a k k a r a
سخيف	s a x iː f
بهر	b a h a r a
سنبل	s u n b u l
عاين	ʕ aː j a n a
طبخ	tˤ a b a x a
أدبة	ʔ a d a b a
قلب	q a l a b a
ليل	l a j l
برشيد	b a r ʃ iː d
كعك	k a ʕ k
طرشي	tˤ u r ʃ i j j
مخبول	m a x b uː l
بطانة	b i tˤ aː n a
نظير	n a ðˤ iː r
تعليم	t a ʕ l iː m
ميناء	m iː n aː ʔ
شربوش	ʃ a r b uː ʃ
باسل	b aː s i l
أحاط	ʔ a ħ aː tˤ a
نفقة	n a f a q a
عرناس	ʕ a r n aː s
سابع	s aː b i ʕ
نخالة	n u x aː l a
زوفا	z uː f aː
زنباع	z a n b aː ʕ
إهليلج	ʔ i h l iː l a d͡ʒ
رخيص	r a x iː sˤ
حوالي	ħ a w aː l a j
ارتباط	i r t i b aː tˤ
ضائن	dˤ aː ʔ i n
أسفنيك	ʔ a s f a n iː k
غواصة	ɣ a w w aː sˤ a
ضمخ	dˤ a m a x a
فكر	f a k a r a
أصلع	ʔ a sˤ l a ʕ
زبيل	z a b b iː l
عبادة	ʕ i b aː d a
سخاء	s a x aː ʔ
صلابة	sˤ a l aː b a
حامول	ħ aː m uː l
مكمل	m u k a m m a l
ستار	s i t aː r
صحرة	sˤ u ħ r a
أخثاث	ʔ a x θ aː θ
خبا	x a b aː
متكبر	m u t a k a b b i r
طائر	tˤ aː ʔ i r
مسكان	m u s k aː n
بتاتا	b a t aː t aː
صبابة	sˤ a b aː b a
محول	m u ħ a w w i l
كشتبان	k u ʃ t u b aː n
استخدم	i s t a x d a m a
طموح	tˤ u m uː ħ
طلب	tˤ a l a b
غليون	ɣ a l j uː n
جعضيض	d͡ʒ a ʕ dˤ iː dˤ
مقصف	m a q sˤ a f
بخير	b i x a j r
ابتنى	i b t a n aː
هنا	h u n aː
خفق	x a f a q a
جليد	d͡ʒ a l iː d
بثور	b u θ uː r
آمين	ʔ aː m iː n a
قبو	q a b w
بدنة	b a d a n a
سبطانة	s a b a tˤ aː n a
تترى	t a t r aː
قوقعة	q a w q a ʕ a
تدريب	t a d r iː b
مئذنة	m i ʔ ð a n a
بخت	b a x t
تشاعر	t a ʃ aː ʕ a r a
إجاص	ʔ i d͡ʒ d͡ʒ aː sˤ
سيماء	s iː m aː ʔ
انخفض	i n x a f a dˤ a
معاوية	m u ʕ aː w i j a
لهذا	l i h aː ð aː
بارد	b aː r i d
خزينة	x a z iː n a
نرويجية	n u r w iː d͡ʒ i j j a
غار	ɣ aː r a
عربية	ʕ a r a b i j j a
صواع	sˤ i w aː ʕ
أغلب	ʔ a ɣ l a b
بائن	b aː ʔ i n
دستور	d u s t uː r
حيهل	ħ a j j a h a l
خصص	x a sˤ sˤ a sˤ a
عجورة	ʕ a d͡ʒ d͡ʒ uː r a
سركنجبين	s i r k a n d͡ʒ a b iː n
تلاشى	t a l aː ʃ aː
عجور	ʕ a d͡ʒ d͡ʒ uː r
قذال	q a ð aː l
صحراوي	sˤ a ħ r aː w i j j
ملعقة	m i l ʕ a q a
تليس	t a l l iː s
هجران	h i d͡ʒ r aː n
فاتية	f aː t i j a
براق	b a r r aː q
أسرب	ʔ u s r u b
أمضى	ʔ a m dˤ aː
كمأ	k a m a ʔ
تعطى	t a ʕ a tˤ tˤ aː
إيران	ʔ iː r aː n
رستاق	r u s t aː q
قرميدة	q i r m iː d a
أباجور	ʔ a b aː d͡ʒ uː r
اندلع	i n d a l a ʕ a
محراث	m i ħ r aː θ
عقل	ʕ a q l
ملوكية	m u l uː k i j j a
الوداع	a l w a d aː ʕ
خرطال	x a r tˤ aː l
صيد	sˤ a j d
متماد	m u t a m aː d d
شقاء	ʃ a q aː ʔ
ضغبوس	dˤ u ɣ b uː s
رسول	r a s uː l
مناخي	m a n aː x i j j
مشرك	m u ʃ r i k
اكتئاب	i k t i ʔ aː b
حنون	ħ a n uː n
لأك	l a ʔ a k a
دبيل	d a b iː l
ثمانون	θ a m aː n uː n
مرادف	m u r aː d i f
مرفوع	m a r f uː ʕ
ملاحقة	m u l aː ħ a q a
صعيد	sˤ a ʕ iː d
أنوق	ʔ a n uː q
كركند	k a r k a n d
اعتمد	i ʕ t a m a d a
نبيل	n a b iː l
مظهر	m a ðˤ h a r
غدير	ɣ a d iː r
مائدة	m aː ʔ i d a
هزل	h a z a l a
شعرى	ʃ a ʕ r aː
اقترح	i q t a r a ħ a
سبعة	s a b ʕ a
عودة	ʕ a w d a
سجين	s a d͡ʒ iː n
تناوم	t a n aː w a m a
استيقظ	i s t a j q a ðˤ a
ذال	ð aː l
مفرغ	m u f a r r a ɣ
أغوى	ʔ a ɣ w aː
فانيذ	f aː n iː ð
تتويج	t a t w iː d͡ʒ
لوياثان	l a w i j aː θ aː n
جاب	d͡ʒ aː b a
إسرنج	ʔ i s r i n d͡ʒ
أيل	ʔ a j j a l
معنوي	m a ʕ n a w i j j
غرس	ɣ a r a s a
طيرة	tˤ a j r a
كان	k aː n a
جزمازق	d͡ʒ a z m aː z a q
ساحة	s aː ħ a
حينما	ħ iː n a m aː
انسلخ	i n s a l a x a
حدوة	ħ a d w a
بركار	b i r k aː r
كيرلس	k iː r u l u s
أعيا	ʔ a ʕ j aː
لوز	l a w z
برلمان	b a r l a m aː n
فاكرة	f aː k i r a
ضيون	dˤ a j w a n
نشيدة	n a ʃ iː d a
غضاضة	ɣ a dˤ aː dˤ a
مضيق	m a dˤ iː q
قاض	q aː dˤ a
تحت	t a ħ t a
غسق	ɣ a s a q
جوزل	d͡ʒ a w z a l
زرشك	z a r r a ʃ k
كلح	k a l a ħ a
جمال	d͡ʒ a m aː l
وضاح	w a dˤ dˤ aː ħ
المنامة	a l m a n aː m a
غمغم	ɣ a m ɣ a m a
وحمة	w a ħ m a
مداخلة	m u d aː x a l a
البرازيل	a l b a r aː z iː l
فاتر	f aː t i r
تقيؤ	t a q a j j u ʔ
كرز	k a r a z
مضض	m a dˤ a dˤ
نشد	n a ʃ a d a
الأشهل	a l ʔ a ʃ h a l
إيريناوس	ʔ iː r iː n aː w u s
تفاوض	t a f aː w a dˤ a
ناخوذاة	n aː x uː ð aː h
توزيع	t a w z iː ʕ
بسفايج	b a s f aː j a d͡ʒ
مغنيسيا	m a ɣ n iː s i j aː
استكشاف	i s t i k ʃ aː f
ائتلاف	i ʔ t i l aː f
بهرج	b a h r a d͡ʒ
حلتيث	ħ i l t iː θ
صتع	sˤ a t a ʕ a
وجب	w a d͡ʒ a b a
ثوب	θ a w b
قاف	q aː f
بيرق	b a j r a q
تساوى	t a s aː w aː
العراق	a l ʕ i r aː q
مثل	m a θ a l
مذيع	m u ð iː ʕ
صوت	sˤ a w t
أبوت	ʔ u b uː t
أخصائي	ʔ a x i sˤ sˤ aː ʔ i j j
أبرز	ʔ a b r a z
نائم	n aː ʔ i m
تماشى	t a m aː ʃ aː
هنالك	h u n aː l i k a
ميثاق	m iː θ aː q
تقيأ	t a q a j j a ʔ a
انجذاب	i n d͡ʒ i ð aː b
فنجنكشت	f a n d͡ʒ a n k u ʃ t
ظلف	ðˤ i l f
مرو	m a r w
اشتهى	i ʃ t a h aː
نطل	n a tˤ a l a
خليجي	x a l iː d͡ʒ i j j
قيصوم	q a j sˤ uː m
ملكوت	m a l a k uː t
شاسع	ʃ aː s i ʕ
أشهد	ʔ a ʃ h a d a
أبكم	ʔ a b k a m
نفض	n a f a dˤ a
دنر	d a n n a r a
سفرة	s u f r a
خوذة	x uː ð a
هذا	h aː ð a
سامور	s aː m uː r
اختط	i x t a tˤ tˤ a
مقعدة	m a q ʕ a d a
سيس	s a j j a s a
اعوج	i ʕ w a d͡ʒ d͡ʒ a
طنجيرة	tˤ a n d͡ʒ iː r a
وطني	w a tˤ a n i j j
أشل	ʔ a ʃ a l l
تحوط	t a ħ a w w a tˤ a
تصهين	t a sˤ a h j a n a
أدحية	ʔ u d ħ i j a
سراح	s a r aː ħ
وتدي	w a t a d i j j
منون	m a n uː n
زاغ	z aː ɣ a
دوغ	d uː ɣ
اشتباه	i ʃ t i b aː h
سلسل	s a l s a l a
اعتزام	i ʕ t i z aː m
فعل	f a ʕ a l a
قرص	q a r a sˤ a
أوكلاهوما	ʔ uː k l aː h uː m aː
ندى	n a d aː
أشخص	ʔ a ʃ x a sˤ a
حيوان	ħ a j a w aː n
هندباء	h i n d i b aː ʔ
ربت	r a b b a t a
اعتدى	i ʕ t a d aː
تعصر	t a ʕ a sˤ sˤ a r a
موسيقى	m uː s iː q aː
زربية	z a r b i j j a
إبل	ʔ i b i l
دركي	d a r a k i j j
خيمة	x a j m a
سمو	s u m u w w
تباطأ	t a b aː tˤ a ʔ a
مستشرق	m u s t a ʃ r i q
تلفاز	t i l f aː z
شاورما	ʃ aː w a r m aː
عوائد	ʕ a w aː ʔ i d
حكومة	ħ u k uː m a
غوشنة	ɣ a w ʃ a n a
تنقض	t a n a q q a dˤ a
كستيج	k u s t iː d͡ʒ
زميلة	z a m iː l a
اتسم	i t t a s a m a
أنهك	ʔ a n h a k a
فاجرة	f aː d͡ʒ i r a
باطني	b aː tˤ i n i j j
منطقي	m a n tˤ i q i j j
أزلي	ʔ a z a l i j j
هندسي	h a n d a s i j j
كمء	k a m ʔ
تشيلي	t ʃ iː l i j j
نمر	n a m i r
ابتذل	i b t a ð a l a
إفادة	ʔ i f aː d a
تخت	t a x t
راء	r aː ʔ
فيروس	f a j r uː s
هرولة	h a r w a l a
قراسيا	q a r aː s i j aː
أسلوب	ʔ u s l uː b
شهدانج	ʃ a h d aː n a d͡ʒ
توكيد	t a w k iː d
أهلي	ʔ a h l i j j
شيرج	ʃ a j r a d͡ʒ
استطار	i s t a tˤ aː r a
خيزران	x a j z u r aː n
هذب	h a ð ð a b a
لماذا	l i m aː ð aː
هواء	h a w aː ʔ
سيكران	s a j k a r aː n
سكرجة	s u k r u d͡ʒ a
مهم	m u h i m m
فداحة	f a d aː ħ a
تحاشى	t a ħ aː ʃ aː
حانوت	ħ aː n uː t
مغطس	m a ɣ tˤ i s
شلة	ʃ a l l a
لجين	l u d͡ʒ a j n
نفخ	n a f a x a
مسطرة	m i s tˤ a r a
تيش	t iː ʃ
أمير	ʔ a m iː r
أمدمي	ʔ u m d a m i j j
غرور	ɣ u r uː r
أعجمي	ʔ a ʕ d͡ʒ a m i j j
محادثة	m u ħ aː d a θ a
تراب	t u r aː b
منقرض	m u n q a r i dˤ
طرمبة	tˤ r u m b a
أشهل	ʔ a ʃ h a l
اعتقاد	i ʕ t i q aː d
معتل	m u ʕ t a l l
لسع	l a s a ʕ a
سلا	s a l aː
اتحد	i t t a ħ a d a
حقد	ħ a q a d a
أتاح	ʔ a t aː ħ a
أنواع	ʔ a n w aː ʕ
سعيد	s a ʕ iː d
نبيه	n a b iː h
حصبة	ħ a sˤ b a
تسعون	t a s ʕ a w n a
ملوخية	m u l uː x i j j a
عضلة	ʕ a dˤ a l a
ميمون	m a j m uː n
حواء	ħ a w w aː ʔ
عطاط	ʕ a tˤ aː tˤ
فضي	f i dˤ dˤ i j j
جلب	d͡ʒ a l a b
ترسانة	t a r s aː n a
مأمأة	m a ʔ m a ʔ a
قطار	q i tˤ aː r
بيدر	b a j d a r
بطروخ	b a tˤ r uː x
تعالم	t a ʕ aː l a m a
سبسب	s a b s a b
مدرك	m u d r a k
رجب	r a d͡ʒ a b
كاراطي	k aː r aː tˤ iː
لاسلطوية	l aː s u l tˤ a w i j j a
كافور	k aː f uː r
خصية	x i sˤ j a
تقدم	t a q a d d a m a
أصحى	ʔ a sˤ ħ aː
بناية	b i n aː j a
بقرة	b a q a r a
انصرف	i n sˤ a r a f a
فالودج	f aː l uː d a d͡ʒ
كندس	k u n d u s
بكارج	b a k aː r i d͡ʒ
ولاية	w a l aː j a
بحر	b a ħ a r
ضمور	dˤ u m uː r
أفقي	ʔ u f u q i j j
بوسكورة	b uː s k uː r a
إمضاء	ʔ i m dˤ aː ʔ
سائح	s aː ʔ i ħ
ليمي	l a j m i j j
استمد	i s t a m a d d a
بلادونا	b i l aː d uː n aː
تعزل	t a ʕ a z z a l a
هتف	h a t a f a
استيعاب	i s t iː ʕ aː b
اعتل	i ʕ t a l l a
صهيونية	sˤ a h j uː n i j j a
ثابت	θ aː b i t
أحول	ʔ a ħ w a l
استئمارة	i s t i ʔ m aː r a
معانقة	m u ʕ aː n a q a
برن	b i r n
حذلقة	ħ a ð l a q a
قاد	q aː d a
كثيراء	k a θ iː r aː ʔ
سدارة	s a d aː r a
وغل	w a ɣ a l a
وبيل	w a b iː l
تململ	t a m a l m a l a
أنضب	ʔ a n dˤ a b a
أبطل	ʔ a b tˤ a l a
خبيئة	x a b iː ʔ a
ازدهر	i z d a h a r a
رغيفات	r a ɣ iː f aː t
صؤل	sˤ a ʔ u l a
تومان	t uː m aː n
لاسلطوي	l aː s u l tˤ a w i j j
تعزب	t a ʕ a z z a b a
شبع	ʃ a b i ʕ a
كوسوفو	k uː s uː f uː
حجر	ħ a d͡ʒ a r
مخيم	m u x a j j a m
اختلف	i x t a l a f a
زواج	z a w aː d͡ʒ
أخدود	ʔ u x d uː d
سينمائي	s i j n a m aː ʔ i j j
سرقسطة	s a r a q u s tˤ a
مسمار	m i s m aː r
صراط	sˤ i r aː tˤ
زنباعة	z a n b aː ʕ a
متواضع	m u t a w aː dˤ i ʕ
سوسة	s uː s a
محيط	m u ħ iː tˤ
سهول	s u h uː l
جريد	d͡ʒ a r iː d
نجار	n a d͡ʒ d͡ʒ aː r
كثير	k a θ iː r
أباخس	ʔ a b aː x i s u
شابانك	ʃ aː b aː n a k
تأخير	t a ʔ x iː r
شظية	ʃ a ðˤ i j j a
روض	r a w w a dˤ a
عباية	ʕ a b aː j a
داخل	d aː x a l a
مالاوي	m aː l aː w iː
اصطدأ	i sˤ tˤ a d a ʔ a
رابطة	r aː b i tˤ a
لعل	l a ʕ a l l a
تعس	t a ʕ a s a
معمل	m a ʕ m a l
فدائي	f i d aː ʔ i j j
سندس	s u n d u s
حدق	ħ a d a q a
ترياق	t i r j aː q
كزمازج	k a z m aː z a d͡ʒ
عرنسية	ʕ a r a n s i j j a
مؤسسة	m u ʔ a s s a s a
تمهيد	t a m h iː d
سجستان	s a d͡ʒ i s t aː n
غباوة	ɣ a b aː w a
رصفان	r u sˤ f aː n
وجد	w a d͡ʒ a d a
توجه	t a w a d͡ʒ d͡ʒ a h a
عرقوب	ʕ u r q uː b
زقوم	z a q q uː m
الصربية	a sˤ sˤ i r b i j j a
مرش	m a r a ʃ a
ساعد	s aː ʕ a d a
أليس	ʔ a l iː s
تقزز	t a q a z z a z a
شهلة	ʃ a h l a
ممتلكات	m u m t a l a k aː t
مجن	m i d͡ʒ a n n
استعارة	i s t i ʕ aː r a
أول	ʔ a w w a l
مفلفل	m u f a l f a l
قرصعنة	q a r sˤ a ʕ a n n a
إبراهيم	ʔ i b r aː h iː m
بارزذ	b aː r z a ð
هود	h a w d
خارصين	x aː r a sˤ iː n
ضاع	dˤ aː ʕ a
محطة	m a ħ a tˤ tˤ a
معاونة	m u ʕ aː w a n a
كذينق	k u ð iː n a q
قصار	q i sˤ aː r
فراغ	f a r aː ɣ
إشبيلية	ʔ i ʃ b iː l i j a
تواصى	t a w aː sˤ aː
خسأ	x a s a ʔ a
مسابقة	m u s aː b a q a
أحبك	ʔ u ħ i b b u k a
غاضب	ɣ aː dˤ i b
مكث	m a k a θ a
ورن	w a r a n
خفر	x a f a r a
سبج	s a b a d͡ʒ
سربام	s a r a b aː m
استفرغ	i s t a f r a ɣ a
محاكمة	m u ħ aː k a m a
ديمومة	d a j m uː m a
ارتفع	i r t a f a ʕ a
جعفر	d͡ʒ a ʕ f a r
رقم	r a q m
حذار	ħ a ð aː r i
ضاحية	dˤ aː ħ i j a
برذعة	b a r ð a ʕ a
معدن	m a ʕ d i n
بيش	b iː ʃ
رقصة	r a q sˤ a
فلت	f a l a t a
أخبر	ʔ a x b a r a
متصل	m u t t a sˤ i l
شكارة	ʃ i k aː r a
قلقديس	q a l q a d iː s
شامخ	ʃ aː m i x
شلباية	ʃ i l b aː j a
جليس	d͡ʒ a l iː s
رسغ	r u s ɣ
تفاح	t u f f aː ħ
شفاف	ʃ a f f aː f
معارضة	m u ʕ aː r a dˤ a
مقالة	m a q aː l a
صفع	sˤ a f a ʕ a
جحا	d͡ʒ u ħ aː
جيم	d͡ʒ iː m
صربي	sˤ i r b i j j
جذر	d͡ʒ a ð a r a
مضمون	m a dˤ m uː n
مجموع	m a d͡ʒ m uː ʕ
ملكة	m a l i k a
بسباسة	b a s b aː s a
مصب	m a sˤ a b b
أمريكا	ʔ a m r iː k aː
ألا	ʔ a l aː
مصنع	m a sˤ n a ʕ
أطلع	ʔ a tˤ l a ʕ a
تخطى	t a x a tˤ tˤ aː
مرصبان	m a r sˤ a b aː n
صرافة	sˤ a r r aː f a
مسدس	m u s a d d a s
أفيون	ʔ a f j uː n
نذير	n a ð iː r
خصوصي	x u sˤ uː sˤ i j j
تبريز	t a b r iː z
سمار	s a m aː r
مخدر	m u x a d d i r
جانرك	d͡ʒ aː n a r i k
مروض	m u r a w w a dˤ
جولق	d͡ʒ a w l a q
فجور	f u d͡ʒ uː r
لصف	l a sˤ a f
خربش	x a r b a ʃ a
إعراب	ʔ i ʕ r aː b
بالوعات	b aː l uː ʕ aː t
راتينج	r aː t iː n a d͡ʒ
أولياء	ʔ a w l i j aː ʔ
بذرقطونا	b a ð a r q a tˤ uː n aː
تقرير	t a q r iː r
الكنية	a l k u n j a
فقاعة	f u q q aː ʕ a
متانة	m a t aː n a
أنزع	ʔ a n z a ʕ a
فأس	f a ʔ s
أرهب	ʔ a r h a b a
فكرة	f i k r a
نشيد	n a ʃ iː d
انفتح	i n f a t a ħ a
حساسي	ħ a s s aː s i j j
متوفر	m u t a w a f f i r
تلا	t a l aː
سهر	s a h i r a
المشتري	a l m u ʃ t a r iː
رعرع	r a ʕ r a ʕ a
إمامة	ʔ i m aː m a
عمان	ʕ a m m aː n
عنق	ʕ a n a q
يتيم	j a t iː m
حليب	ħ a l iː b
استحصل	i s t a ħ sˤ a l a
وابور	w aː b uː r
جيء	d͡ʒ a j ʔ
باطية	b aː tˤ i j a
وزراء	w u z a r aː ʔ
خصوص	x u sˤ uː sˤ
رتينج	r a t iː n a d͡ʒ
زرع	z a r a ʕ a
تماسك	t a m aː s a k a
ظمئ	ðˤ a m i ʔ a
كرسوع	k u r s uː ʕ
ذعن	ð a ʕ i n a
خيزان	x iː z aː n
محسن	m u ħ a s s a n
شيرة	ʃ a j r a
أنتيكخانة	ʔ a n t iː k x aː n a
رمان	r u m m aː n
مساطر	m a s aː tˤ i r
طرز	tˤ a r r a z a
لبى	l a b b aː
أجوف	ʔ a d͡ʒ w a f
لثغة	l u θ ɣ a
محيل	m u ħ iː l
قدم	q a d a m
ثور	θ a w r
تجرع	t a d͡ʒ a r r a ʕ a
جارية	d͡ʒ aː r i j a
زعتر	z a ʕ t a r
وقع	w a q a ʕ a
قونية	q uː n i j a
قنصلية	q u n sˤ u l i j j a
أزأم	ʔ a z ʔ a m a
قلم	q a l a m
أقرع	ʔ a q r a ʕ
ظاهري	ðˤ aː h i r i j j
ابتلى	i b t a l aː
حجن	ħ a d͡ʒ a n a
زريبة	z a r iː b a
إنتاج	ʔ i n t aː d͡ʒ
طلاق	tˤ a l aː q
سماء	s a m aː ʔ
أساس	ʔ a s aː s
جوذاب	d͡ʒ uː ð aː b
مسافة	m a s aː f a
ديس	d iː s
جيد	d͡ʒ a j j i d
باريس	b aː r iː s
عام	ʕ aː m
صوة	sˤ u w w a
تداعى	t a d aː ʕ aː
واشنطن	w aː ʃ i n tˤ u n
غريبة	ɣ a r iː b a
مضاربة	m u dˤ aː r a b a
رتيل	r u t a j l
شبيه	ʃ a b iː h
مثنوية	m a θ n a w i j j a
قايين	q aː j iː n
ناشف	n aː ʃ i f
أبث	ʔ a b a θ a
طفيف	tˤ a f iː f
صخد	sˤ a x a d a
خداج	x i d aː d͡ʒ
موز	m a w z
قاع	q aː ʕ
تجرد	t a d͡ʒ a r r a d a
انتقض	i n t a q a dˤ a
سيبويه	s iː b a w a j h
دردي	d i r d iː
زفر	z a f a r a
إهداء	ʔ i h d aː ʔ
وصيف	w a sˤ iː f
بيروقراطي	b iː r uː q r aː tˤ i j j
ممحوق	m a m ħ uː q
أعقد	ʔ a ʕ q a d
قال	q aː l
صوف	sˤ a w i f a
إبيقوري	ʔ i b iː q uː r i j j
مخفر	m a x f a r
دويبة	d u w a j b b a
نملة	n a m l a
قمح	q a m ħ
طقم	tˤ a q m
تحكيم	t a ħ k iː m
ديباج	d iː b aː d͡ʒ
تعريف	t a ʕ r iː f
بقية	b a q i j j a
أكمون	ʔ a k m uː n
ذكرى	ð i k r aː
بستوقة	b u s t uː q a
تناسق	t a n aː s u q
إعلامي	ʔ i ʕ l aː m i j j
بلعوم	b u l ʕ uː m
نعال	n i ʕ aː l
استفسار	i s t i f s aː r
باحث	b aː ħ a θ a
كدس	k a d a s a
عتب	ʕ a t a b
وهلة	w a h l a
القنيطرة	a l q u n a j tˤ i r a
دثر	d a θ r
صتم	sˤ a t a m
حبس	ħ a b b a s a
تانبول	t aː n a b uː l
لاحم	l aː ħ i m
ضحية	dˤ a ħ i j j a
دغدغ	d a ɣ d a ɣ a
عمروسة	ʕ a m r uː s a
كنيسة	k a n iː s a
نوراني	n uː r aː n i j j
أباس	ʔ u b aː s
بينيث	b a j n iː θ
شوبك	ʃ a w b a k
شهوة	ʃ a h w a
ضالين	dˤ aː l l iː n
أقضى	ʔ a q dˤ aː
لاط	l aː tˤ a
متجر	m a t d͡ʒ a r
شرق	ʃ a r q
فوضوي	f a w dˤ a w i j j
إبليس	ʔ i b l iː s
نجي	n a d͡ʒ i j j
شكال	ʃ i k aː l
زوجة	z a w d͡ʒ a
جهة	d͡ʒ i h a
مديرة	m u d iː r a
ترك	t a r a k a
تنديل	t a n d iː l
أسطرلاب	ʔ a s tˤ u r l aː b
جلباب	d͡ʒ i l b aː b
أسري	ʔ u s r i j j
جنب	d͡ʒ a n a b
سابق	s aː b i q
إسلام	ʔ i s l aː m
تحكم	t a ħ a k k a m a
فاصوليا	f aː sˤ uː l i j aː
إنهاء	ʔ i n h aː ʔ
بيت	b a j j a t a
غرد	ɣ a r a d
أوقف	ʔ a w q a f a
ابتل	i b t a l l a
غضب	ɣ a dˤ a b
حظيرة	ħ a ðˤ iː r a
أغلفة	ʔ a ɣ l i f a
فاكهة	f aː k h a
اشتق	i ʃ t a q q a
قوم	q a w m
منفي	m a n f i j j
ممسح	m i m s a ħ
أجلح	ʔ a d͡ʒ l a ħ
لكم	l a k a m a
قلما	q a l l a m aː
أدب	ʔ a d a b
شعبة	ʃ i ʕ b a
لحاق	l a ħ aː q
تزعزع	t a z a ʕ z a ʕ a
تزحلق	t a z a ħ l a q a
عجلة	ʕ a d͡ʒ a l a
أكتوبر	ʔ a k t uː b a r
ضرب	dˤ a r a b
بكرج	b a k r a d͡ʒ
شبوط	ʃ a b b uː tˤ
ميمنة	m a j m a n a
فوض	f a w w a dˤ a
دمغة	d a m ɣ a
زحف	z a ħ a f a
طبيبة	tˤ a b iː b a
درياق	d i r j aː q
وبخ	w a b b a x a
غفر	ɣ a f a r a
حجة	ħ i d͡ʒ d͡ʒ a
اكتسب	i k t a s a b a
جسم	d͡ʒ a s s a m a
واحة	w aː ħ a
قذارة	q a ð aː r a
صفر	sˤ a f a r
فنلندا	f i n l a n d aː
ملوخيا	m u l uː x i j j aː
مومس	m uː m i s
ملا	m u l l aː
قنبيل	q a n b iː l
مسجد	m a s d͡ʒ i d
قرصان	q u r sˤ aː n
سؤدد	s u ʔ d a d
بطرخ	b a tˤ r a x
مواطنة	m u w aː tˤ a n a
نزلة	n a z l a
أردمون	ʔ a r d a m uː n
محادث	m u ħ aː d a θ
باب	b aː b
ضجيج	dˤ a d͡ʒ iː d͡ʒ
غرامة	ɣ a r aː m a
هانم	h aː n i m
تعليق	t a ʕ l iː q
باغت	b aː ɣ a t a
انتهى	i n t a h aː
العرائش	a l ʕ a r aː ʔ i ʃ
رياضي	r i j aː dˤ i j j
مرحبا	m a r ħ a b aː
استوقف	i s t a w q a f a
احتقر	i ħ t a q a r a
فالوذة	f aː l uː ð a
تنسيق	t a n s iː q
مجراف	m i d͡ʒ r aː f
أطل	ʔ a tˤ a l l a
أريزونا	ʔ a r iː z uː n aː
متين	m a t iː n
صحاف	sˤ a ħ ħ aː f
عنقاد	ʕ i n q aː d
طريق	tˤ a r iː q
عطاء	ʕ a tˤ aː ʔ
طبشورة	tˤ a b ʃ uː r a
مقبرة	m a q b a r a
كأب	k a ʔ b
استنتاج	i s t i n t aː d͡ʒ
فاشرا	f aː ʃ i r aː
أرز	ʔ a r a z z a
فيل	f iː l
كوسا	k uː s aː
جذع	d͡ʒ a ð a ʕ
أنزل	ʔ a n z a l a
محاور	m a ħ aː w i r
ندوة	n a d w a
شقة	ʃ a q q a
زوان	z a w aː n
لازوردي	l aː z u w a r d i j j
دفاع	d i f aː ʕ
فوضى	f a w dˤ aː
قراءة	q i r aː ʔ a
لفافة	l i f aː f a
نزية	n a z i j j a
تحرش	t a ħ a r r a ʃ a
صراخة	sˤ a r r aː x a
ندد	n a d d a d a
أكثرية	ʔ a k θ a r i j j a
انتخب	i n t a x a b a
كامخ	k aː m a x
استمات	i s t a m aː t a
كرك	k u r k
ارتقب	i r t a q a b a
وفق	w a f f a q a
قوة	q u w w a
انخرط	i n x a r a tˤ a
كارة	k aː r a
أمسوخ	ʔ u m s uː x
مبرة	m a b a r r a
ترنح	t a r a n n a ħ a
مصراع	m i sˤ r aː ʕ
موسيقا	m uː s iː q aː
سقيفة	s a q iː f a
بهلول	b u h l uː l
استجار	i s t a d͡ʒ aː r a
غافث	ɣ aː f a θ
مشاورة	m u ʃ aː w a r a
شلكاية	ʃ a l a k aː j a
تركمانستان	t u r k u m aː n i s t aː n
اتصال	i t t i sˤ aː l
بكين	b i k iː n
خربز	x i r b i z
قلعي	q a l a ʕ i j j
رتيلاء	r u t a j l aː ʔ
مبكر	m u b a k k i r
عادات	ʕ aː d aː t
قسطاس	q i s tˤ aː s
روسي	r uː s i j j
متشكر	m u t a ʃ a k k i r
وجوم	w u d͡ʒ uː m
ألغى	ʔ a l ɣ aː
يافع	j aː f i ʕ
بغيض	b a ɣ iː dˤ
نعناع	n a ʕ n aː ʕ
عندما	ʕ i n d a m aː
زأم	z a ʔ a m a
فسيفساء	f u s a j f i s aː ʔ
دبلجة	d a b l a d͡ʒ a
برسيم	b i r s iː m
غناء	ɣ i n aː ʔ
لأن	l i ʔ a n n a
فسقية	f a s q i j j a
تهجى	t a h a d͡ʒ d͡ʒ aː
هالوك	h aː l uː k
تلحين	t a l ħ iː n
سوريا	s uː r i j aː
عود	ʕ a w d
سوراني	s uː r aː n i j j
عيان	ʕ a j j aː n
ساحلي	s aː ħ i l i j j
مالق	m aː l a q
قشمير	q i ʃ m iː r
تعشيقة	t a ʕ i ʃ iː q a
حصرم	ħ a sˤ r a m
فنطاس	f i n tˤ aː s
إبادة	ʔ i b aː d a
قفة	q u f f a
شراع	ʃ i r aː ʕ
كسوة	k i s w a
معزف	m i ʕ z a f
شمس	ʃ a m a s
إجبار	ʔ i d͡ʒ b aː r
نهزة	n u h z a
قام	q aː m a
ألمانيا	ʔ a l m aː n i j aː
ودج	w a d a d͡ʒ
كاحل	k aː ħ i l
ارتدع	i r t a d a ʕ a
لفف	l a f f a f a
طبقة	tˤ a b a q a
ناضج	n aː dˤ i d͡ʒ
جارة	d͡ʒ aː r a
سدل	s a d a l a
شعيب	ʃ u ʕ a j b
غبار	ɣ u b aː r
براين	b r aː j a n
هرول	h a r w a l
ملاتيوس	m i l aː t i j uː s
حالة	ħ aː l a
دوخة	d a w x a
نبأ	n a b a ʔ
سلاطين	s a l aː tˤ iː n
مطحنة	m a tˤ ħ a n a
بيعة	b a j ʕ a
قريب	q a r iː b
المجر	a l m a d͡ʒ a r
متفجرات	m u t a f a d͡ʒ d͡ʒ i r aː t
أسطرك	ʔ a s tˤ a r a k
أحمق	ʔ a ħ m a q
قاوون	q aː w uː n
داعش	d aː ʕ i ʃ
نتوء	n u t uː ʔ
أوحل	ʔ a w ħ a l a
صقنقور	sˤ a q a n q uː r
مربوط	m a r b uː tˤ
جلهم	d͡ʒ a l h a m
اكتفى	i k t a f aː
مفسر	m u f a s s i r
جادل	d͡ʒ aː d a l a
جبس	d͡ʒ i b s
ذرية	ð u r r i j j a
دعوة	d a ʕ w a
خطام	x i tˤ aː m
أعصر	ʔ a ʕ sˤ a r a
ماسح	m aː s i ħ
مفك	m i f a k k
انتظم	i n t a ðˤ a m a
بعث	b a ʕ a θ a
زيتي	z a j t i j j
كوخ	k uː x
بولاد	b uː l aː d
كرواتي	k u r u w aː t i j j
سبأ	s a b a ʔ
كمون	k a m m uː n
تحسس	t a ħ a s s a s a
عالمي	ʕ aː l a m i j j
حادث	ħ aː d a θ a
زرقطونا	z a r q a tˤ uː n aː
صاءك	sˤ aː ʔ a k a
أوج	ʔ a w d͡ʒ
قلية	q i l l i j j a
سطم	s a tˤ a m a
قصاج	q u sˤ aː d͡ʒ
لكنة	l u k n a
مثار	m u θ aː r
أسف	ʔ a s a f f a
حلقة	ħ a l a q a
كذين	k u ð iː n
سفر	s a f a r
فحشاء	f a ħ ʃ aː ʔ
تحرير	t a ħ r iː r
باروق	b aː r uː q
فودنج	f uː d a n a d͡ʒ
مختبر	m u x t a b a r
هوتة	h a w t a
مخاطر	m a x aː tˤ i r
طلع	tˤ a l a ʕ a
غاب	ɣ aː b a
شنع	ʃ a n n a ʕ a
ناقص	n aː q i sˤ
تشويق	t a ʃ w iː q
عناية	ʕ a n aː j a
جوهري	d͡ʒ a w h a r i j j
عنوسة	ʕ u n uː s a
صيخود	sˤ a j x uː d
رونق	r a w n a q
عصب	ʕ a sˤ a b a
أصفهان	ʔ a sˤ f a h aː n
رقيب	r a q iː b
انزعاج	i n z i ʕ aː d͡ʒ
استعمر	i s t a ʕ m a r a
سكسكة	s a k s a k a
مساومة	m u s aː w a m a
منبه	m u n a b b i h
فلز	f i l a z z
إعلان	ʔ i ʕ l aː n
مستطيلات	m u s t tˤ iː l aː t
تعالى	t a ʕ aː l aː
تمسيد	t a m s iː d
احتفل	i ħ t a f a l a
غمود	ɣ u m uː d
مسود	m u s w a d d
أفل	ʔ a f a l a
حلكة	ħ u l k a
إزالة	ʔ i z aː l a
دبقي	d i b q i j j
نموذجي	n a m uː ð a d͡ʒ i j j
فتاحة	f a t t aː ħ a
دغبوس	d u ɣ b uː s
شره	ʃ a r i h a
شحن	ʃ a ħ a n a
القاهرة	a l q aː h i r a
مصدوم	m a sˤ d uː m
هجليج	h a d͡ʒ l iː d͡ʒ
جندب	d͡ʒ u n d u b
أفرع	ʔ a f r a ʕ
زعط	z a ʕ a tˤ a
استصبر	i s t a sˤ b a r a
سرقين	s i r q iː n
أبها	ʔ a b h aː
عين	ʕ a j j a n a
حمص	ħ a m m a sˤ a
فعالية	f a ʕ ʕ aː l i j j a
ارتخى	i r t a x aː
فضائي	f a dˤ aː ʔ i j j
رابع	r aː b i ʕ
قشعريرة	q u ʃ a ʕ r iː r a
طاعم	tˤ aː ʕ a m a
دائرة	d aː ʔ i r a h
اتبع	i t t a b a ʕ a
استهجان	i s t i h d͡ʒ aː n
مهنة	m i h n a
طما	tˤ a m aː
القرآن	a l q u r ʔ aː n
بسبايج	b a s b aː j a d͡ʒ
جعل	d͡ʒ a ʕ a l a
صاحب	sˤ aː ħ i b
منتخب	m u n t a x a b
مطار	m a tˤ aː r
طحين	tˤ a ħ iː n
مكة	m a k k a
نفاخة	n u f f aː x a
أرثوذكسي	ʔ u r θ uː ð u k s i j j
متسامح	m u t a s aː m i ħ
قرطاجي	q a r tˤ aː d͡ʒ i j j
فقس	f a q a s a
اليمن	a l j a m a n
سرو	s a r w
مصعد	m i sˤ ʕ a d
عائشة	ʕ aː ʔ i ʃ a
تقدد	t a q a d d a d a
زخات	z a x x aː t
سجلاط	s i d͡ʒ i l l aː tˤ
سرخس	s a r x a s
همس	h a m a s a
غانا	ɣ aː n aː
حافلات	ħ aː f i l aː t
عجاب	ʕ u d͡ʒ aː b
زميل	z a m iː l
عناب	ʕ u n n aː b
أسير	ʔ a s iː r
عيش	ʕ a j ʃ
مدام	m u d aː m
بوسة	b a w s a
خادم	x aː d i m
منبر	m i n b a r
حبة	ħ a b b a
فراسيون	f a r aː s i j uː n
مقدر	m u q a d d a r
قروش	q u r uː ʃ
ناي	n aː j
بلور	b i l l a w r
بعلة	b a ʕ l a
فتش	f a t t a ʃ a
قرآني	q u r ʔ aː n i j j
أمصوخ	ʔ u m sˤ uː x
ألية	ʔ a l j a
جورجيا	d͡ʒ uː r d͡ʒ i j aː
آخر	ʔ aː x a r
انقضاض	i n q i dˤ aː dˤ
حاذق	ħ aː ð i q
أرغان	ʔ a r ɣ aː n
ركيزة	r a k iː z a
دكان	d u k k aː n
موحش	m uː ħ i ʃ
أتون	ʔ a t t uː n
ممتلئ	m u m t a l i ʔ
ستارة	s i t aː r a
مظلة	m a ðˤ a l l a
ترصد	t a r a sˤ sˤ a d a
رتيلة	r u t a j l a
مخبأ	m a x b a ʔ
شتاء	ʃ i t aː ʔ
مراسل	m u r aː s i l
بليز	b a l iː z
فرخ	f a r r a x a
ترنج	t r i n d͡ʒ
بوذية	b uː ð i j j a
السفن	a s s u f u n
اغتنم	i ɣ t a n a m a
استفتى	i s t a f t aː
ناخوذة	n aː x uː ð a
أكل	ʔ a k a l a
نوع	n a w w a ʕ a
صيدلية	sˤ a j d a l i j j a
إتلاف	ʔ i t l aː f
إرتريا	ʔ i r i t r i j aː
خطة	x u tˤ tˤ a
بضع	b i dˤ ʕ
عبو	ʕ a b w
ناقوس	n aː q uː s
شبهة	ʃ u b h a
آنك	ʔ aː n u k
رعراع	r a ʕ r aː ʕ
أنما	ʔ a n n a m aː
عيادة	ʕ i j aː d a
معركة	m a ʕ r a k a
الإسكندرية	a l ʔ i s k a n d a r i j j a
دون	d a w w a n a
برشام	b i r ʃ aː m
رادود	r aː d uː d
ثيوقراطي	θ i j uː q r aː tˤ i j j
ذاق	ð aː q a
فتح	f a t a ħ a
أخلاقية	ʔ a x l aː q i j j a
ودامون	w a d aː m uː n
ببر	b a b r
محى	m a ħ aː
استنشق	i s t a n ʃ a q a
انهمك	i n h a m a k a
روسيا	r uː s i j aː
ظبي	ðˤ a b j
زكريا	z a k a r i j j aː
افتقد	i f t a q a d a
أبهج	ʔ a b h a d͡ʒ a
أندر	ʔ a n d a r
ذروة	ð u r w a
فنار	f a n aː r
حنجري	ħ a n d͡ʒ a r i j j
أعجم	ʔ a ʕ d͡ʒ a m a
حورس	ħ uː r u s
جمجمة	d͡ʒ u m d͡ʒ u m a
افترق	i f t a r a q a
طريخ	tˤ a r r iː x
ياي	j aː j
ميتوكندريا	m iː t uː k u n d r i j aː
مرقاق	m i r q aː q
استعمل	i s t a ʕ m a l a
مبشرة	m i b ʃ a r a
إيا	ʔ i j j aː
خصفة	x a sˤ a f a
لقاح	l a q aː ħ
ذمة	ð i m m a
مجموعة	m a d͡ʒ m uː ʕ a
سيرج	s a j r a d͡ʒ
أبش	ʔ a b a ʃ a
مغن	m u ɣ a n n i n
رقيق	r a q iː q
حاسوب	ħ aː s uː b
توتيا	t uː t i j aː
تذكار	t a ð k aː r
إيثار	ʔ iː θ aː r
أسياخ	ʔ a s j aː x
وعليكم	w a ʕ a l a j k u m
نجاة	n a d͡ʒ aː h
إحصائي	ʔ i ħ sˤ aː ʔ i j j
مصباح	m i sˤ b aː ħ
بعثران	b a ʕ θ a r aː n
مازريون	m aː z a r i j uː n
أساسي	ʔ a s aː s i j j
أفريقيا	ʔ a f r iː q j aː
ويكاموس	w iː k aː m uː s
سوس	s a w i s a
مشتاق	m u ʃ t aː q
أعطى	ʔ a ʕ tˤ aː
بزاق	b u z aː q
مرسم	m a r s a m
خيرات	x a j r aː t
سهل	s a h h a l a
أمهل	ʔ a m h a l a
أوعية	ʔ a w ʕ i j a
كحلاء	k a ħ l aː ʔ
أناغاليس	ʔ a n aː ɣ aː l iː s
ترجى	t a r a d͡ʒ d͡ʒ aː
تدريج	t a d r iː d͡ʒ
طلعة	tˤ a l ʕ a
مهذار	m i h ð aː r
شرشيري	ʃ a r ʃ iː r i j j
للأسف	l i l ʔ a s a f
فصح	f a sˤ u ħ a
مغسلة	m a ɣ s a l a
قناع	q i n aː ʕ
غائر	ɣ aː ʔ i r
أضاع	ʔ a dˤ aː ʕ a
مرأة	m a r ʔ a
صغير	sˤ a ɣ iː r
خطيب	x a tˤ iː b
باص	b aː sˤ
واطن	w aː tˤ a n a
منذ	m u n ð u
عنقود	ʕ a n q uː d
غنيمة	ɣ a n iː m a
أركنساس	ʔ a r k a n s aː s
هاتف	h aː t i f
استغرق	i s t a ɣ r a q a
اعتلى	i ʕ t a l aː
جاذبية	d͡ʒ aː ð i b i j j a
سلافي	s l aː f i j j
نظام	n i ðˤ aː m
اقتصاد	i q t i sˤ aː d
عربز	ʕ a r b a z
شاهلوج	ʃ aː h a l uː d͡ʒ
متوسط	m u t a w a s s i tˤ
متزاوج	m u t a z aː w i d͡ʒ
اشتباك	i ʃ t i b aː k
تلك	t i l k a
أسارون	ʔ a s aː r uː n
بلغم	b a l ɣ a m
اندفاع	i n d i f aː ʕ
مشجب	m i ʃ d͡ʒ a b
طمأن	tˤ a m ʔ a n a
تصادم	t a sˤ aː d a m a
كره	k a r h
رخخة	r i x a x a
نسى	n a s s aː
زمن	z a m a n
منافس	m u n aː f i s
أيهقان	ʔ a j h a q aː n
جار	d͡ʒ aː r
بندقاني	b u n d u q aː n iː
دارفلفل	d aː r f i l f i l
لحلاح	l a ħ l aː ħ
أغلف	ʔ a ɣ l a f
مضمار	m i dˤ m aː r
إسرائيل	ʔ i s r aː ʔ iː l
تذمر	t a ð a m m a r a
ضمة	dˤ a m m a
دشمة	d u ʃ m a
خرقة	x i r q a
مضرب	m i dˤ r a b
مشرب	m a ʃ r a b
قاليقلا	q aː l iː q a l aː
تغذية	t a ɣ ð i j a
بشملة	b a ʃ m a l a
سخبر	s a x b a r
ديان	d a j j aː n
نحال	n a ħ ħ aː l
جرو	d͡ʒ a r w
مغبن	m a ɣ b a n
لثم	l a θ a m a
اجتماع	i d͡ʒ t i m aː ʕ
عميق	ʕ a m iː q
جثة	d͡ʒ u θ θ a
عزا	ʕ a z aː
أشوس	ʔ a ʃ w a s
استقبال	i s t i q b aː l
كسيح	k a s iː ħ
هبد	h a b d
ماثل	m aː θ a l a
محموم	m a ħ m uː m
حرق	ħ a r a q a
بليحا	b a l iː ħ aː
رباعيات	r u b aː ʕ i j j aː t
مروحة	m i r w a ħ a
كأس	k a ʔ s
أركن	ʔ a r k u n
طاقية	tˤ aː q i j j a
شاء	ʃ aː ʔ
أسمرة	ʔ a s m a r a
مجسمة	m u d͡ʒ a s s a m a
ثلاثة	θ a l aː θ a
هزج	h a z i d͡ʒ a
مسى	m a s aː
شمبانيا	ʃ a m b aː n j aː
سيف	s a j f
طابور	tˤ aː b uː r
بعثة	b a ʕ θ a
مشعاع	m i ʃ ʕ aː ʕ
ريح	r a j j a ħ a
أكاف	ʔ u k aː f
تزامن	t a z aː m a n a
إشبين	ʔ i ʃ b iː n
سفيه	s a f iː h
بند	b a n d
اشترى	i ʃ t a r aː
غلاء	ɣ a l aː ʔ
برقوق	b a r q uː q
أنثوي	ʔ u n θ a w i j j
بوط	b uː tˤ
بسمة	b a s m a
خنق	x a n a q a
قابيل	q aː b iː l
إسناد	ʔ i s n aː d
سطام	s i tˤ aː m
مقشرة	m i q ʃ a r a
منشأة	m u n ʃ a ʔ a
نعامة	n a ʕ aː m a
تصدير	t a sˤ d iː r
حاسم	ħ aː s i m
اصطك	i sˤ tˤ a k k a
غزاوة	ɣ a z aː w a
قبيلة	q a b iː l a
إفريقية	ʔ i f r iː q i j a
مفرش	m i f r a ʃ
عانى	ʕ aː n aː
طمث	tˤ a m θ
عنصر	ʕ u n sˤ u r
فحص	f a ħ a sˤ a
لحظتذاك	l a ħ ðˤ a t a ð aː k a
مرطبان	m a r tˤ a b aː n
هنغاري	h a n ɣ aː r i j j
ركبة	r a k a b a
تقني	t i q n i j j
استغاث	i s t a ɣ aː θ a
فوطة	f uː tˤ a
سيخية	s iː x i j j a
مغناطيسية	m a ɣ n aː tˤ iː s i j j a
تنحى	t a n a ħ ħ aː
اخترق	i x t a r a q a
فولاذ	f uː l aː ð
أحد	ʔ a ħ a d
نعوظ	n u ʕ uː ðˤ
قيصر	q a j sˤ a r
سقطرة	s u q u tˤ r a
جمهور	d͡ʒ u m h uː r
رضى	r u dˤ aː
سورينام	s uː r iː n aː m
صناب	sˤ i n aː b
يونيو	j uː n i j uː
لذيذ	l a ð iː ð
شاقولي	ʃ aː q uː l i j j
رجرج	r a d͡ʒ r a d͡ʒ a
سويدي	s u w a j d i j j
فشقر	f a ʃ q a r
حنيف	ħ a n iː f
العبرية	a l ʕ i b r i j j a
نبذة	n u b ð a
ضواحك	dˤ a w aː ħ i k
صنعاء	sˤ a n ʕ aː ʔ
عفوي	ʕ a f w i j j
نفاذ	n a f aː ð
أنعم	ʔ a n ʕ a m
ترميم	t a r m iː m
تين	t iː n
وسد	w a s s a d a
أصبح	ʔ a sˤ b a ħ
قفازات	q u f f aː z aː t
نعل	n a ʕ a l
عنوان	ʕ u n w aː n
عظمى	ʕ u ðˤ m aː
رفس	r a f a s a
سباك	s a b b aː k
أنسون	ʔ a n s uː n
أيون	ʔ a j uː n
مقاص	m a q aː sˤ sˤ
فئران	f i ʔ r aː n
أشنان	ʔ u ʃ n aː n
قفلوط	q a f a l uː tˤ
نياط	n i j aː tˤ
معاينة	m u ʕ aː j a n a
سكن	s a k a n
ثريد	θ a r iː d
فاقة	f aː q a
احترف	i ħ t a r a f a
تشبث	t a ʃ a b b a θ a
إيدز	ʔ iː d z
فيثاغورس	f iː θ aː ɣ uː r a s
خرج	x a r a d͡ʒ a
ساج	s aː d͡ʒ
سمن	s a m i n a
رجلة	r u d͡ʒ l a
نادى	n aː d aː
مجرب	m u d͡ʒ a r r i b
عليق	ʕ u l l a j q
ولى	w a l l aː
خنجر	x a n d͡ʒ a r
جحر	d͡ʒ u ħ r
شاكر	ʃ aː k i r
صمغ	sˤ a m ɣ
جزئي	d͡ʒ u z ʔ i j j
شيعة	ʃ iː ʕ a
عفريت	ʕ a f r iː t
كوز	k uː z
حرقوص	ħ a r q uː sˤ
حشيش	ħ a ʃ iː ʃ
مسموح	m a s m uː ħ
السويد	a s s u w a j d
مسد	m a s a d a
أندراوس	ʔ a n d a r aː w u s
وصيد	w a sˤ iː d
ندبة	n a d b a
حراري	ħ a r aː r i j j
عند	ʕ i n d a
هذر	h a ð a r a
أسطوري	ʔ u s tˤ uː r i j j
أغيد	ʔ a ɣ j a d
حرير	ħ a r iː r
تعافى	t a ʕ aː f aː
تبرير	t a b r iː r
شركة	ʃ a r i k a
فرن	f u r n
وزنة	w a z n a
كراويا	k a r aː w i j aː
باطس	b aː tˤ u s
صحي	sˤ a ħ i j a
كرح	k i r ħ
حرقدة	ħ a r q a d a
رافعة	r aː f i ʕ a
خرس	x a r a s a
شمشم	ʃ a m ʃ a m a
باستا	b aː s t aː
جهادي	d͡ʒ i h aː d i j j
فانوس	f aː n uː s
رسداق	r u s d aː q
لبلاب	l a b l aː b
ارتباك	i r t i b aː k
مشنة	m i ʃ a n n a
كبش	k a b ʃ
بريطاني	b a r iː tˤ aː n i j j
نصراني	n a sˤ r aː n i j j
غزال	ɣ a z aː l
نحاس	n u ħ aː s
دفتر	d a f t a r
راود	r aː w a d a
فتخاء	f a t x aː ʔ
معدات	m u ʕ a d d aː t
فأر	f a ʔ r
قارة	q aː r a
علني	ʕ a l a n i j j
وقت	w a q a t
تصتم	t a sˤ a t t a m a
صندوق	sˤ a n d uː q
نموذج	n a m uː ð a d͡ʒ
تجاوزات	t a d͡ʒ aː w u z aː t
ارتعش	i r t a ʕ a ʃ a
سين	s iː n
ندوات	n a d a w aː t
فوتنج	f uː t a n a d͡ʒ
جبيز	d͡ʒ a b iː z
غضة	ɣ a dˤ dˤ a
انهمر	i n h a m a r a
مستعرب	m u s t a ʕ r i b
غارة	ɣ aː r a
وفاء	w a f aː ʔ
نقيض	n a q iː dˤ
ثلة	θ u l l a
شمالي	ʃ a m aː l i j j
حبالة	ħ i b aː l a
وقود	w a q uː d
بلاغة	b a l aː ɣ a
هول	h a w l
جريدة	d͡ʒ a r iː d a
معطس	m a ʕ tˤ i s
استفز	i s t a f a z z a
أنيسون	ʔ a n iː s uː n
مقذاف	m i q ð aː f
إبريز	ʔ i b r iː z
ديك	d iː k
مشرق	m a ʃ r i q
رطب	r a tˤ b
فاسد	f aː s i d
صمام	sˤ i m aː m
براعة	b a r aː ʕ a
مشاعر	m a ʃ aː ʕ i r
رفيق	r a f iː q
لجام	l i d͡ʒ aː m
فتوى	f a t w aː
جائز	d͡ʒ aː ʔ i z
قميحة	q a m iː ħ a
ابتلال	i b t i l aː l
بغتة	b a ɣ t a
عيد	ʕ a j j a d a
خوف	x a w f
مرارة	m a r aː r a
ذهن	ð i h n
هريرة	h u r a j r a h
عدالة	ʕ a d aː l a
وحل	w a ħ l
أغرى	ʔ a ɣ r aː
سلح	s a l a ħ a
أتى	ʔ a t aː
راسخت	r aː s u x t
رفائيل	r u f aː ʔ iː l
حبارى	ħ u b aː r aː
فوز	f a w z
إياك	ʔ i j j aː k a
الصومال	a sˤ sˤ uː m aː l
بنان	b a n aː n
مثال	m i θ aː l
عظيم	ʕ a ðˤ iː m
ألقى	ʔ a l q aː
مشعل	m a ʃ ʕ a l
دلل	d a l l a l a
نخشوش	n a x ʃ uː ʃ
سلام	s a l aː m
لاوس	l aː w s
خشاب	x a ʃ ʃ aː b
تقوى	t a q w aː
دراسي	d i r aː s i j j
أعتاب	ʔ a ʕ t aː b
أرومة	ʔ a r uː m a
طحال	tˤ i ħ aː l
ليلك	l a j l a k
رحيق	r a ħ iː q
مأدبة	m a ʔ d u b a
ملعون	m a l ʕ uː n
حافة	ħ aː f a
تنظيم	t a n ðˤ iː m
بربري	b a r b a r i j j
حاء	ħ aː ʔ
قائد	q aː ʔ i d
نضوج	n u dˤ uː d͡ʒ
يبروح	j a b r uː ħ
ثلاثون	θ a l aː θ uː n a
قصرية	q a sˤ r i j j a
بغاء	b i ɣ aː ʔ
خلفي	x a l f i j j
فشقار	f a ʃ q aː r
حمار	ħ a m m aː r
بركة	b a r a k a
دمدم	d a m d a m a
كوالا	k u w aː l aː
حيث	ħ a j θ u
محن	m i ħ a n
اكتنف	i k t a n a f a
موسم	m a w s i m
حنظلة	ħ a n ðˤ a l a
تواقف	t a w aː q a f a
أعجوبة	ʔ u ʕ d͡ʒ uː b a
مفروشات	m a f r uː ʃ aː t
مائت	m aː ʔ i t
تطبب	t a tˤ a b b a b a
شهدانق	ʃ a h d aː n a q
هندس	h a n d a s a
مرتعب	m u r t a ʕ i b
رهبانية	r a h b aː n i j j a
قداحة	q a d d aː ħ a
بدهي	b a d a h i j j
إمالة	ʔ i m aː l a
النيجر	a n n iː d͡ʒ a r
الآخرة	a l ʔ aː x i r a
أسماء	ʔ a s m aː ʔ
تيغار	t a j ɣ aː r
حبن	ħ a b a n
فرغة	f a r i ɣ a
حلال	ħ a l aː l
إذاعة	ʔ i ð aː ʕ a
مصحنة	m i sˤ ħ a n a
مجمد	m u d͡ʒ a m m a d
مقلق	m u q l i q
قشف	q a ʃ i f a
نعيم	n a ʕ iː m
كميت	k u m a j t
شامة	ʃ aː m a
جزدان	d͡ʒ i z d aː n
أزرق	ʔ a z r a q
تطوان	t a tˤ w aː n
تمرين	t a m r iː n
مضايف	m a dˤ aː j i f
فاض	f aː dˤ a
وراط	w i r aː tˤ
أرضي	ʔ a r dˤ i j j
معجون	m a ʕ d͡ʒ uː n
زكام	z u k aː m
ذمم	ð i m a m
بقر	b a q a r
غامق	ɣ aː m i q
استخبار	i s t i x b aː r
أعز	ʔ a ʕ a z z
نون	n a w w a n a
بحران	b u ħ r aː n
رائب	r aː ʔ i b
همزة	h a m z a
ذئب	ð i ʔ b
شيطان	ʃ a j tˤ aː n
هراوة	h i r aː w a
استثمار	i s t i θ m aː r
مطراني	m u tˤ r aː n i j j
قنطرة	q a n tˤ a r a
غيظ	ɣ a j ðˤ
راقص	r aː q a sˤ a
صأل	sˤ a ʔ a l a
شعير	ʃ a ʕ iː r
ملاحظة	m u l aː ħ a ðˤ a
ضال	dˤ aː l l
مجسم	m u d͡ʒ a s s a m
تضرر	t a dˤ a r r a r a
شوح	ʃ uː ħ
مناعة	m a n aː ʕ a
فصد	f a sˤ a d a
كبكب	k a b k a b a
إنما	ʔ i n n a m aː
سكران	s a k r aː n
آذريون	ʔ aː ð a r j uː n
طاجيكستان	tˤ aː d͡ʒ iː k i s t aː n
مغلوب	m a ɣ l uː b
زايلفون	z aː j l u f uː n
الغابون	a l ɣ aː b uː n
زفن	z a f a n a
مشقة	m a ʃ a q q a
مجري	m a d͡ʒ a r i j j
سنجاب	s i n d͡ʒ aː b
كلك	k a l a k
نساب	n a s s aː b
مطفأة	m i tˤ f a ʔ a
بنفسج	b a n a f s a d͡ʒ
نهب	n a h a b a
مليء	m a l iː ʔ
قلقطار	q a l q a tˤ aː r
حاشا	ħ aː ʃ aː
بروناي	b r uː n aː j
مرقد	m a r q a d
أتوم	ʔ a t uː m
فضول	f dˤ uː l
مثلجات	m u θ a l l a d͡ʒ aː t
نبهاء	n u b a h aː ʔ
بادية	b aː d i j a
مذاق	m a ð aː q
اعتاض	i ʕ t aː dˤ a
آيسلندا	ʔ aː j i s l a n d aː
صلعة	sˤ a l ʕ a
مشوي	m a ʃ w i j j
طرق	tˤ a r a q a
باضع	b aː dˤ i ʕ
سقلطوني	s i q i l l a tˤ uː n i j j
غلقة	ɣ a l q a
لهي	l a h i j a
شرسوف	ʃ u r s uː f
هوري	h uː r i j j
شاف	ʃ aː f a
تدليك	t a d l iː k
مهندس	m u h a n d i s
تايوان	t aː j w aː n
مثنان	m a θ n aː n
هبيد	h a b iː d
جشاء	d͡ʒ u ʃ aː ʔ
خلية	x a l i j j a
مراهق	m u r aː h i q
مدبر	m u d a b b i r
مدلجة	m i d l a d͡ʒ a
أسفر	ʔ a s f a r a
تضاد	t a dˤ aː d d a
بغداد	b a ɣ d aː d
استمر	i s t a m a r r a
عباء	ʕ a b aː ʔ
سرط	s a r a tˤ a
ناميبيا	n aː m iː b j aː
وغد	w a ɣ d
شحاذ	ʃ a ħ ħ aː ð
بسكرة	b i s k a r a
عباءة	ʕ a b aː ʔ a
هدهد	h a d h a d a
راقب	r aː q a b a
كازاخستان	k aː z aː x i s t aː n
بربخ	b a r b a x
محل	m a ħ a l l
انتقال	i n t i q aː l
مجازر	m a d͡ʒ aː z i r
شاكرة	ʃ aː k i r a
ذبول	ð u b uː l
تسكع	t a s a k k a ʕ a
مجادلة	m u d͡ʒ aː d a l a h
حلول	ħ u l uː l
مخالف	m u x aː l i f
انتماء	i n t i m aː ʔ
وجدة	w a d͡ʒ d a
تأوه	t a ʔ a w w a h a
أولى	ʔ a w l aː
السنغال	a s s i n i ɣ aː l
إنقاض	ʔ i n q aː dˤ
تقرح	t a q a r r a ħ a
تهالك	t a h aː l a k a
قثاء	q i θ θ aː ʔ
شلنبر	ʃ u l u n b a r
عمودي	ʕ a m uː d i j j
بيلادونا	b iː l aː d uː n aː
زراعي	z i r aː ʕ i j j
ذهب	ð a h a b
تمساح	t i m s aː ħ
تسلق	t a s a l l a q a
فرقاطة	f i r q aː tˤ a
عنيف	ʕ a n iː f
حلتيت	ħ a l t iː t
كابل	k aː b u l
صهيوني	sˤ a h j uː n i j j
أبد	ʔ a b a d
دمية	d u m j a
نانخواة	n aː n a x w aː h
شبوطة	ʃ a b b uː tˤ a
جاهز	d͡ʒ aː h i z
عبودية	ʕ u b uː d i j j a
زوم	z uː m
شليل	ʃ a l iː l
بعيد	b a ʕ iː d
عرعر	ʕ a r ʕ a r
مبارزة	m u b aː r a z a
دمقس	d i m a q s
سلباح	s i l b aː ħ
هذيان	h a ð a j aː n
تسعة	t i s ʕ a
روس	r a w w a s a
صيدلة	sˤ a j d a l a
تعسفي	t a ʕ a s s u f i j j
أصخر	ʔ a sˤ x a r a
أنضج	ʔ a n dˤ a d͡ʒ a
فصيل	f a sˤ iː l
عراك	ʕ i r aː k
كفاح	k i f aː ħ
توظيف	t a w ðˤ iː f
خاطئ	x aː tˤ i ʔ
استقتل	i s t a q t a l a
بوتان	b uː t aː n
جمانة	d͡ʒ u m aː n a
برق	b a r a q a
إبداعي	ʔ i b d aː ʕ i j j
تكعيب	t a k ʕ iː b
دونمة	d uː n m a
هدف	h a d a f
استحم	i s t a ħ a m m a
قوس	q a w i s a
ثاودسيوس	θ aː w u d u s i j uː s
هدى	h a d aː
أمس	ʔ a m a s s a
خنصور	x a n sˤ uː r
صدق	sˤ a d a q a
اليسع	a l j a s a ʕ
أمسك	ʔ a m s a k a
تهدد	t a h a d d a d a
مأزق	m a ʔ z i q
ميم	m iː m
جور	d͡ʒ a w r
مويزج	m a w iː z a d͡ʒ
غزير	ɣ a z iː r
سعي	s a ʕ j
مدغشقر	m a d a ɣ a ʃ q a r
نشادر	n u ʃ aː d i r
لكمة	l a k m a
بامية	b aː m i j a
تصغير	t a sˤ ɣ iː r
المرء	a l m a r ʔ
رهينة	r a h iː n a
أيقن	ʔ a j q a n a
مراوغة	m u r aː w a ɣ a
فراولة	f a r aː w i l a
استقل	i s t a q a l l a
أدهش	ʔ a d h a ʃ a
ثورة	θ a w r a
كمام	k i m aː m
ساوم	s aː w a m a
استجاب	i s t a d͡ʒ aː b a
أنفق	ʔ a n f a q a
أفسنتين	ʔ a f s i n t iː n
قرقع	q a r q a ʕ a
ريال	r i j aː l
سدر	s a d i r a
تلقاء	t i l q aː ʔ a
لبن	l a b a n
اختل	i x t a l l a
جنح	d͡ʒ u n ħ
مشعر	m a ʃ ʕ a r
بشرة	b a ʃ a r a
ثانوي	θ aː n a w i
فريق	f a r iː q
محرقة	m a ħ r a q a
شمشار	ʃ a m ʃ aː r
صحى	sˤ a ħ ħ aː
سقرلاط	s i q i r l aː tˤ
بهائي	b a h aː ʔ i j j
المكسيك	a l m a k s iː k
أكسد	ʔ a k s a d a
عنزروت	ʕ a n z a r uː t
موسكو	m uː s k uː
غباء	ɣ a b aː ʔ
طنطور	tˤ a n tˤ uː r
خيالي	x a j aː l i j j
تخفيض	t a x f iː dˤ
عصيب	ʕ a sˤ iː b
عمامة	ʕ i m aː m a
فدان	f a d d aː n
قطيع	q a tˤ iː ʕ
دند	d a n d
بواب	b a w w aː b
ماحق	m aː ħ i q
كلب	k a l b
منيرة	m u n iː r a
كاذب	k aː ð i b
كستبان	k u s t u b aː n
معنى	m a ʕ n aː
خباز	x a b b aː z
تذكرة	t a ð k i r a
باراغواي	b aː r aː ɣ u w aː j
حوول	ħ uː w i l a
المريخ	a l m i r r iː x
فيما	f iː m aː
عفيف	ʕ a f iː f
عجاوة	ʕ u d͡ʒ aː w a
ناسفة	n aː s i f a
أفاد	ʔ a f aː d a
جاورجيوس	d͡ʒ aː w u r d͡ʒ i j uː s
إربيان	ʔ i r b i j aː n
إندونيسي	ʔ i n d uː n iː s i j j
أبلس	ʔ a b l a s a
حجرة	ħ u d͡ʒ r a
انجراف	i n d͡ʒ i r aː f
إشغال	ʔ i ʃ ɣ aː l
قربان	q i r b aː n
أغماد	ʔ a ɣ m aː d
الخميس	a l x a m iː s
غفلة	ɣ a f l a
كادس	k aː d i s
خرزة	x u r z a
رحيل	r a ħ iː l
فجل	f a d͡ʒ a l
دقع	d a q i ʕ a
عاصف	ʕ aː sˤ i f
رغوة	r a ɣ w a
نسيم	n a s iː m
اتجه	i t t a d͡ʒ a h a
ينبوع	j a n b uː ʕ
عنكبوت	ʕ a n k a b uː t
إرادي	ʔ i r aː d i j j
باذنجان	b aː ð i n d͡ʒ aː n
مكدس	m u k a d d a s
اقتضى	i q t a dˤ aː
أتقن	ʔ a t q a n a
ركنية	r u k n i j j a
مريء	m a r iː ʔ
صقر	sˤ a q r
حديد	ħ a d iː d
سليلى	s u l a j l aː
عرزال	ʕ i r z aː l
تأسف	t a ʔ a s s a f a
قاطعة	q aː tˤ i ʕ a
باقة	b aː q a
إسكتلندي	ʔ i s k u t l a n d i j j
ترنيم	t a r n iː m
مملوك	m a m l uː k
سميذ	s a m iː ð
ثقة	θ i q a
أخت	ʔ u x t
سفارة	s i f aː r a
دهنج	d a h n a d͡ʒ
معروف	m a ʕ r uː f
رضوخ	r u dˤ uː x
أفغانستان	ʔ a f ɣ aː n i s t aː n
الآن	a l ʔ aː n a
جبان	d͡ʒ a b aː n
رمش	r a m a ʃ a
ذكاء	ð a k aː ʔ
ماعون	m aː ʕ uː n
عانس	ʕ aː n i s
مسعور	m a s ʕ uː r
مسن	m i s a n n
رزداق	r u z d aː q
نهار	n a h aː r
محرك	m u ħ a r r i k
أشرفي	ʔ a ʃ r a f i j j
أوضح	ʔ a w dˤ a ħ a
رفأ	r a f a ʔ a
أسس	ʔ a s s a s a
مشى	m a ʃ aː
مسرحي	m a s r a ħ i j j
أحيلى	ʔ u ħ a j l aː
أكسح	ʔ a k s a ħ
بين	b a j n a
نهق	n a h a q a
ندم	n a d a m
خراء	x i r aː ʔ
هرة	h i r r a h
قومية	q a w m i j j a
شهادة	ʃ a h aː d a
إحاطة	ʔ i ħ aː tˤ a
جميزة	d͡ʒ u m m a j z
ترمس	t i r m i s
فالوذق	f aː l uː ð a q
مشواة	m i ʃ w aː h
دافئ	d aː f i ʔ
ناهز	n aː h a z a
نرجيل	n a r d͡ʒ iː l
جثجاث	d͡ʒ a θ d͡ʒ aː θ
تعويذة	t a ʕ w iː ð a
توارى	t a w aː r aː
آخن	ʔ aː x a n
أنيون	ʔ a n j uː n
قعد	q a ʕ a d a
بعير	b a ʕ iː r
عابس	ʕ aː b i s
كانون	k aː n uː n
نعمة	n i ʕ m a
حكة	ħ i k k a
قيطون	q a j tˤ uː n
وديعة	w a d iː ʕ a
نعجة	n a ʕ d͡ʒ a
معجم	m u ʕ d͡ʒ a m
إزار	ʔ i z aː r
كناب	k i n aː b
راءى	r aː ʔ aː
تاء	t aː ʔ
سيكولوجي	s a j k uː l uː d͡ʒ i j j
فرضية	f a r a dˤ i j j a
خمسة	x a m s a
جلنار	d͡ʒ u l l a n aː r
أين	ʔ a j j a n a
مورد	m a w r i d
ذكر	ð a k a r
تلفت	t a l a f f a t a
ديسم	d a j s a m
فراطة	f u r aː tˤ a
صفيراء	sˤ u f a j r aː ʔ
آبيس	ʔ aː b iː s
بئسما	b i ʔ s a m aː
دستج	d a s t a d͡ʒ
مكان	m a k aː n
غمى	ɣ a m m aː
عران	ʕ i r aː n
طليعة	tˤ a l iː ʕ a
تنبول	t u m b uː l
أجار	ʔ a d͡ʒ aː r a
ثانية	θ aː n i j a
رعد	r a ʕ d
إصبع	ʔ i sˤ b a ʕ
كرفس	k a r a f s
متحد	m u t t a ħ i d
مرآة	m i r ʔ aː h
خطمي	x a tˤ m i j j
مداد	m i d aː d
مدة	m a d d a
تفرغ	t a f a r r a ɣ a
أنكر	ʔ a n k a r a
أزرع	ʔ a z r a ʕ a
فرهود	f u r h uː d
أنا	ʔ a n aː
ريباس	r iː b aː s
ختان	x i t aː n
بطارخ	b a tˤ aː r i x
قفاز	q u f aː z
دفيء	d a f iː ʔ
مقود	m i q w a d
صهريج	sˤ a h r iː d͡ʒ
لام	l aː m
دكتور	d u k t uː r
انكمش	i n k a m a ʃ a
شفة	ʃ a f a
قابل	q aː b a l a
أهيف	ʔ a h j a f
أنور	ʔ a n w a r
إكليل	ʔ i k l iː l
اختتم	i x t a t a m a
مسكوكة	m a s k uː k a
لواط	l i w aː tˤ
رائعة	r aː ʔ i ʕ a
مشترك	m u ʃ t a r a k
ضبط	dˤ a b a tˤ a
براشوت	b a r aː ʃ uː t
بحاح	b u ħ aː ħ
بؤر	b u ʔ a r
نمط	n a m a tˤ
التهاب	i l t i h aː b
سبب	s a b a b
السبت	a s s a b t
إشبينة	ʔ i ʃ b iː n a
إحسان	ʔ i ħ s aː n
يربوع	j a r b uː ʕ
اتهام	i t t i h aː m
أثث	ʔ a θ θ a θ a
اجتلى	i d͡ʒ t a l aː
صعوبة	sˤ u ʕ uː b a
ضمني	dˤ i m n i j j
شلال	ʃ a l l aː l
اتسع	i t t a s a ʕ a
مجرفة	m i d͡ʒ r a f a
ردع	r a d a ʕ a
فريسة	f a r iː s a
إبليز	ʔ i b l iː z
ملجأ	m a l d͡ʒ a ʔ
أدحوة	ʔ u d ħ u w w a
مقطعية	m a q tˤ a ʕ i j j a
سلطوي	s u l tˤ a w i j j
ولكن	w a l aː k i n
حمصيص	ħ a m a sˤ iː sˤ
استضاف	i s t a dˤ aː f a
حمل	ħ a m a l
ليلي	l a j l i j j
عسبق	ʕ a s b a q
رابط	r aː b i tˤ
إسماعيلي	ʔ i s m aː ʕ iː l i j j
مفاجأة	m u f aː d͡ʒ a ʔ a
بلاذر	b a l aː ð i r
جندبادستر	d͡ʒ u n d u b aː d a s t a r
عبيثران	ʕ a b a j θ a r aː n
حماق	ħ a m aː q
نهز	n a h a z a
تقوض	t a q a w w a dˤ a
خزامى	x u z aː m aː
مري	m u r iː
جدوى	d͡ʒ a d w aː
خرنق	x i r n i q
تربية	t a r b i j a
كزمازك	k a z m aː z a k
رسالة	r i s aː l a
مراكش	m u r r aː k u ʃ
نيابة	n i j aː b a
عجرفة	ʕ a d͡ʒ r a f a
قطة	q i tˤ tˤ a
أيقظ	ʔ a j q a ðˤ a
ضمير	dˤ a m iː r
مغاث	m u ɣ aː θ
قرفصاء	q u r f u sˤ aː ʔ
أعف	ʔ a ʕ a f f a
معمودية	m a ʕ m uː d i j j a
انشقاق	i n ʃ i q aː q
سعادة	s a ʕ aː d a
اصهب	i sˤ h a b b a
مبارز	m u b aː r a z
صبان	sˤ a b b aː n
جني	d͡ʒ i n n i j j
اكتحل	i k t a ħ a l a
ابرغش	i b r a ɣ a ʃ ʃ a
نسبوية	n i s b a w i j j a
سبلة	s a b l a
مسلم	m u s a l l a m
غلاية	ɣ a l l aː j a
لئلا	l i ʔ a l l aː
لادن	l aː d a n
درع	d a r r a ʕ a
هعخع	h u ʕ x u ʕ
أوريغون	ʔ uː r iː ɣ uː n
بواليع	b a w aː l iː ʕ
قبائلي	q a b aː ʔ i l i j j
أبريل	ʔ a b r iː l
شاهدانج	ʃ aː h d aː n a d͡ʒ
دستة	d a s t a
خلنجان	x a l a n d͡ʒ aː n
رواصيل	r a w aː sˤ iː l
أفلاطون	ʔ a f l aː tˤ uː n
شريعة	ʃ a r iː ʕ a
خالد	x aː l i d
حسنا	ħ a s s a n n aː
فاثور	f aː θ uː r
احتاز	i ħ t aː z a
فاوض	f aː w a dˤ a
رمم	r a m m a m a
فلفل	f i l f i l
غريب	ɣ a r iː b
علم	ʕ a l a m
طرخون	tˤ a r x uː n
سنبلة	s u n b u l a
دنو	d u n u w w
فيجن	f a j d͡ʒ a n
شاور	ʃ aː w a r a
الذي	a l l a ð iː
جبناء	d͡ʒ u b a n aː ʔ
تعلة	t a ʕ i l l a
منفاخ	m i n f aː x
مقدونس	m a q d uː n i s
شارع	ʃ aː r i ʕ
لاذ	l aː ð a
فسح	f a s a ħ a
مخلص	m a x l a sˤ
تذاكى	t a ð aː k aː
أنف	ʔ a n f
حضرموت	ħ a dˤ r a m a w t
دونم	d uː n u m
خوي	x a w i j a
زغلول	z u ɣ l uː l
صقيع	sˤ a q iː ʕ
قاوق	q aː w u q
باصور	b aː sˤ uː r
مغنم	m a ɣ n a m
مبالغة	m u b aː l a ɣ a
سلاف	s u l aː f
صدرية	sˤ a d r i j j a
ببنودة	b a b n uː d a
فوار	f a w w aː r
ممن	m i m m a n
جبت	d͡ʒ i b t
مقاعد	m a q aː ʕ i d
ظهر	ðˤ a h a r a
معقود	m a ʕ q uː d
هازباء	h aː z i b aː ʔ
مزدهر	m u z d a h i r
رياضة	r i j aː dˤ a
دفلى	d i f l aː
إناء	ʔ i n aː ʔ
قتل	q a t a l a
جنائي	d͡ʒ i n aː ʔ i j j
أزعج	ʔ a z ʕ a d͡ʒ a
عتيق	ʕ a t iː q
بقي	b a q i j a
كون	k a w n
افترى	i f t a r aː
حفيدة	ħ a f iː d a
حنبلي	ħ a n b a l i j j
تبغ	t a b ɣ
اقتصد	i q t a sˤ a d a
باكستاني	b aː k i s t aː n i j j
إلحاق	ʔ i l ħ aː q
مميثا	m a m m iː θ aː
صنارة	sˤ i n aː r a
تمهل	t a m a h h a l a
خولنجان	x a w l a n d͡ʒ aː n
ماذا	m aː ð aː
نارجيل	n aː r a d͡ʒ iː l
وسع	w a s i ʕ a
أبدية	ʔ a b a d i j j a
لعبة	l a ʕ b a
سراق	s a r r aː q
رغيفة	r a ɣ iː f a
عمرة	ʕ u m r a
مسلسل	m u s a l s a l
مخافة	m a x aː f a
صحل	sˤ a ħ i l a
زينب	z a j n a b
مرجان	m a r d͡ʒ aː n
ركع	r a k a ʕ a
جندية	d͡ʒ u n d i j j a
مفصل	m u f a sˤ sˤ a l
حوض	ħ a w dˤ
ماهاراجا	m aː h aː r aː d͡ʒ aː
شجا	ʃ a d͡ʒ aː
جنسية	d͡ʒ i n s i j j a
أهدى	ʔ a h d aː
تدريس	t a d r iː s
شاذ	ʃ aː ð ð
مصفاة	m i sˤ f aː h
كفى	k a f aː
غسالة	ɣ a s s aː l a
صورة	sˤ uː r a
تجربة	t a d͡ʒ r i b a
أخدر	ʔ a x d a r
ضفدع	dˤ a f d a ʕ
بصير	b a sˤ iː r
صاع	sˤ aː ʕ
يافوخ	j aː f uː x
أخمص	ʔ a x m u sˤ
علة	ʕ i l l a
بنجنكشت	b a n d͡ʒ a n k u ʃ t
مصبنة	m a sˤ b a n a
سار	s aː r r
أنتن	ʔ a n t u n n a
ضمران	dˤ a m r aː n
مكسور	m a k s uː r
أطباء	ʔ a tˤ i b b aː ʔ
اكترى	i k t a r aː
إلكترونيات	ʔ i l i k t r uː n i j j aː t
زنبوع	z a n b uː ʕ
منتصف	m u n t a sˤ a f
بوذا	b uː ð aː
سنط	s a n tˤ
مجرد	m u d͡ʒ a r r a d
مخاض	m a x aː dˤ
سقم	s a q a m
قبج	q a b a d͡ʒ
فكاهي	f u k aː h i j j
منهج	m a n h a d͡ʒ
بشنونة	b a ʃ n uː n a
درزن	d a r z a n
علقة	ʕ a l a q a
يحيى	j a ħ j aː
ماه	m aː h a
شمال	ʃ a m aː l
بنفسجي	b a n a f s a d͡ʒ i j j
أصف	ʔ a sˤ a f
سقراط	s u q r aː tˤ
سعار	s u ʕ aː r
اصطخم	i sˤ tˤ a x a m a
تراجيديا	t r aː d͡ʒ iː d j aː
قدوم	q a d d uː m
فضح	f a dˤ a ħ a
فرسخ	f a r s a x
فضة	f i dˤ dˤ a
بورصة	b uː r sˤ a
حطم	ħ a tˤ a m a
بلاهة	b a l aː h a
غافت	ɣ aː f a t
أكاذيب	ʔ a k aː ð iː b
مغيم	m u ɣ a j j i m
مكسرات	m u k a s s a r aː t
نشرة	n a ʃ r a
جدار	d͡ʒ i d aː r
ريشة	r iː ʃ a
أسطورة	ʔ u s tˤ uː r a
مرددوش	m a r d a d uː ʃ
قنص	q a n a sˤ a
تصالح	t a sˤ aː l a ħ a
صبحة	sˤ a b ħ a
أنطاكية	ʔ a n tˤ aː k i j a
جماد	d͡ʒ a m aː d
مجاور	m u d͡ʒ aː w i r
رائع	r aː ʔ i ʕ
عقال	ʕ i q aː l
بيطرة	b a j tˤ a r a
شاي	ʃ aː j
طائفة	tˤ aː ʔ i f a
وعدة	w a ʕ d a
كافتيريا	k aː f i t iː r i j aː
وجيز	w a d͡ʒ iː z
طعام	tˤ a ʕ aː m
عجيب	ʕ a d͡ʒ iː b
أمان	ʔ a m aː n
أطرش	ʔ a tˤ r a ʃ
تألق	t a ʔ a l l a q a
تقدس	t a q a d d a s a
مزاد	m a z aː d
هارون	h aː r uː n
تفاف	t i f aː f
تناعس	t a n aː ʕ a s a
لينينية	l iː n iː n i j j a
معاء	m i ʕ aː ʔ
مستقبل	m u s t a q b a l
ثرب	θ a r b
أزب	ʔ a z a b b
فتوش	f a t t uː ʃ
زائر	z aː ʔ i r
نزهة	n u z h a
نيوزيلاندا	n i j uː z iː l aː n d aː
غلا	ɣ a l aː
طباق	tˤ a b b aː q
احتكار	i ħ t i k aː r
بأس	b a ʔ s
أحسن	ʔ a ħ s a n
قاجوج	q aː d͡ʒ uː d͡ʒ
حرج	ħ a r i d͡ʒ a
فتاة	f a t aː h
شخص	ʃ a x a sˤ a
مكتب	m a k t a b
لبأ	l i b a ʔ
مماس	m u m aː s s
واجهة	w aː d͡ʒ i h a
رغف	r u ɣ u f
هلسنكي	h i l s i n k iː
اتعاظ	i t t i ʕ aː ðˤ
يابس	j aː b i s
شمندورة	ʃ a m a n d uː r a
جبانات	d͡ʒ a b aː n aː t
صفن	sˤ a f a n
اجتاز	i d͡ʒ t aː z a
الكويت	a l k u w a j t
جين	d͡ʒ iː n
أوقد	ʔ a w q a d a
مماثلة	m u m aː θ a l a
وجنة	w a d͡ʒ n a
مفرد	m u f r a d
قلقاس	q u l q aː s
حيثيات	ħ a j θ i j j aː t
