könyvecske	k ø ɲ v ɛ t͡ʃ k ɛ
oltalmatok	o l t ɒ l m ɒ t o k
tanúsítvány	t ɒ n uː ʃ iː t v aː ɲ
felülír	f ɛ l y l iː r
rézért	r eː z eː r t
szünetben	s y n ɛ d b ɛ n
felszínén	f ɛ l s iː n eː n
tapasztalata	t ɒ p ɒ s t ɒ l ɒ t ɒ
legszociálisabb	l ɛ k s o t͡s i j aː l i ʃ ɒ bː
Zala	z ɒ l ɒ
ölts	ø l t͡ʃ
somok	ʃ o m o k
szélesség	s eː l ɛ ʃː eː ɡ
kabala	k ɒ b ɒ l ɒ
fejeid	f ɛ j ɛ j i d
toboroz	t o b o r o z
bombarobbanás	b o m b ɒ r o bː ɒ n aː ʃ
legrokonszenvesebb	l ɛ ɡ r o k o n s ɛ ɱ v ɛ ʃ ɛ bː
talpak	t ɒ l p ɒ k
övének	ø v eː n ɛ k
távokon	t aː v o k o n
füröszt	f y r ø s t
létszámú	l eː t s aː m uː
papucsaid	p ɒ p u t͡ʃ ɒ j i d
költségtervek	k ø l t͡ʃ eː k t ɛ r v ɛ k
énekről	eː n ɛ k r øː l
ruténium	r u t eː n i j u m
csoportos	t͡ʃ o p o r t o ʃ
fölhagy	f ø l ɦ ɒ ɟ
véts	v eː t͡ʃː
marokkóiak	m ɒ r o kː oː j i j ɒ k
héten	h eː t ɛ n
vájdling	v aː j d l i ŋ ɡ
egyszerűsíthető	ɛ c s ɛ r yː ʃ iː t h ɛ t øː
bocsátanának	b o t͡ʃ aː t ɒ n aː n ɒ k
szangvinikus	s ɒ ŋ ɡ v i n i k u ʃ
speciálisabb	ʃ p ɛ t͡s i j aː l i ʃ ɒ bː
bátorságotok	b aː t o r ʃ aː ɡ o t o k
éter	eː t ɛ r
Balogh	b ɒ l o ɡ
hajkeféi	h ɒ j k ɛ f eː j i
abakusza	ɒ b ɒ k u s ɒ
szita	s i t ɒ
ingázik	i ŋ ɡ aː z i k
tartós	t ɒ r t oː ʃ
kérje	k eː r j ɛ
hirdet	h i r d ɛ t
nyugalmú	ɲ u ɡ ɒ l m uː
lógsz	l oː k s
ágyneműk	aː ɟ n ɛ m yː k
tealevél	t ɛ ɒ l ɛ v eː l
óvónő	o v oː n øː
bélyeggyűjtések	b eː j ɛ ɡ ɟ yː j t eː ʃ ɛ k
tananyag	t ɒ n ɒ ɲ ɒ ɡ
ciklámen	t͡s i k l aː m ɛ n
kiússza	k i j uː sː ɒ
legérintetlenebb	l ɛ ɡ eː r i n t ɛ t l ɛ n ɛ bː
énbennem	eː m b ɛ nː ɛ m
tudomások	t u d o m aː ʃ o k
hatóságok	h ɒ t oː ʃ aː ɡ o k
zsugoribb	ʒ u ɡ o r i bː
hazafiasan	h ɒ z ɒ f i j ɒ ʃ ɒ n
zsebbe	ʒ ɛ bː ɛ
avarom	ɒ v ɒ r o m
késedelme	k eː ʃ ɛ d ɛ l m ɛ
bocsátanánk	b o t͡ʃ aː t ɒ n aː ŋ k
babapiskóta	b ɒ b ɒ p i ʃ k oː t ɒ
találkozók	t ɒ l aː l k o z oː k
telepítési	t ɛ l ɛ p iː t eː ʃ i
szókapcsolatok	s oː k ɒ p t͡ʃ o l ɒ t o k
hóbagoly	h oː b ɒ ɡ o j
tűzeset	t yː z ɛ ʃ ɛ t
rendelkeznek	r ɛ n d ɛ l k ɛ z n ɛ k
százalékának	s aː z ɒ l eː k aː n ɒ k
passzív	p ɒ sː iː v
haris	h ɒ r i ʃ
treffek	t r ɛ fː ɛ k
házatokat	h aː z ɒ t o k ɒ t
vigye	v i ɟ ɛ
hiányzóbb	h i j aː ɲ z oː bː
olvasol	o l v ɒ ʃ o l
legobjektívebb	l ɛ ɡ o b j ɛ k t iː v ɛ bː
belül	b ɛ l y l
pisztolyaid	p i s t o j ɒ j i d
rögtön	r ø k t ø n
jégszemek	j eː k s ɛ m ɛ k
nebáncsvirág	n ɛ b aː n t͡ʃ v i r aː ɡ
termőföld	t ɛ r m øː f ø l d
céhhé	t͡s eː xː eː
szójaszósz	s oː j ɒ s oː s
menyek	m ɛ ɲ ɛ k
sávvá	ʃ aː vː aː
Földön	f ø l d ø n
partnert	p ɒ r t n ɛ r t
rendelések	r ɛ n d ɛ l eː ʃ ɛ k
hangos	h ɒ ŋ ɡ o ʃ
legsértődékenyebb	l ɛ k ʃ eː r t øː d eː k ɛ ɲ ɛ bː
szereplők	s ɛ r ɛ p l øː k
kötvények	k ø t v eː ɲ ɛ k
paleontológia	p ɒ l ɛ o n t o l oː ɡ i j ɒ
alanyesetté	ɒ l ɒ ɲ ɛ ʃ ɛ tː eː
cédrusfán	t͡s eː d r u ʃ f aː n
technikával	t ɛ x n i k aː v ɒ l
áttörés	aː tː ø r eː ʃ
ciklus	t͡s i k l u ʃ
hadászat	h ɒ d aː s ɒ t
listán	l i ʃ t aː n
értenéd	eː r t ɛ n eː d
innovatívabb	i nː o v ɒ t iː v ɒ bː
mernek	m ɛ r n ɛ k
ostyákon	o ʃ c aː k o n
fogdák	f o ɡ d aː k
apátnő	ɒ p aː t n øː
engedi	ɛ ŋ ɡ ɛ d i
cári	t͡s aː r i
táplálkozik	t aː p l aː l k o z i k
uralkodók	u r ɒ l k o d oː k
fülkagylók	f y l k ɒ ɟ l oː k
elöljárós	ɛ l ø jː aː r oː ʃ
sétál	ʃ eː t aː l
agglomerációk	ɒ ɡ l o m ɛ r aː t͡s i j oː k
darun	d ɒ r u n
szoci	s o t͡s i
manipulációk	m ɒ n i p u l aː t͡s i j oː k
tali	t ɒ l i
lámpaernyők	l aː m p ɒ ɛ r ɲ øː k
csodabogár	t͡ʃ o d ɒ b o ɡ aː r
háziasszony	h aː z i j ɒ sː o ɲ
íjak	iː j ɒ k
alanyeset	ɒ l ɒ ɲ ɛ ʃ ɛ t
pezsgőbb	p ɛ ʒ ɡ øː bː
rendezői	r ɛ n d ɛ z øː j i
eredmények	ɛ r ɛ d m eː ɲ ɛ k
nevelek	n ɛ v ɛ l ɛ k
hetvenegy	h ɛ t v ɛ n ɛ ɟː
almaid	ɒ l m ɒ j i d
búsabb	b uː ʃ ɒ bː
szégyenl	s eː ɟ ɛ n l
vektorok	v ɛ k t o r o k
bálványimádás	b aː l v aː ɲ i m aː d aː ʃ
válófélben	v aː l oː f eː l b ɛ n
szerető	s ɛ r ɛ t øː
legborúsabb	l ɛ ɡ b o r uː ʃ ɒ bː
értük	eː r t y k
fokoz	f o k o z
vetemény	v ɛ t ɛ m eː ɲ
kibeszéli	k i b ɛ s eː l i
hagyjad	h ɒ ɟː ɒ d
százhuszonegy	s aː s h u s o n ɛ ɟː
szövetkezet	s ø v ɛ t k ɛ z ɛ t
kamilla	k ɒ m i lː ɒ
kertésze	k ɛ r t eː s ɛ
zsinór	ʒ i n oː r
fakírok	f ɒ k iː r o k
termény	t ɛ r m eː ɲ
leglényegesebb	l ɛ ɡ l eː ɲ ɛ ɡ ɛ ʃ ɛ bː
háztűzre	h aː s t yː z r ɛ
előírásai	ɛ l øː j iː r aː ʃ ɒ j i
fizikailag	f i z i k ɒ j i l ɒ ɡ
legalkalmasabb	l ɛ ɡ ɒ l k ɒ l m ɒ ʃ ɒ bː
nagyszámú	n ɒ c s aː m uː
nyugdíjkorhatár	ɲ u ɡ d iː j k o r ɦ ɒ t aː r
sorsuk	ʃ o r ʃ u k
faragás	f ɒ r ɒ ɡ aː ʃ
tartóztat	t ɒ r t oː s t ɒ t
arzének	ɒ r z eː n ɛ k
őmögöttük	øː m ø ɡ ø tː y k
öntöz	ø n t ø z
adoptálások	ɒ d o p t aː l aː ʃ o k
mellékfolyó	m ɛ lː eː k f o j oː
alanyesetekké	ɒ l ɒ ɲ ɛ ʃ ɛ t ɛ kː eː
adóink	ɒ d oː j i ŋ k
emotikon	ɛ m o t i k o n
dicséretként	d i t͡ʃ eː r ɛ t k eː n t
menedzserek	m ɛ n ɛ d͡ʒː ɛ r ɛ k
téveszméje	t eː v ɛ s m eː j ɛ
uncsitesó	u n t͡ʃ i t ɛ ʃ oː
őssejtek	øː ʃː ɛ j t ɛ k
abdominálisan	ɒ b d o m i n aː l i ʃ ɒ n
másrészt	m aː ʃ r eː s t
lettekért	l ɛ tː ɛ k eː r t
távon	t aː v o n
Tokaj	t o k ɒ j
infravörös	i ɱ f r ɒ v ø r ø ʃ
vertem	v ɛ r t ɛ m
nyilvánul	ɲ i l v aː n u l
gépeket	ɡ eː p ɛ k ɛ t
jussak	j u ʃː ɒ k
mindenáron	m i n d ɛ n aː r o n
petrezselyem	p ɛ t r ɛ ʒ ɛ j ɛ m
cserél	t͡ʃ ɛ r eː l
termeik	t ɛ r m ɛ j i k
gazdáitok	ɡ ɒ z d aː j i t o k
mellkasi	m ɛ l k ɒ ʃ i
heten	h ɛ t ɛ n
lapockacsontok	l ɒ p o t͡s k ɒ t͡ʃ o n t o k
tenned	t ɛ nː ɛ d
Sárvár	ʃ aː r v aː r
rivalizál	r i v ɒ l i z aː l
Drégelypalánk	d r eː ɡ ɛ j p ɒ l aː ŋ k
somot	ʃ o m o t
tévhitben	t eː f h i d b ɛ n
tisztáz	t i s t aː z
tarthatatlan	t ɒ r t h ɒ t ɒ t l ɒ n
visszafogott	v i sː ɒ f o ɡ o tː
ritkábban	r i t k aː bː ɒ n
dúskeblű	d uː ʃ k ɛ b l yː
összeütközés	ø sː ɛ y t k ø z eː ʃ
malmok	m ɒ l m o k
Zselyke	ʒ ɛ j k ɛ
szellem	s ɛ lː ɛ m
pleonazmus	p l ɛ o n ɒ z m u ʃ
dúsítások	d uː ʃ iː t aː ʃ o k
hajcsavaró	h ɒ j t͡ʃ ɒ v ɒ r oː
nagyvonalú	n ɒ ɟ v o n ɒ l uː
lábközépcsont	l aː p k ø z eː p t͡ʃ o n t
esőerdő	ɛ ʃ øː ɛ r d øː
bőrrel	b øː rː ɛ l
nagytól	n ɒ c t oː l
negyvennyolcadik	n ɛ ɟ v ɛ ɲː o l t͡s ɒ d i k
adományokért	ɒ d o m aː ɲ o k eː r t
széle	s eː l ɛ
alkotóbb	ɒ l k o t oː bː
fásult	f aː ʃ u l t
Kurszk	k u r s k
lábnál	l aː b n aː l
adótól	ɒ d oː t oː l
hazudni	h ɒ z u d n i
nyelvhez	ɲ ɛ l f h ɛ z
egyetem	ɛ ɟ ɛ t ɛ m
ködlámpák	k ø d l aː m p aː k
szűrők	s yː r øː k
legkérdésesebb	l ɛ kː eː r d eː ʃ ɛ ʃ ɛ bː
kapcsolódó	k ɒ p t͡ʃ o l oː d oː
professzorokra	p r o f ɛ sː o r o k r ɒ
cimbalmosok	t͡s i m b ɒ l m o ʃ o k
csendéletek	t͡ʃ ɛ n d eː l ɛ t ɛ k
ateizmusok	ɒ t ɛ j i z m u ʃ o k
kréta	k r eː t ɒ
szeretne	s ɛ r ɛ t n ɛ
írandó	iː r ɒ n d oː
hátsóbb	h aː t ʃ oː bː
csömör	t͡ʃ ø m ø r
elefántok	ɛ l ɛ f aː n t o k
eszerint	ɛ s ɛ r i n t
nyelvekhez	ɲ ɛ l v ɛ k h ɛ z
nevű	n ɛ v yː
fejléc	f ɛ j l eː t͡s
fényképezte	f eː ɲ k eː p ɛ s t ɛ
posztgraduális	p o z d ɡ r ɒ d u aː l i ʃ
becsíp	b ɛ t͡ʃ iː p
virslik	v i r ʃ l i k
legfogékonyabban	l ɛ k f o ɡ eː k o ɲ ɒ bː ɒ n
l	l
à	aː
huszadik	h u s ɒ d i k
palotámra	p ɒ l o t aː m r ɒ
izmot	i z m o t
isim	i ʃ i m
tapasztalatot	t ɒ p ɒ s t ɒ l ɒ t o t
bárókisasszonyok	b aː r oː k i ʃ ɒ sː o ɲ o k
hétje	h eː cː ɛ
legkellemetlenebb	l ɛ kː ɛ lː ɛ m ɛ t l ɛ n ɛ bː
katedrális	k ɒ t ɛ d r aː l i ʃ
alanyokká	ɒ l ɒ ɲ o kː aː
rece	r ɛ t͡s ɛ
bárányfelhők	b aː r aː ɲ f ɛ l ɦ øː k
termények	t ɛ r m eː ɲ ɛ k
egyfelé	ɛ c f ɛ l eː
rögösebb	r ø ɡ ø ʃ ɛ bː
fönt	f ø n t
vakság	v ɒ k ʃ aː ɡ
dicséretig	d i t͡ʃ eː r ɛ t i ɡ
tanfolyamok	t ɒ ɱ f o j ɒ m o k
bűz	b yː z
legérdeklődőbb	l ɛ ɡ eː r d ɛ k l øː d øː bː
ostábla	o ʃ t aː b l ɒ
bejárat	b ɛ j aː r ɒ t
méretek	m eː r ɛ t ɛ k
holttér	h o l t eː r
gesztus	ɡ ɛ s t u ʃ
audienciák	ɒ u d i j ɛ n t͡s i j aː k
bankkal	b ɒ ŋ k ɒ l
laposabb	l ɒ p o ʃ ɒ bː
valamikre	v ɒ l ɒ m i k r ɛ
unnák	u nː aː k
ajtókká	ɒ j t oː kː aː
termodinamika	t ɛ r m o d i n ɒ m i k ɒ
hajhab	h ɒ j ɦ ɒ b
tamáskodik	t ɒ m aː ʃ k o d i k
dicséretek	d i t͡ʃ eː r ɛ t ɛ k
programja	p r o ɡ r ɒ m j ɒ
barlangkutatók	b ɒ r l ɒ ŋ k u t ɒ t oː k
orozhat	o r o s h ɒ t
ajándékokon	ɒ j aː n d eː k o k o n
fenomén	f ɛ n o m eː n
győzelemben	ɟ øː z ɛ l ɛ m b ɛ n
pocsolya	p o t͡ʃ o j ɒ
szökések	s ø k eː ʃ ɛ k
menyétek	m ɛ ɲ eː t ɛ k
adatai	ɒ d ɒ t ɒ j i
vés	v eː ʃ
munkaasztal	m u ŋ k ɒ ɒ s t ɒ l
bennünket	b ɛ nː y ŋ k ɛ t
kuli	k u l i
kattints	k ɒ tː i n t͡ʃ
tárgyilagosság	t aː r ɟ i l ɒ ɡ o ʃː aː ɡ
vitatottabb	v i t ɒ t o tː ɒ bː
önöktől	ø n ø k t øː l
legbetyárosabb	l ɛ ɡ b ɛ c aː r o ʃ ɒ bː
lefátyoloz	l ɛ f aː c o l o z
betűtalp	b ɛ t yː t ɒ l p
hangsúlyt	h ɒ ŋ k ʃ uː j t
forintos	f o r i n t o ʃ
harapnivaló	h ɒ r ɒ p n i v ɒ l oː
nagyobbat	n ɒ ɟ o bː ɒ t
igyátok	i ɟ aː t o k
többekkel	t ø bː ɛ kː ɛ l
legpaprikásabb	l ɛ k p ɒ p r i k aː ʃ ɒ bː
koholmány	k o h o l m aː ɲ
döntőbe	d ø n t øː b ɛ
ütleg	y t l ɛ ɡ
halmazaim	h ɒ l m ɒ z ɒ j i m
Kiskunhalas	k i ʃ k u n ɦ ɒ l ɒ ʃ
argonod	ɒ r ɡ o n o d
kontextusok	k o n t ɛ k s t u ʃ o k
húznunk	h uː z n u ŋ k
tanulnia	t ɒ n u l n i j ɒ
legóriásibb	l ɛ ɡ oː r i j aː ʃ i bː
fen	f ɛ n
vezetőnek	v ɛ z ɛ t øː n ɛ k
legtragikusabb	l ɛ k t r ɒ ɡ i k u ʃ ɒ bː
padlóval	p ɒ d l oː v ɒ l
látnom	l aː t n o m
milyennek	m i j ɛ nː ɛ k
nyitottátok	ɲ i t o tː aː t o k
érdekel	eː r d ɛ k ɛ l
arisztokrata	ɒ r i s t o k r ɒ t ɒ
legkönnyebben	l ɛ kː ø ɲː ɛ bː ɛ n
hasszium	h ɒ sː i j u m
tréningruha	t r eː n i ŋ ɡ r u ɦ ɒ
zöldesebb	z ø l d ɛ ʃ ɛ bː
legcsúszósabb	l ɛ k t͡ʃ uː s oː ʃ ɒ bː
vízpartok	v iː s p ɒ r t o k
dalnokuk	d ɒ l n o k u k
zsorzsett	ʒ o r ʒ ɛ tː
számítógépközpontok	s aː m iː t oː ɡ eː p k ø s p o n t o k
apával	ɒ p aː v ɒ l
innunk	i nː u ŋ k
osztrák	o s t r aː k
sötétben	ʃ ø t eː d b ɛ n
tál	t aː l
Kalocsa	k ɒ l o t͡ʃ ɒ
remek	r ɛ m ɛ k
álmom	aː l m o m
varázslások	v ɒ r aː ʒ l aː ʃ o k
alanyokba	ɒ l ɒ ɲ o ɡ b ɒ
világban	v i l aː ɡ b ɒ n
Bella	b ɛ lː ɒ
tfilin	t f i l i n
alapfokunk	ɒ l ɒ p f o k u ŋ k
átlagosnál	aː t l ɒ ɡ o ʃ n aː l
motorkerékpár	m o t o r k ɛ r eː k p aː r
takarón	t ɒ k ɒ r oː n
szerkezeti	s ɛ r k ɛ z ɛ t i
kenyérbolt	k ɛ ɲ eː r b o l t
bevásárlókocsi	b ɛ v aː ʃ aː r l oː k o t͡ʃ i
elsőbbségek	ɛ l ʃ øː p ʃ eː ɡ ɛ k
keresztapa	k ɛ r ɛ s t ɒ p ɒ
mintája	m i n t aː j ɒ
kasba	k ɒ ʒ b ɒ
szpeleológus	s p ɛ l ɛ o l oː ɡ u ʃ
teelőled	t ɛ ɛ l øː l ɛ d
megyékig	m ɛ ɟ eː k i ɡ
közé	k ø z eː
egyetemes	ɛ ɟ ɛ t ɛ m ɛ ʃ
színvonalas	s iː ɱ v o n ɒ l ɒ ʃ
hömpölyög	h ø m p ø j ø ɡ
félsz	f eː l s
foglyunk	f o ɡ j u ŋ k
megdöbben	m ɛ ɡ d ø bː ɛ n
figyelmekért	f i ɟ ɛ l m ɛ k eː r t
koromban	k o r o m b ɒ n
világuk	v i l aː ɡ u k
diófájuk	d i j oː f aː j u k
halait	h ɒ l ɒ j i t
Müller	m y lː ɛ r
alaktalan	ɒ l ɒ k t ɒ l ɒ n
leglágyabban	l ɛ ɡ l aː ɟ ɒ bː ɒ n
zenéim	z ɛ n eː j i m
nemi	n ɛ m i
alakod	ɒ l ɒ k o d
étkezőasztal	eː t k ɛ z øː ɒ s t ɒ l
vacka	v ɒ t͡s k ɒ
húr	h uː r
neveltétek	n ɛ v ɛ l t eː t ɛ k
költők	k ø l t øː k
ficsúr	f i t͡ʃ uː r
Luxemburg	l u k s ɛ m b u r ɡ
döntöttük	d ø n t ø tː y k
akkordból	ɒ kː o r d b oː l
apaibb	ɒ p ɒ j i bː
tsak	t͡ʃ ɒ k
ducit	d u t͡s i t
hajlandóbb	h ɒ j l ɒ n d oː bː
esetrag	ɛ ʃ ɛ t r ɒ ɡ
mestereim	m ɛ ʃ t ɛ r ɛ j i m
általatok	aː l t ɒ l ɒ t o k
növekedési	n ø v ɛ k ɛ d eː ʃ i
ívás	iː v aː ʃ
meszek	m ɛ s ɛ k
ivott	i v o tː
aliázik	ɒ l i j aː z i k
kellessenek	k ɛ lː ɛ ʃː ɛ n ɛ k
ötszázas	ø t͡sː aː z ɒ ʃ
fájlt	f aː j l t
manóba	m ɒ n oː b ɒ
prevención	p r ɛ v ɛ n t͡s i j oː n
bankjaik	b ɒ ŋ k j ɒ j i k
rendezései	r ɛ n d ɛ z eː ʃ ɛ j i
tárak	t aː r ɒ k
alakoknál	ɒ l ɒ k o k n aː l
főzök	f øː z ø k
Nap	n ɒ p
falnád	f ɒ l n aː d
tré	t r eː
problémáidra	p r o b l eː m aː j i d r ɒ
váltsatok	v aː l t͡ʃ ɒ t o k
kiválóan	k i v aː l oː ɒ n
emeletes	ɛ m ɛ l ɛ t ɛ ʃ
narancsfák	n ɒ r ɒ n t͡ʃ f aː k
feltüntetésével	f ɛ l t y n t ɛ t eː ʃ eː v ɛ l
plazma	p l ɒ z m ɒ
nyakig	ɲ ɒ k i ɡ
elválaszt	ɛ l v aː l ɒ s t
forral	f o rː ɒ l
elégedetlen	ɛ l eː ɡ ɛ d ɛ t l ɛ n
vietnámiak	v i j ɛ t n aː m i j ɒ k
Bükkszék	b y k s eː k
töltsek	t ø l t͡ʃ ɛ k
szimpla	s i m p l ɒ
kérdésbe	k eː r d eː ʒ b ɛ
agancsokról	ɒ ɡ ɒ n t͡ʃ o k r oː l
növényegészségügyi	n ø v eː ɲ ɛ ɡ eː ʃː eː ɡ y ɟ i
ejtette	ɛ j t ɛ tː ɛ
sörbet	ʃ ø r b ɛ t
minőségek	m i n øː ʃ eː ɡ ɛ k
járőrök	j aː r øː r ø k
bravó	b r ɒ v oː
értenének	eː r t ɛ n eː n ɛ k
nővel	n øː v ɛ l
ilyesmiről	i j ɛ ʃ m i r øː l
homlokokhoz	h o m l o k o k h o z
nyugtatvány	ɲ u k t ɒ t v aː ɲ
népszerű	n eː p s ɛ r yː
másnaposság	m aː ʃ n ɒ p o ʃː aː ɡ
szentenciát	s ɛ n t ɛ n t͡s i j aː t
szánhat	s aː n ɦ ɒ t
hatunk	h ɒ t u ŋ k
halála	h ɒ l aː l ɒ
árvácska	aː r v aː t͡ʃ k ɒ
veti	v ɛ t i
atomfegyverek	ɒ t o ɱ f ɛ ɟ v ɛ r ɛ k
táblázatban	t aː b l aː z ɒ d b ɒ n
helyhez	h ɛ j h ɛ z
kölcsönös	k ø l t͡ʃ ø n ø ʃ
hintő	h i n t øː
fűszeres	f yː s ɛ r ɛ ʃ
készítések	k eː s iː t eː ʃ ɛ k
tutajok	t u t ɒ j o k
nyilatkozik	ɲ i l ɒ t k o z i k
kedvtelen	k ɛ t f t ɛ l ɛ n
keblünkön	k ɛ b l y ŋ k ø n
belügyminisztérium	b ɛ l y ɟ m i n i s t eː r i j u m
érzékenyít	eː r z eː k ɛ ɲ iː t
házasságtörések	h aː z ɒ ʃː aː k t ø r eː ʃ ɛ k
sorsában	ʃ o r ʃ aː b ɒ n
hagyd	h ɒ ɟ d
vörösbegyek	v ø r ø ʒ b ɛ ɟ ɛ k
gyorsúszás	ɟ o r ʃ uː s aː ʃ
mossam	m o ʃː ɒ m
panaszkönyvekért	p ɒ n ɒ s k ø ɲ v ɛ k eː r t
hármasugrás	h aː r m ɒ ʃ u ɡ r aː ʃ
bokátok	b o k aː t o k
ablakokba	ɒ b l ɒ k o ɡ b ɒ
tigrisekként	t i ɡ r i ʃ ɛ kː eː n t
élte	eː l t ɛ
dadák	d ɒ d aː k
keblű	k ɛ b l yː
bélfodrok	b eː l f o d r o k
kolosszális	k o l o sː aː l i ʃ
bőrig	b øː r i ɡ
leghűségesebb	l ɛ k h yː ʃ eː ɡ ɛ ʃ ɛ bː
magazinról	m ɒ ɡ ɒ z i n r oː l
kripta	k r i p t ɒ
andris	ɒ n d r i ʃ
csokoládényulak	t͡ʃ o k o l aː d eː ɲ u l ɒ k
mikrohullám	m i k r o ɦ u lː aː m
cintányérok	t͡s i n t aː ɲ eː r o k
saláta	ʃ ɒ l aː t ɒ
oldalamat	o l d ɒ l ɒ m ɒ t
gyűrt	ɟ yː r t
vesztés	v ɛ s t eː ʃ
kézbe	k eː z b ɛ
alanyig	ɒ l ɒ ɲ i ɡ
lelemény	l ɛ l ɛ m eː ɲ
dolmányért	d o l m aː ɲ eː r t
olyanokban	o j ɒ n o ɡ b ɒ n
hintó	h i n t oː
szervezetül	s ɛ r v ɛ z ɛ t y l
intézményeknek	i n t eː z m eː ɲ ɛ k n ɛ k
térképen	t eː r k eː p ɛ n
pajta	p ɒ j t ɒ
veszteségek	v ɛ s t ɛ ʃ eː ɡ ɛ k
ömleszt	ø m l ɛ s t
államközi	aː lː ɒ m k ø z i
bárhonnan	b aː r ɦ o nː ɒ n
átszökik	aː t s ø k i k
epék	ɛ p eː k
nekilát	n ɛ k i l aː t
nyomai	ɲ o m ɒ j i
enném	ɛ nː eː m
tükörsima	t y k ø r ʃ i m ɒ
mérnünk	m eː r n y ŋ k
szervezési	s ɛ r v ɛ z eː ʃ i
Salamon	ʃ ɒ l ɒ m o n
szökőárak	s ø k øː aː r ɒ k
Nagybánya	n ɒ ɟ b aː ɲ ɒ
hervad	h ɛ r v ɒ d
kusza	k u s ɒ
felépítés	f ɛ l eː p iː t eː ʃ
négyzetek	n eː ɟ z ɛ t ɛ k
javasolnálak	j ɒ v ɒ ʃ o l n aː l ɒ k
balzsamok	b ɒ l ʒ ɒ m o k
napsugár	n ɒ p ʃ u ɡ aː r
orvvadászat	o r v ɒ d aː s ɒ t
húználak	h uː z n aː l ɒ k
elpusztít	ɛ l p u s t iː t
olvasatlan	o l v ɒ ʃ ɒ t l ɒ n
lábak	l aː b ɒ k
összekenhet	ø sː ɛ k ɛ n ɦ ɛ t
emberekben	ɛ m b ɛ r ɛ ɡ b ɛ n
szőlőzsírok	s øː l øː ʒ iː r o k
vitát	v i t aː t
felejt	f ɛ l ɛ j t
Benjámin	b ɛ ɲː aː m i n
hadi	h ɒ d i
exon	ɛ k s o n
vennétek	v ɛ nː eː t ɛ k
felelősök	f ɛ l ɛ l øː ʃ ø k
zárjatok	z aː r j ɒ t o k
legzseniálisabb	l ɛ ɡ ʒ ɛ n i j aː l i ʃ ɒ bː
tudnivalók	t u d n i v ɒ l oː k
buta	b u t ɒ
merészség	m ɛ r eː ʃː eː ɡ
havazik	h ɒ v ɒ z i k
zúgok	z uː ɡ o k
kerülget	k ɛ r y l ɡ ɛ t
következményeként	k ø v ɛ t k ɛ z m eː ɲ ɛ k eː n t
házé	h aː z eː
malájok	m ɒ l aː j o k
gyűrsz	ɟ yː r s
adnánk	ɒ d n aː ŋ k
olívaolajok	o l iː v ɒ o l ɒ j o k
irodaszékek	i r o d ɒ s eː k ɛ k
blokk	b l o kː
felkészülést	f ɛ l k eː s y l eː ʃ t
motorkerékpárok	m o t o r k ɛ r eː k p aː r o k
tartalékok	t ɒ r t ɒ l eː k o k
helyről	h ɛ j r øː l
forrad	f o rː ɒ d
barátságok	b ɒ r aː t͡ʃː aː ɡ o k
vályúk	v aː j uː k
csempész	t͡ʃ ɛ m p eː s
zongorákon	z o ŋ ɡ o r aː k o n
látogatta	l aː t o ɡ ɒ tː ɒ
kedvünk	k ɛ d v y ŋ k
sámli	ʃ aː m l i
vektortér	v ɛ k t o r t eː r
pisztolyaik	p i s t o j ɒ j i k
úthálózat	uː t h aː l oː z ɒ t
destruktív	d ɛ ʃ t r u k t iː v
találmányuk	t ɒ l aː l m aː ɲ u k
érzelmeket	eː r z ɛ l m ɛ k ɛ t
nézelődik	n eː z ɛ l øː d i k
antiszeptikus	ɒ n t i s ɛ p t i k u ʃ
úszás	uː s aː ʃ
vajak	v ɒ j ɒ k
haldoklok	h ɒ l d o k l o k
adományokat	ɒ d o m aː ɲ o k ɒ t
valószínűségszámítás	v ɒ l oː s iː n yː ʃ eː k s aː m iː t aː ʃ
kardnyúlvány	k ɒ r d ɲ uː l v aː ɲ
adottakért	ɒ d o tː ɒ k eː r t
inzulinjai	i n z u l i ɲː ɒ j i
tigrisektől	t i ɡ r i ʃ ɛ k t øː l
ásótok	aː ʃ oː t o k
pokla	p o k l ɒ
elkényeztetettebb	ɛ l k eː ɲ ɛ s t ɛ t ɛ tː ɛ bː
legregresszívebb	l ɛ ɡ r ɛ ɡ r ɛ sː iː v ɛ bː
ástak	aː ʃ t ɒ k
legbiztatóbb	l ɛ ɡ b i s t ɒ t oː bː
xilofonod	k s i l o f o n o d
egészségükre	ɛ ɡ eː ʃː eː ɡ y k r ɛ
zacskók	z ɒ t͡ʃ k oː k
érdekeket	eː r d ɛ k ɛ k ɛ t
fókuszál	f oː k u s aː l
ausztrál	ɒ u s t r aː l
földieper	f ø l d i j ɛ p ɛ r
babérjain	b ɒ b eː r j ɒ j i n
dohánygyár	d o ɦ aː ɲ ɟ aː r
tűrhetetlen	t yː r ɦ ɛ t ɛ t l ɛ n
bejelenteni	b ɛ j ɛ l ɛ n t ɛ n i
éden	eː d ɛ n
latyak	l ɒ c ɒ k
ecetes	ɛ t͡s ɛ t ɛ ʃ
bosszúságok	b o sː uː ʃ aː ɡ o k
simulékony	ʃ i m u l eː k o ɲ
nyílászáró	ɲ iː l aː ʒ z aː r oː
véletek	v eː l ɛ t ɛ k
elmegyógyintézet	ɛ l m ɛ ɟ oː ɟ i n t eː z ɛ t
januárt	j ɒ n u aː r t
keserédes	k ɛ ʃ ɛ r eː d ɛ ʃ
legszakszerűbb	l ɛ k s ɒ k s ɛ r yː bː
szülői	s y l øː j i
kifejezéstelenebb	k i f ɛ j ɛ z eː ʃ t ɛ l ɛ n ɛ bː
estiben	ɛ ʃ t i b ɛ n
fortéja	f o r t eː j ɒ
ajkuk	ɒ j k u k
készenlét	k eː s ɛ n l eː t
hallomások	h ɒ lː o m aː ʃ o k
műveltség	m yː v ɛ l t͡ʃ eː ɡ
kanóc	k ɒ n oː t͡s
cicák	t͡s i t͡s aː k
totyog	t o c o ɡ
nyilatkozatokat	ɲ i l ɒ t k o z ɒ t o k ɒ t
zenedéitek	z ɛ n ɛ d eː j i t ɛ k
szuggesztió	s u ɡː ɛ s t i j oː
csajkánk	t͡ʃ ɒ j k aː ŋ k
elleni	ɛ lː ɛ n i
krajcár	k r ɒ j t͡s aː r
aduvá	ɒ d u v aː
vendégség	v ɛ n d eː k ʃ eː ɡ
szegecs	s ɛ ɡ ɛ t͡ʃ
popzenék	p o b z ɛ n eː k
Asztalos	ɒ s t ɒ l o ʃ
keresztes	k ɛ r ɛ s t ɛ ʃ
kedély	k ɛ d eː j
szárazon	s aː r ɒ z o n
bögölynél	b ø ɡ ø j n eː l
segítenénk	ʃ ɛ ɡ iː t ɛ n eː ŋ k
vöröshagymák	v ø r ø ʃ h ɒ ɟ m aː k
metszünk	m ɛ t͡sː y ŋ k
tanulna	t ɒ n u l n ɒ
sablonom	ʃ ɒ b l o n o m
szét	s eː t
ideggyógyászok	i d ɛ ɡ ɟ oː ɟ aː s o k
szégyell	s eː ɟ ɛ lː
bokszkesztyű	b o k s k ɛ s c yː
fontosságát	f o n t o ʃː aː ɡ aː t
kadmiumok	k ɒ d m i j u m o k
megvizsgál	m ɛ ɡ v i ʒ ɡ aː l
tünetileg	t y n ɛ t i l ɛ ɡ
borús	b o r uː ʃ
derékszögű	d ɛ r eː k s ø ɡ yː
zúzz	z uː zː
kényszerű	k eː ɲ s ɛ r yː
bioakusztika	b i j o ɒ k u s t i k ɒ
fülért	f y l eː r t
játékokhoz	j aː t eː k o k h o z
palotánk	p ɒ l o t aː ŋ k
legszőkésebb	l ɛ k s øː k eː ʃ ɛ bː
leghasznosabb	l ɛ k h ɒ s n o ʃ ɒ bː
tévék	t eː v eː k
fejjed	f ɛ jː ɛ d
makró	m ɒ k r oː
lényegét	l eː ɲ ɛ ɡ eː t
egyáltalán	ɛ ɟː aː l t ɒ l aː n
utótag	u t oː t ɒ ɡ
tömsz	t ø m s
adukba	ɒ d u ɡ b ɒ
apály	ɒ p aː j
névnapot	n eː v n ɒ p o t
támasztott	t aː m ɒ s t o tː
oratóriumok	o r ɒ t oː r i j u m o k
jönnétek	j ø nː eː t ɛ k
csuklyák	t͡ʃ u k j aː k
voltatok	v o l t ɒ t o k
karaktereken	k ɒ r ɒ k t ɛ r ɛ k ɛ n
paranormális	p ɒ r ɒ n o r m aː l i ʃ
emő	ɛ m øː
membránfehérje	m ɛ m b r aː ɱ f ɛ ɦ eː r j ɛ
keletre	k ɛ l ɛ t r ɛ
szingapúriak	s i ŋ ɡ ɒ p uː r i j ɒ k
homályosít	h o m aː j o ʃ iː t
amellett	ɒ m ɛ lː ɛ tː
agákként	ɒ ɡ aː kː eː n t
abakuszoknál	ɒ b ɒ k u s o k n aː l
ennyit	ɛ ɲː i t
gyászok	ɟ aː s o k
eseteid	ɛ ʃ ɛ t ɛ j i d
Hunyadi	h u ɲ ɒ d i
elhamarkodva	ɛ l ɦ ɒ m ɒ r k o d v ɒ
húsdaráló	h uː ʒ d ɒ r aː l oː
legünneplőbb	l ɛ ɡ y nː ɛ p l øː bː
lócák	l oː t͡s aː k
csészéid	t͡ʃ eː s eː j i d
zajba	z ɒ j b ɒ
mosások	m o ʃ aː ʃ o k
mórok	m oː r o k
végzetes	v eː ɡ z ɛ t ɛ ʃ
szereplője	s ɛ r ɛ p l øː j ɛ
eressz	ɛ r ɛ sː
lányosabb	l aː ɲ o ʃ ɒ bː
nehézségek	n ɛ ɦ eː ʃː eː ɡ ɛ k
Lengyeltóti	l ɛ ɲ ɟ ɛ l t oː t i
meggondoltabb	m ɛ ɡː o n d o l t ɒ bː
katedrálisok	k ɒ t ɛ d r aː l i ʃ o k
ölesebb	ø l ɛ ʃ ɛ bː
álláspontját	aː lː aː ʃ p o ɲ c aː t
Aranyosgyéres	ɒ r ɒ ɲ o ʒ ɟ eː r ɛ ʃ
tanultabb	t ɒ n u l t ɒ bː
zsarnokibb	ʒ ɒ r n o k i bː
állítani	aː lː iː t ɒ n i
legsápatagabb	l ɛ k ʃ aː p ɒ t ɒ ɡ ɒ bː
jómódú	j oː m oː d uː
betűtök	b ɛ t yː t ø k
bátorságod	b aː t o r ʃ aː ɡ o d
legolvadékonyabb	l ɛ ɡ o l v ɒ d eː k o ɲ ɒ bː
aggyá	ɒ ɟː aː
kifogások	k i f o ɡ aː ʃ o k
koponyáid	k o p o ɲ aː j i d
tarra	t ɒ rː ɒ
felhőkarcoló	f ɛ l ɦ øː k ɒ r t͡s o l oː
olvasnál	o l v ɒ ʃ n aː l
bérként	b eː r k eː n t
állnák	aː l n aː k
elvtársnők	ɛ l f t aː r ʃ n øː k
tus	t u ʃ
fejtenétek	f ɛ j t ɛ n eː t ɛ k
böglyökre	b ø ɡ j ø k r ɛ
iskolatáskák	i ʃ k o l ɒ t aː ʃ k aː k
mimellettünk	m i m ɛ lː ɛ tː y ŋ k
klasszicista	k l ɒ sː i t͡s i ʃ t ɒ
hélium	h eː l i j u m
tanulnék	t ɒ n u l n eː k
sorozatgyilkos	ʃ o r o z ɒ d ɟ i l k o ʃ
keserűség	k ɛ ʃ ɛ r yː ʃ eː ɡ
bélről	b eː rː øː l
kezdetben	k ɛ z d ɛ d b ɛ n
vízikutya	v iː z i k u c ɒ
kártalanítás	k aː r t ɒ l ɒ n iː t aː ʃ
antialkoholista	ɒ n t i j ɒ l k o h o l i ʃ t ɒ
egyfajta	ɛ c f ɒ j t ɒ
legrozogább	l ɛ ɡ r o z o ɡ aː bː
dús	d uː ʃ
ígér	i ɡ eː r
pontosít	p o n t o ʃ iː t
kalapotok	k ɒ l ɒ p o t o k
keljenek	k ɛ jː ɛ n ɛ k
törvénye	t ø r v eː ɲ ɛ
halmazom	h ɒ l m ɒ z o m
jegeskávé	j ɛ ɡ ɛ ʃ k aː v eː
képzésekké	k eː b z eː ʃ ɛ kː eː
elégtől	ɛ l eː k t øː l
tolom	t o l o m
kamaszhoz	k ɒ m ɒ s h o z
repülőgépgyárak	r ɛ p y l øː ɡ eː b ɟ aː r ɒ k
lecsendesül	l ɛ t͡ʃ ɛ n d ɛ ʃ y l
hűség	h yː ʃ eː ɡ
bohócok	b o ɦ oː t͡s o k
gyapjak	ɟ ɒ p j ɒ k
kutatni	k u t ɒ t n i
figyelmeztetés	f i ɟ ɛ l m ɛ s t ɛ t eː ʃ
lile	l i l ɛ
berendezett	b ɛ r ɛ n d ɛ z ɛ tː
profitábilis	p r o f i t aː b i l i ʃ
reprodukciók	r ɛ p r o d u k t͡s i j oː k
higgyél	h i ɟː eː l
inzulinja	i n z u l i ɲː ɒ
bakteriológia	b ɒ k t ɛ r i j o l oː ɡ i j ɒ
logaritmusok	l o ɡ ɒ r i t m u ʃ o k
molibdén	m o l i b d eː n
napnyugták	n ɒ p ɲ u k t aː k
ásatási	aː ʃ ɒ t aː ʃ i
kezdi	k ɛ z d i
beleszólás	b ɛ l ɛ s oː l aː ʃ
szerződéssel	s ɛ r z øː d eː ʃː ɛ l
tanácsnak	t ɒ n aː t͡ʃ n ɒ k
emlős	ɛ m l øː ʃ
unokahúg	u n o k ɒ ɦ uː ɡ
acetonok	ɒ t͡s ɛ t o n o k
irtsatok	i r t͡ʃ ɒ t o k
ernyőszervezet	ɛ r ɲ øː s ɛ r v ɛ z ɛ t
kerítésen	k ɛ r iː t eː ʃ ɛ n
farmer	f ɒ r m ɛ r
tüsszentések	t y sː ɛ n t eː ʃ ɛ k
disznóólak	d i s n oː oː l ɒ k
szilárdabb	s i l aː r d ɒ bː
madarász	m ɒ d ɒ r aː s
táplálkozás	t aː p l aː l k o z aː ʃ
szénsav	s eː n ʃ ɒ v
ortopédiák	o r t o p eː d i j aː k
titánok	t i t aː n o k
mondott	m o n d o tː
zománcok	z o m aː n t͡s o k
meny	m ɛ ɲ
dolmányokra	d o l m aː ɲ o k r ɒ
csapos	t͡ʃ ɒ p o ʃ
lap	l ɒ p
sápad	ʃ aː p ɒ d
leghasználtabb	l ɛ k h ɒ s n aː l t ɒ bː
vezetőig	v ɛ z ɛ t øː j i ɡ
szigetvilágok	s i ɡ ɛ t v i l aː ɡ o k
hűen	h yː ɛ n
őalóla	øː ɒ l oː l ɒ
mellékmondatok	m ɛ lː eː k m o n d ɒ t o k
vezetőknél	v ɛ z ɛ t øː k n eː l
ébressz	eː b r ɛ sː
lássak	l aː ʃː ɒ k
nászajándék	n aː s ɒ j aː n d eː k
Palesztinának	p ɒ l ɛ s t i n aː n ɒ k
meghatározás	m ɛ k h ɒ t aː r o z aː ʃ
jellemnév	j ɛ lː ɛ m n eː v
huszonnyolc	h u s o ɲː o l t͡s
bombasztikus	b o m b ɒ s t i k u ʃ
csábítások	t͡ʃ aː b iː t aː ʃ o k
teremen	t ɛ r ɛ m ɛ n
hangulata	h ɒ ŋ ɡ u l ɒ t ɒ
legpechesebb	l ɛ k p ɛ xː ɛ ʃ ɛ bː
hozamod	h o z ɒ m o d
áteresztőképességek	aː t ɛ r ɛ s t øː k eː p ɛ ʃː eː ɡ ɛ k
túlnépesedés	t uː l n eː p ɛ ʃ ɛ d eː ʃ
menedzsmentek	m ɛ n ɛ d͡ʒ m ɛ n t ɛ k
tányéron	t aː ɲ eː r o n
hitét	h i t eː t
tehetségeteket	t ɛ h ɛ t͡ʃː eː ɡ ɛ t ɛ k ɛ t
várjanak	v aː r j ɒ n ɒ k
jogai	j o ɡ ɒ j i
bukta	b u k t ɒ
hittérítők	h i tː eː r iː t øː k
éghet	eː k h ɛ t
országos	o r s aː ɡ o ʃ
észre	eː s r ɛ
látomás	l aː t o m aː ʃ
nyakká	ɲ ɒ kː aː
sportágak	ʃ p o r t aː ɡ ɒ k
zöldségesek	z ø l t͡ʃ eː ɡ ɛ ʃ ɛ k
családfák	t͡ʃ ɒ l aː t f aː k
kölcsön	k ø l t͡ʃ ø n
alapismeretek	ɒ l ɒ p i ʃ m ɛ r ɛ t ɛ k
sírodban	ʃ iː r o d b ɒ n
páran	p aː r ɒ n
Helga	h ɛ l ɡ ɒ
alaktanaik	ɒ l ɒ k t ɒ n ɒ j i k
miattuk	m i j ɒ tː u k
kazánok	k ɒ z aː n o k
vadkecskék	v ɒ t k ɛ t͡ʃ k eː k
programként	p r o ɡ r ɒ m k eː n t
örömmel	ø r ø mː ɛ l
hipotalamusz	h i p o t ɒ l ɒ m u s
rézig	r eː z i ɡ
gratulálunk	ɡ r ɒ t u l aː l u ŋ k
uncsi	u n t͡ʃ i
szakdolgozat	s ɒ ɡ d o l ɡ o z ɒ t
cipők	t͡s i p øː k
tanúk	t ɒ n uː k
orgonaművész	o r ɡ o n ɒ m yː v eː s
kávézások	k aː v eː z aː ʃ o k
valókon	v ɒ l oː k o n
c	t͡s
poszméh	p o s m eː
keljünk	k ɛ jː y ŋ k
osztanak	o s t ɒ n ɒ k
ellenőrző	ɛ lː ɛ n øː r z øː
néhányat	n eː ɦ aː ɲ ɒ t
szubjektívebb	s u b j ɛ k t iː v ɛ bː
ambíciók	ɒ m b iː t͡s i j oː k
Hajós	h ɒ j oː ʃ
csontrendszer	t͡ʃ o n t r ɛ n t͡s ɛ r
egyéb	ɛ ɟ eː b
tervezési	t ɛ r v ɛ z eː ʃ i
kicsik	k i t͡ʃ i k
viselni	v i ʃ ɛ l n i
unjam	u ɲː ɒ m
táthat	t aː t h ɒ t
Egyházasrádóc	ɛ c h aː z ɒ ʃ r aː d oː t͡s
világossá	v i l aː ɡ o ʃː aː
mennynek	m ɛ ɲ n ɛ k
kettőd	k ɛ tː øː d
kapuknál	k ɒ p u k n aː l
boróka	b o r oː k ɒ
beosztású	b ɛ o s t aː ʃ uː
sarc	ʃ ɒ r t͡s
eszcájg	ɛ s t͡s aː j ɡ
nyakamat	ɲ ɒ k ɒ m ɒ t
alanynak	ɒ l ɒ ɲ n ɒ k
füstös	f y ʃ t ø ʃ
bánatuk	b aː n ɒ t u k
hírtelevízió	h iː r t ɛ l ɛ v iː z i j oː
álljanak	aː jː ɒ n ɒ k
preferál	p r ɛ f ɛ r aː l
fordít	f o r d iː t
poggyászok	p o ɟː aː s o k
istenfélő	i ʃ t ɛ ɱ f eː l øː
vezetőkről	v ɛ z ɛ t øː k r øː l
főzniük	f øː z n i j y k
világom	v i l aː ɡ o m
gurulna	ɡ u r u l n ɒ
óvsz	oː f s
elvesztés	ɛ l v ɛ s t eː ʃ
vonzottál	v o n z o tː aː l
panaszt	p ɒ n ɒ s t
szerencsétlenebb	s ɛ r ɛ n t͡ʃ eː t l ɛ n ɛ bː
bonts	b o n t͡ʃ
abakuszaitok	ɒ b ɒ k u s ɒ j i t o k
órát	oː r aː t
üdvösség	y d v ø ʃː eː ɡ
dominikai	d o m i n i k ɒ j i
egészekért	ɛ ɡ eː s ɛ k eː r t
ismeretelmélet	i ʃ m ɛ r ɛ t ɛ l m eː l ɛ t
diktátorok	d i k t aː t o r o k
hólyagok	h oː j ɒ ɡ o k
középfülek	k ø z eː p f y l ɛ k
másokig	m aː ʃ o k i ɡ
Csató	t͡ʃ ɒ t oː
apokalipszis	ɒ p o k ɒ l i p s i ʃ
muníciók	m u n iː t͡s i j oː k
nagyítható	n ɒ ɟ iː t h ɒ t oː
gondolatuk	ɡ o n d o l ɒ t u k
egymásért	ɛ ɟ m aː ʃ eː r t
Bernát	b ɛ r n aː t
ángy	aː ɲ ɟ
ellentételezése	ɛ lː ɛ n t eː t ɛ l ɛ z eː ʃ ɛ
mosogatunk	m o ʃ o ɡ ɒ t u ŋ k
vietnami	v i j ɛ t n ɒ m i
nemtom	n ɛ m t o m
lég	l eː ɡ
szavazáshoz	s ɒ v ɒ z aː ʃ h o z
igealak	i ɡ ɛ ɒ l ɒ k
vontátok	v o n t aː t o k
Sándor	ʃ aː n d o r
árnyékotoktól	aː r ɲ eː k o t o k t oː l
műselyem	m yː ʃ ɛ j ɛ m
látok	l aː t o k
foglalkozni	f o ɡ l ɒ l k o z n i
cérnák	t͡s eː r n aː k
ábrándvilágot	aː b r aː n d v i l aː ɡ o t
berendezés	b ɛ r ɛ n d ɛ z eː ʃ
Merkúr	m ɛ r k uː r
limuzinok	l i m u z i n o k
gyúr	ɟ uː r
bőrgyár	b øː r ɟ aː r
egérfogók	ɛ ɡ eː r f o ɡ oː k
fejescsont	f ɛ j ɛ ʃ t͡ʃ o n t
oldaladat	o l d ɒ l ɒ d ɒ t
valamely	v ɒ l ɒ m ɛ j
bérnek	b eː r n ɛ k
bemutatkozások	b ɛ m u t ɒ t k o z aː ʃ o k
mellékletek	m ɛ lː eː k l ɛ t ɛ k
morális	m o r aː l i ʃ
megvalósítani	m ɛ ɡ v ɒ l oː ʃ iː t ɒ n i
nézlek	n eː z l ɛ k
gondozásában	ɡ o n d o z aː ʃ aː b ɒ n
legakusztikusabb	l ɛ ɡ ɒ k u s t i k u ʃ ɒ bː
Szakcs	s ɒ k t͡ʃ
csatabárdokat	t͡ʃ ɒ t ɒ b aː r d o k ɒ t
vírusok	v iː r u ʃ o k
telne	t ɛ l n ɛ
koronái	k o r o n aː j i
teremtmények	t ɛ r ɛ m t m eː ɲ ɛ k
tanítványod	t ɒ n iː t v aː ɲ o d
fejben	f ɛ j b ɛ n
súlyvonalak	ʃ uː j v o n ɒ l ɒ k
fogmedrek	f o ɡ m ɛ d r ɛ k
nyelvből	ɲ ɛ l v b øː l
szabadidők	s ɒ b ɒ d i d øː k
legegyhangúbban	l ɛ ɡ ɛ c h ɒ ŋ ɡ uː bː ɒ n
alamizsna	ɒ l ɒ m i ʒ n ɒ
ovis	o v i ʃ
szerkesztője	s ɛ r k ɛ s t øː j ɛ
pótlása	p oː t l aː ʃ ɒ
csípd	t͡ʃ iː b d
feketén	f ɛ k ɛ t eː n
kefir	k ɛ f i r
sajtburger	ʃ ɒ j d b u r ɡ ɛ r
küldje	k y l ɟ ɛ
repülőgépek	r ɛ p y l øː ɡ eː p ɛ k
szerkeszt	s ɛ r k ɛ s t
reájuk	r ɛ aː j u k
fényképeztek	f eː ɲ k eː p ɛ s t ɛ k
angolokat	ɒ ŋ ɡ o l o k ɒ t
különlegesebb	k y l ø n l ɛ ɡ ɛ ʃ ɛ bː
hollét	h o lː eː t
szisztematikus	s i s t ɛ m ɒ t i k u ʃ
cikkelyek	t͡s i kː ɛ j ɛ k
perec	p ɛ r ɛ t͡s
világnak	v i l aː ɡ n ɒ k
henye	h ɛ ɲ ɛ
lovagra	l o v ɒ ɡ r ɒ
megelőz	m ɛ ɡ ɛ l øː z
tükör	t y k ø r
arabeszkek	ɒ r ɒ b ɛ s k ɛ k
fényceruza	f eː ɲ t͡s ɛ r u z ɒ
nagyit	n ɒ ɟ i t
csuklóból	t͡ʃ u k l oː b oː l
ókori	oː k o r i
felületesség	f ɛ l y l ɛ t ɛ ʃː eː ɡ
irodalomtörténet	i r o d ɒ l o m t ø r t eː n ɛ t
legszalonképesebb	l ɛ k s ɒ l o ŋ k eː p ɛ ʃ ɛ bː
legmesszebb	l ɛ ɡ m ɛ sː ɛ bː
lője	l øː j ɛ
Háry	h aː r i
anyu	ɒ ɲ u
húszezer	h uː s ɛ z ɛ r
elfogadhatóbb	ɛ l f o ɡ ɒ t h ɒ t oː bː
dicséretekig	d i t͡ʃ eː r ɛ t ɛ k i ɡ
kozákok	k o z aː k o k
pozícióban	p o z iː t͡s i j oː b ɒ n
témákba	t eː m aː ɡ b ɒ
teretek	t ɛ r ɛ t ɛ k
népes	n eː p ɛ ʃ
gombon	ɡ o m b o n
fogna	f o ɡ n ɒ
jubileumi	j u b i l ɛ u m i
válaszolhat	v aː l ɒ s o l ɦ ɒ t
érdeklődéseket	eː r d ɛ k l øː d eː ʃ ɛ k ɛ t
gyűjteményekbe	ɟ yː j t ɛ m eː ɲ ɛ ɡ b ɛ
gyufásdobozok	ɟ u f aː ʒ d o b o z o k
koromfekete	k o r o ɱ f ɛ k ɛ t ɛ
F	f
kutyáid	k u c aː j i d
erőteljesen	ɛ r øː t ɛ jː ɛ ʃ ɛ n
öltönynadrág	ø l t ø ɲ n ɒ d r aː ɡ
repülők	r ɛ p y l øː k
fülszöveg	f y l s ø v ɛ ɡ
anyanyelvű	ɒ ɲ ɒ ɲ ɛ l v yː
irányában	i r aː ɲ aː b ɒ n
önből	ø m b øː l
vérebek	v eː r ɛ b ɛ k
legbarátibb	l ɛ ɡ b ɒ r aː t i bː
engedélyt	ɛ ŋ ɡ ɛ d eː j t
tálak	t aː l ɒ k
bocsátana	b o t͡ʃ aː t ɒ n ɒ
érzem	eː r z ɛ m
melléd	m ɛ lː eː d
szemhéjak	s ɛ m ɦ eː j ɒ k
összkomfortos	ø s k o ɱ f o r t o ʃ
egyed	ɛ ɟ ɛ d
evangéliumi	ɛ v ɒ ŋ ɡ eː l i j u m i
ablakból	ɒ b l ɒ ɡ b oː l
gördülőállomány	ɡ ø r d y l øː aː lː o m aː ɲ
Csokonyavisonta	t͡ʃ o k o ɲ ɒ v i ʃ o n t ɒ
egészségi	ɛ ɡ eː ʃː eː ɡ i
Edit	ɛ d i t
lakmuszpapír	l ɒ k m u s p ɒ p iː r
skalpol	ʃ k ɒ l p o l
akkordot	ɒ kː o r d o t
fájj	f aː jː
merjük	m ɛ r j y k
földi	f ø l d i
vacsorára	v ɒ t͡ʃ o r aː r ɒ
szeretet	s ɛ r ɛ t ɛ t
leglelkesebb	l ɛ ɡ l ɛ l k ɛ ʃ ɛ bː
Etu	ɛ t u
halánték	h ɒ l aː n t eː k
minisztériumok	m i n i s t eː r i j u m o k
kristályos	k r i ʃ t aː j o ʃ
rendesen	r ɛ n d ɛ ʃ ɛ n
csalódások	t͡ʃ ɒ l oː d aː ʃ o k
belőletek	b ɛ l øː l ɛ t ɛ k
versenyző	v ɛ r ʃ ɛ ɲ z øː
dévanágari	d eː v ɒ n aː ɡ ɒ r i
unjanak	u ɲː ɒ n ɒ k
átlós	aː t l oː ʃ
magasztosabb	m ɒ ɡ ɒ s t o ʃ ɒ bː
elolt	ɛ l o l t
Habakuk	h ɒ b ɒ k u k
prérikutya	p r eː r i k u c ɒ
tisztelt	t i s t ɛ l t
hatványra	h ɒ t v aː ɲ r ɒ
tilinkó	t i l i ŋ k oː
tanácsokból	t ɒ n aː t͡ʃ o ɡ b oː l
élje	eː jː ɛ
fölfelé	f ø l f ɛ l eː
Beáta	b ɛ aː t ɒ
terhet	t ɛ r ɦ ɛ t
feddte	f ɛ tː ɛ
köztünk	k ø s t y ŋ k
dolmányaik	d o l m aː ɲ ɒ j i k
keveset	k ɛ v ɛ ʃ ɛ t
hajatlan	h ɒ j ɒ t l ɒ n
lesi	l ɛ ʃ i
kürtön	k y r t ø n
lakcím	l ɒ k t͡s iː m
ültétek	y l t eː t ɛ k
legsekélyebb	l ɛ k ʃ ɛ k eː j ɛ bː
világként	v i l aː kː eː n t
periferiális	p ɛ r i f ɛ r i j aː l i ʃ
citológiai	t͡s i t o l oː ɡ i j ɒ j i
mezőbe	m ɛ z øː b ɛ
Nauru	n ɒ u r u
alakjaik	ɒ l ɒ k j ɒ j i k
szekta	s ɛ k t ɒ
mindenkiből	m i n d ɛ ŋ k i b øː l
meggyőződve	m ɛ ɡ ɟ øː z øː d v ɛ
kikölcsönöz	k i k ø l t͡ʃ ø n ø z
szájgarat	s aː j ɡ ɒ r ɒ t
földrajzi	f ø l d r ɒ j z i
uszító	u s iː t oː
bársony	b aː r ʃ o ɲ
akadozik	ɒ k ɒ d o z i k
semlegesek	ʃ ɛ m l ɛ ɡ ɛ ʃ ɛ k
megjelenési	m ɛ ɡ j ɛ l ɛ n eː ʃ i
kitölt	k i t ø l t
baktériumölő	b ɒ k t eː r i j u m ø l øː
megmondtam	m ɛ ɡ m o n t ɒ m
házasságoknak	h aː z ɒ ʃː aː ɡ o k n ɒ k
alannyá	ɒ l ɒ ɲː aː
tarthat	t ɒ r t h ɒ t
tízszög	t iː sː ø ɡ
filmről	f i l m r øː l
bódul	b oː d u l
estély	ɛ ʃ t eː j
tudd	t u dː
kenyerek	k ɛ ɲ ɛ r ɛ k
Angola	ɒ ŋ ɡ o l ɒ
Móra	m oː r ɒ
jádezöld	j aː d ɛ z ø l d
demók	d ɛ m oː k
térszög	t eː r s ø ɡ
fogékonyság	f o ɡ eː k o ɲ ʃ aː ɡ
euklideszi	ɛ u k l i d ɛ s i
abakuszokban	ɒ b ɒ k u s o ɡ b ɒ n
tizenötödike	t i z ɛ n ø t ø d i k ɛ
helynél	h ɛ j n eː l
eldug	ɛ l d u ɡ
kontinens	k o n t i n ɛ n ʃ
kerevetek	k ɛ r ɛ v ɛ t ɛ k
kakaóvajak	k ɒ k ɒ oː v ɒ j ɒ k
alkalmával	ɒ l k ɒ l m aː v ɒ l
magazinjaim	m ɒ ɡ ɒ z i ɲː ɒ j i m
tanárt	t ɒ n aː r t
paszomány	p ɒ s o m aː ɲ
taxi	t ɒ k s i
nyilvánosságok	ɲ i l v aː n o ʃː aː ɡ o k
sajnálja	ʃ ɒ j n aː jː ɒ
egészség	ɛ ɡ eː ʃː eː ɡ
megcsúszik	m ɛ k t͡ʃ uː s i k
Makedónia	m ɒ k ɛ d oː n i j ɒ
bizalmat	b i z ɒ l m ɒ t
fényesebb	f eː ɲ ɛ ʃ ɛ bː
csombord	t͡ʃ o m b o r d
másba	m aː ʒ b ɒ
sírotokban	ʃ iː r o t o ɡ b ɒ n
közepette	k ø z ɛ p ɛ tː ɛ
csokra	t͡ʃ o k r ɒ
Enying	ɛ ɲ i ŋ ɡ
ellop	ɛ lː o p
fórumok	f oː r u m o k
farkasokat	f ɒ r k ɒ ʃ o k ɒ t
részbe	r eː z b ɛ
hűtőszekrény	h yː t øː s ɛ k r eː ɲ
köböl	k ø b ø l
aktát	ɒ k t aː t
repülőjegy	r ɛ p y l øː j ɛ ɟ
undok	u n d o k
vaku	v ɒ k u
kürttel	k y r t ɛ l
ügyünk	y ɟ y ŋ k
fordíthat	f o r d iː t h ɒ t
villog	v i lː o ɡ
valamiket	v ɒ l ɒ m i k ɛ t
termékismertető	t ɛ r m eː k i ʃ m ɛ r t ɛ t øː
eltérő	ɛ l t eː r øː
bemutatták	b ɛ m u t ɒ tː aː k
fensz	f ɛ n s
kezet	k ɛ z ɛ t
zongorák	z o ŋ ɡ o r aː k
farkas	f ɒ r k ɒ ʃ
zsaluzz	ʒ ɒ l u zː
homokjaink	h o m o k j ɒ j i ŋ k
elromlik	ɛ rː o m l i k
fiai	f i j ɒ j i
arám	ɒ r aː m
személynév	s ɛ m eː j n eː v
folyamatokig	f o j ɒ m ɒ t o k i ɡ
Jeruzsálem	j ɛ r u ʒ aː l ɛ m
pintér	p i n t eː r
általában	aː l t ɒ l aː b ɒ n
vakondjaitok	v ɒ k o ɲ ɟ ɒ j i t o k
Kharón	k ɒ r oː n
Türkmenisztán	t y r k m ɛ n i s t aː n
észlel	eː s l ɛ l
xenonom	k s ɛ n o n o m
bújt	b uː j t
kapcsolataink	k ɒ p t͡ʃ o l ɒ t ɒ j i ŋ k
családfám	t͡ʃ ɒ l aː t f aː m
sonkák	ʃ o ŋ k aː k
obszervatóriumok	o p s ɛ r v ɒ t oː r i j u m o k
szükségeshez	s y k ʃ eː ɡ ɛ ʃ h ɛ z
feltesz	f ɛ l t ɛ s
tévedésben	t eː v ɛ d eː ʒ b ɛ n
falaz	f ɒ l ɒ z
buzgó	b u z ɡ oː
milyenekbe	m i j ɛ n ɛ ɡ b ɛ
pária	p aː r i j ɒ
meccsek	m ɛ t͡ʃː ɛ k
közelit	k ø z ɛ l i t
koncertek	k o n t͡s ɛ r t ɛ k
hálásabb	h aː l aː ʃ ɒ bː
józan	j oː z ɒ n
szeráj	s ɛ r aː j
telefonálás	t ɛ l ɛ f o n aː l aː ʃ
infrastruktúránk	i ɱ f r ɒ ʃ t r u k t uː r aː ŋ k
illesztő	i lː ɛ s t øː
vadászatok	v ɒ d aː s ɒ t o k
hibátlan	h i b aː t l ɒ n
fenyegetés	f ɛ ɲ ɛ ɡ ɛ t eː ʃ
ürömfajdok	y r ø ɱ f ɒ j d o k
pónilovak	p oː n i l o v ɒ k
kákán	k aː k aː n
részeg	r eː s ɛ ɡ
vérszegénységet	v eː r s ɛ ɡ eː ɲ ʃ eː ɡ ɛ t
testek	t ɛ ʃ t ɛ k
ocsú	o t͡ʃ u
démonok	d eː m o n o k
Somogysámson	ʃ o m o c ʃ aː m ʃ o n
bólint	b oː l i n t
lurkó	l u r k oː
indifferens	i n d i fː ɛ r ɛ n ʃ
fennállása	f ɛ nː aː lː aː ʃ ɒ
részeknek	r eː s ɛ k n ɛ k
kapum	k ɒ p u m
alkoholok	ɒ l k o h o l o k
ázik	aː z i k
izoprén	i z o p r eː n
állapotokban	aː lː ɒ p o t o ɡ b ɒ n
énért	eː n eː r t
programnál	p r o ɡ r ɒ m n aː l
rizs	r i ʒ
asszociatív	ɒ sː o t͡s i j ɒ t iː v
bajuszú	b ɒ j u s uː
rakétavető	r ɒ k eː t ɒ v ɛ t øː
z	z
csinálj	t͡ʃ i n aː jː
kajszibarackok	k ɒ j s i b ɒ r ɒ t͡s k o k
ötvennyolcadik	ø t v ɛ ɲː o l t͡s ɒ d i k
küldték	k y l t eː k
bachi	b ɒ xː i
Stefánia	ʃ t ɛ f aː n i j ɒ
mérték	m eː r t eː k
lényegi	l eː ɲ ɛ ɡ i
csuklón	t͡ʃ u k l oː n
birsalmafái	b i r ʃ ɒ l m ɒ f aː j i
ügyfélkapcsolati	y c f eː l k ɒ p t͡ʃ o l ɒ t i
acetont	ɒ t͡s ɛ t o n t
videója	v i d ɛ oː j ɒ
lobon	l o b o n
add	ɒ dː
joghatóság	j o k h ɒ t oː ʃ aː ɡ
szőke	s øː k ɛ
ügyeik	y ɟ ɛ j i k
bridzs	b r i d͡ʒː
utaskísérő	u t ɒ ʃ k iː ʃ eː r øː
hajgumi	h ɒ j ɡ u m i
hetente	h ɛ t ɛ n t ɛ
kongj	k o ŋ ɡ ʝ
fogékonyságok	f o ɡ eː k o ɲ ʃ aː ɡ o k
néző	n eː z øː
épebb	eː p ɛ bː
figyelőlistába	f i ɟ ɛ l øː l i ʃ t aː b ɒ
csicsereg	t͡ʃ i t͡ʃ ɛ r ɛ ɡ
hant	h ɒ n t
térségek	t eː r ʃ eː ɡ ɛ k
antitest	ɒ n t i t ɛ ʃ t
kölyök	k ø j ø k
nyirkos	ɲ i r k o ʃ
írisz	iː r i s
addig	ɒ dː i ɡ
mindenségit	m i n d ɛ n ʃ eː ɡ i t
elődök	ɛ l øː d ø k
áldomás	aː l d o m aː ʃ
sötétkamra	ʃ ø t eː t k ɒ m r ɒ
keménykalapok	k ɛ m eː ɲ k ɒ l ɒ p o k
lábadat	l aː b ɒ d ɒ t
bejelöl	b ɛ j ɛ l ø l
vonz	v o n z
veszélye	v ɛ s eː j ɛ
atka	ɒ t k ɒ
érek	eː r ɛ k
kapjátok	k ɒ p j aː t o k
keresztvetés	k ɛ r ɛ s t v ɛ t eː ʃ
osztanátok	o s t ɒ n aː t o k
bezoárkecske	b ɛ z o aː r k ɛ t͡ʃ k ɛ
névtelen	n eː f t ɛ l ɛ n
restaurátorok	r ɛ ʃ t ɒ u r aː t o r o k
Platón	p l ɒ t oː n
megkeres	m ɛ kː ɛ r ɛ ʃ
avokádók	ɒ v o k aː d oː k
vízszintes	v iː sː i n t ɛ ʃ
csobogások	t͡ʃ o b o ɡ aː ʃ o k
topográfiák	t o p o ɡ r aː f i j aː k
átka	aː t k ɒ
folyamatokért	f o j ɒ m ɒ t o k eː r t
derek	d ɛ r ɛ k
tűzoltókat	t yː z o l t oː k ɒ t
énelébem	eː n ɛ l eː b ɛ m
leverne	l ɛ v ɛ r n ɛ
zúza	z uː z ɒ
írje	iː r j ɛ
zászlót	z aː s l oː t
kényelmesen	k eː ɲ ɛ l m ɛ ʃ ɛ n
gyomirtás	ɟ o m i r t aː ʃ
alkalmasságok	ɒ l k ɒ l m ɒ ʃː aː ɡ o k
falok	f ɒ l o k
milliárd	m i lː i j aː r d
adtunk	ɒ tː u ŋ k
csalhat	t͡ʃ ɒ l ɦ ɒ t
szántunk	s aː n t u ŋ k
nuklein	n u k l ɛ j i n
billenőkapcsoló	b i lː ɛ n øː k ɒ p t͡ʃ o l oː
légkörtan	l eː kː ø r t ɒ n
nőd	n øː d
mellékvese	m ɛ lː eː k v ɛ ʃ ɛ
fenekére	f ɛ n ɛ k eː r ɛ
legtapintatlanabb	l ɛ k t ɒ p i n t ɒ t l ɒ n ɒ bː
várjad	v aː r j ɒ d
külvárosok	k y l v aː r o ʃ o k
egyenlítői	ɛ ɟː ɛ n l iː t øː j i
akciótervek	ɒ k t͡s i j oː t ɛ r v ɛ k
expresszivitás	ɛ k s p r ɛ sː i v i t aː ʃ
boroskancsó	b o r o ʃ k ɒ n t͡ʃ oː
leggyengédebb	l ɛ ɡ ɟ ɛ ŋ ɡ eː d ɛ bː
felkavaróbb	f ɛ l k ɒ v ɒ r oː bː
abakuszban	ɒ b ɒ k u z b ɒ n
megjelentetések	m ɛ ɡ j ɛ l ɛ n t ɛ t eː ʃ ɛ k
galeri	ɡ ɒ l ɛ r i
legbővebben	l ɛ ɡ b øː v ɛ bː ɛ n
ablakoknak	ɒ b l ɒ k o k n ɒ k
bürokrácia	b y r o k r aː t͡s i j ɒ
nyeletek	ɲ ɛ l ɛ t ɛ k
nyitvatermők	ɲ i t v ɒ t ɛ r m øː k
alkalom	ɒ l k ɒ l o m
őhozzája	øː ɦ o zː aː j ɒ
olvasod	o l v ɒ ʃ o d
hasznosítása	h ɒ s n o ʃ iː t aː ʃ ɒ
számolótáblájuk	s aː m o l oː t aː b l aː j u k
rászed	r aː s ɛ d
érhetni	eː r ɦ ɛ t n i
Óbarok	oː b ɒ r o k
kútház	k uː t h aː z
multik	m u l t i k
ugyanide	u ɟ ɒ n i d ɛ
albatroszként	ɒ l b ɒ t r o s k eː n t
agancshoz	ɒ ɡ ɒ n t͡ʃ h o z
szobrász	s o b r aː s
megszerezni	m ɛ k s ɛ r ɛ z n i
anyósok	ɒ ɲ oː ʃ o k
képviselete	k eː p v i ʃ ɛ l ɛ t ɛ
hallatlan	h ɒ lː ɒ t l ɒ n
tapasztalatai	t ɒ p ɒ s t ɒ l ɒ t ɒ j i
megfélemlítés	m ɛ k f eː l ɛ m l iː t eː ʃ
szállítás	s aː lː iː t aː ʃ
önökben	ø n ø ɡ b ɛ n
oktatás	o k t ɒ t aː ʃ
tanítok	t ɒ n iː t o k
adattudós	ɒ d ɒ tː u d oː ʃ
közlönyt	k ø z l ø ɲ t
határozatlan	h ɒ t aː r o z ɒ t l ɒ n
léve	l eː v ɛ
rendőrállam	r ɛ n d øː r aː lː ɒ m
idegklinikák	i d ɛ kː l i n i k aː k
melyért	m ɛ j eː r t
lábtőcsont	l aː p t øː t͡ʃ o n t
történelmek	t ø r t eː n ɛ l m ɛ k
fickók	f i t͡s k oː k
legnagyszerűbb	l ɛ ɡ n ɒ c s ɛ r yː bː
gondjaid	ɡ o ɲ ɟ ɒ j i d
lényege	l eː ɲ ɛ ɡ ɛ
sarlósfecskék	ʃ ɒ r l oː ʃ f ɛ t͡ʃ k eː k
herékre	h ɛ r eː k r ɛ
korhadtabb	k o r ɦ ɒ tː ɒ bː
aljai	ɒ jː ɒ j i
Mikeás	m i k ɛ aː ʃ
frigy	f r i ɟ
meditációk	m ɛ d i t aː t͡s i j oː k
drágáll	d r aː ɡ aː lː
legkreatívabb	l ɛ k r ɛ ɒ t iː v ɒ bː
martalócok	m ɒ r t ɒ l oː t͡s o k
mosson	m o ʃː o n
jogvédelem	j o ɡ v eː d ɛ l ɛ m
váltópénzek	v aː l t oː p eː n z ɛ k
Haiti	h ɒ j i t i
tártabb	t aː r t ɒ bː
bocsássam	b o t͡ʃ aː ʃː ɒ m
varázslás	v ɒ r aː ʒ l aː ʃ
fodrászok	f o d r aː s o k
ipartelepek	i p ɒ r t ɛ l ɛ p ɛ k
kelletjük	k ɛ lː ɛ cː y k
rabló	r ɒ b l oː
szülőföldek	s y l øː f ø l d ɛ k
tejesemberek	t ɛ j ɛ ʃ ɛ m b ɛ r ɛ k
csábít	t͡ʃ aː b iː t
adminisztrátorokat	ɒ d m i n i s t r aː t o r o k ɒ t
léptünk	l eː p t y ŋ k
túlzottan	t uː l z o tː ɒ n
rajz	r ɒ j z
fednünk	f ɛ d n y ŋ k
zenedéim	z ɛ n ɛ d eː j i m
jártuk	j aː r t u k
szeld	s ɛ l d
munkájával	m u ŋ k aː j aː v ɒ l
eredete	ɛ r ɛ d ɛ t ɛ
ajánlanám	ɒ j aː n l ɒ n aː m
fú	f uː
lovagias	l o v ɒ ɡ i j ɒ ʃ
Baranya	b ɒ r ɒ ɲ ɒ
legfanyarabb	l ɛ k f ɒ ɲ ɒ r ɒ bː
Mezőhegyes	m ɛ z øː ɦ ɛ ɟ ɛ ʃ
gyerekeken	ɟ ɛ r ɛ k ɛ k ɛ n
ezoterika	ɛ z o t ɛ r i k ɒ
barátkozik	b ɒ r aː t k o z i k
szaglóideg	s ɒ ɡ l oː j i d ɛ ɡ
fusizik	f u ʃ i z i k
bevezetését	b ɛ v ɛ z ɛ t eː ʃ eː t
várostérkép	v aː r o ʃ t eː r k eː p
műemlék	m yː ɛ m l eː k
Körmend	k ø r m ɛ n d
közleményben	k ø z l ɛ m eː ɲ b ɛ n
dolmányaim	d o l m aː ɲ ɒ j i m
földpát	f ø l t p aː t
kemény	k ɛ m eː ɲ
megijed	m ɛ ɡ i j ɛ d
melegházi	m ɛ l ɛ k h aː z i
produkció	p r o d u k t͡s i j oː
túlterhelés	t uː l t ɛ r ɦ ɛ l eː ʃ
féltetek	f eː l t ɛ t ɛ k
vendége	v ɛ n d eː ɡ ɛ
kémcsövek	k eː m t͡ʃ ø v ɛ k
adócsalás	ɒ d oː t͡ʃ ɒ l aː ʃ
környezetvédelmek	k ø r ɲ ɛ z ɛ t v eː d ɛ l m ɛ k
fejeteket	f ɛ j ɛ t ɛ k ɛ t
szabálytalanabb	s ɒ b aː j t ɒ l ɒ n ɒ bː
bajaitok	b ɒ j ɒ j i t o k
Győr	ɟ øː r
oktatásokban	o k t ɒ t aː ʃ o ɡ b ɒ n
artéria	ɒ r t eː r i j ɒ
deklaráció	d ɛ k l ɒ r aː t͡s i j oː
rohanva	r o ɦ ɒ ɱ v ɒ
szerével	s ɛ r eː v ɛ l
poligon	p o l i ɡ o n
legfagyasztóbb	l ɛ k f ɒ ɟ ɒ s t oː bː
délkeletibb	d eː l k ɛ l ɛ t i bː
elvált	ɛ l v aː l t
balettcipő	b ɒ l ɛ t͡sː i p øː
sütőben	ʃ y t øː b ɛ n
utazásra	u t ɒ z aː ʃ r ɒ
kerítések	k ɛ r iː t eː ʃ ɛ k
vodka	v o t k ɒ
szavazó	s ɒ v ɒ z oː
csizmadia	t͡ʃ i z m ɒ d i j ɒ
óhajtja	oː ɦ ɒ j c ɒ
faágak	f ɒ aː ɡ ɒ k
mancsa	m ɒ n t͡ʃ ɒ
húzzuk	h uː zː u k
kényelmetlenség	k eː ɲ ɛ l m ɛ t l ɛ n ʃ eː ɡ
Ő	øː
rengés	r ɛ ŋ ɡ eː ʃ
idegösszeomlás	i d ɛ ɡ ø sː ɛ o m l aː ʃ
hellyé	h ɛ jː eː
aranygaluska	ɒ r ɒ ɲ ɡ ɒ l u ʃ k ɒ
berakás	b ɛ r ɒ k aː ʃ
támadhat	t aː m ɒ t h ɒ t
túlzott	t uː l z o tː
érj	eː r ʝ
középponti	k ø z eː pː o n t i
skizofrén	ʃ k i z o f r eː n
késsel	k eː ʃː ɛ l
faputtonyokba	f ɒ p u tː o ɲ o ɡ b ɒ
mellékvesék	m ɛ lː eː k v ɛ ʃ eː k
adotton	ɒ d o tː o n
Kulcs	k u l t͡ʃ
étteremlánc	eː tː ɛ r ɛ m l aː n t͡s
ismertétek	i ʃ m ɛ r t eː t ɛ k
babérjaitokon	b ɒ b eː r j ɒ j i t o k o n
lézerek	l eː z ɛ r ɛ k
területre	t ɛ r y l ɛ t r ɛ
hangfalaitok	h ɒ ŋ k f ɒ l ɒ j i t o k
vicc	v i t͡sː
álljuk	aː jː u k
névjegykártya	n eː v j ɛ c k aː r c ɒ
státus	ʃ t aː t u ʃ
csajkátok	t͡ʃ ɒ j k aː t o k
tenyerek	t ɛ ɲ ɛ r ɛ k
csalódott	t͡ʃ ɒ l oː d o tː
végbizonyítvány	v eː ɡ b i z o ɲ iː t v aː ɲ
Alcsevszk	ɒ l t͡ʃ ɛ f s k
várólistára	v aː r oː l i ʃ t aː r ɒ
Kornél	k o r n eː l
holdak	h o l d ɒ k
fertályok	f ɛ r t aː j o k
tejcukor	t ɛ j t͡s u k o r
számítógépes	s aː m iː t oː ɡ eː p ɛ ʃ
tradicionálisan	t r ɒ d i t͡s i j o n aː l i ʃ ɒ n
narratológia	n ɒ rː ɒ t o l oː ɡ i j ɒ
fahéjfákon	f ɒ ɦ eː j f aː k o n
akink	ɒ k i ŋ k
eltávolít	ɛ l t aː v o l iː t
impresszáriók	i m p r ɛ sː aː r i j oː k
fotót	f o t oː t
rendszerekkel	r ɛ n t s ɛ r ɛ kː ɛ l
hamvasztás	h ɒ ɱ v ɒ s t aː ʃ
legrövidítettebb	l ɛ ɡ r ø v i d iː t ɛ tː ɛ bː
kiválasztott	k i v aː l ɒ s t o tː
kiválasztani	k i v aː l ɒ s t ɒ n i
információhoz	i ɱ f o r m aː t͡s i j oː ɦ o z
újszülött	uː j s y l ø tː
elhanyagol	ɛ l ɦ ɒ ɲ ɒ ɡ o l
műterme	m yː t ɛ r m ɛ
négyek	n eː ɟ ɛ k
tályog	t aː j o ɡ
taksál	t ɒ k ʃ aː l
betűméret	b ɛ t yː m eː r ɛ t
ricinus	r i t͡s i n u ʃ
Pusztaföldvár	p u s t ɒ f ø l d v aː r
traktor	t r ɒ k t o r
sztrichnin	s t r i x n i n
zseniálisabb	ʒ ɛ n i j aː l i ʃ ɒ bː
kíséretek	k iː ʃ eː r ɛ t ɛ k
íreim	iː r ɛ j i m
lobba	l o bː ɒ
dongó	d o ŋ ɡ oː
adományul	ɒ d o m aː ɲ u l
leghavasabb	l ɛ k h ɒ v ɒ ʃ ɒ bː
rokonszenves	r o k o n s ɛ ɱ v ɛ ʃ
mandátumok	m ɒ n d aː t u m o k
attak	ɒ tː ɒ k
párhuzamos	p aː r ɦ u z ɒ m o ʃ
karácsony	k ɒ r aː t͡ʃ o ɲ
gondosság	ɡ o n d o ʃː aː ɡ
aranyat	ɒ r ɒ ɲ ɒ t
megoldással	m ɛ ɡ o l d aː ʃː ɒ l
tanulmányokká	t ɒ n u l m aː ɲ o kː aː
szórakozik	s oː r ɒ k o z i k
bűnügy	b yː n y ɟ
almafáid	ɒ l m ɒ f aː j i d
héják	h eː j aː k
villin	v i lː i n
lazacra	l ɒ z ɒ t͡s r ɒ
illusztrációk	i lː u s t r aː t͡s i j oː k
tehetik	t ɛ h ɛ t i k
benyomni	b ɛ ɲ o m n i
fordított	f o r d iː t o tː
nyelvekért	ɲ ɛ l v ɛ k eː r t
konstruktívabb	k o n ʃ t r u k t iː v ɒ bː
legspeciálisabb	l ɛ k ʃ p ɛ t͡s i j aː l i ʃ ɒ bː
Pest	p ɛ ʃ t
énekké	eː n ɛ kː eː
születik	s y l ɛ t i k
nyilvánosabban	ɲ i l v aː n o ʃ ɒ bː ɒ n
satu	ʃ ɒ t u
betűig	b ɛ t yː j i ɡ
internetre	i n t ɛ r n ɛ t r ɛ
ragadványnév	r ɒ ɡ ɒ d v aː ɲ n eː v
ejtőernyők	ɛ j t øː ɛ r ɲ øː k
másnapos	m aː ʃ n ɒ p o ʃ
bársonyok	b aː r ʃ o ɲ o k
tudományosan	t u d o m aː ɲ o ʃ ɒ n
emberük	ɛ m b ɛ r y k
ordenáré	o r d ɛ n aː r eː
agyonlő	ɒ ɟ o n l øː
szüksége	s y k ʃ eː ɡ ɛ
csíkász	t͡ʃ iː k aː s
bízott	b iː z o tː
cicán	t͡s i t͡s aː n
betöltött	b ɛ t ø l t ø tː
alaktanok	ɒ l ɒ k t ɒ n o k
képzésekről	k eː b z eː ʃ ɛ k r øː l
harap	h ɒ r ɒ p
időkbe	i d øː ɡ b ɛ
januároknak	j ɒ n u aː r o k n ɒ k
bokával	b o k aː v ɒ l
adtak	ɒ tː ɒ k
dobjalak	d o b j ɒ l ɒ k
hordalékok	h o r d ɒ l eː k o k
vonjam	v o ɲː ɒ m
elemetek	ɛ l ɛ m ɛ t ɛ k
ősfajok	øː ʃ f ɒ j o k
ellátott	ɛ lː aː t o tː
auditóriumok	ɒ u d i t oː r i j u m o k
sílift	ʃ iː l i f t
teázik	t ɛ aː z i k
ekként	ɛ kː eː n t
őröm	øː r ø m
püspökbot	p y ʃ p ø ɡ b o t
szeretted	s ɛ r ɛ tː ɛ d
abrakot	ɒ b r ɒ k o t
sógunátus	ʃ oː ɡ u n aː t u ʃ
dicséretre	d i t͡ʃ eː r ɛ t r ɛ
nyakakként	ɲ ɒ k ɒ kː eː n t
kenderikék	k ɛ n d ɛ r i k eː k
többeken	t ø bː ɛ k ɛ n
Feketehalom	f ɛ k ɛ t ɛ ɦ ɒ l o m
gyógyfüvek	ɟ oː c f y v ɛ k
ájulj	aː j u jː
rádióban	r aː d i j oː b ɒ n
sántább	ʃ aː n t aː bː
programjaim	p r o ɡ r ɒ m j ɒ j i m
fasírt	f ɒ ʃ iː r t
versenytársak	v ɛ r ʃ ɛ ɲ t aː r ʃ ɒ k
izomról	i z o m r oː l
semmi	ʃ ɛ mː i
ütnétek	y t n eː t ɛ k
Hárskút	h aː r ʃ k uː t
pasas	p ɒ ʃ ɒ ʃ
legmonumentálisabb	l ɛ ɡ m o n u m ɛ n t aː l i ʃ ɒ bː
forgó	f o r ɡ oː
szőttétek	s øː tː eː t ɛ k
nyulacskák	ɲ u l ɒ t͡ʃ k aː k
sikkes	ʃ i kː ɛ ʃ
anyagok	ɒ ɲ ɒ ɡ o k
bármeddig	b aː r m ɛ dː i ɡ
szükségesekké	s y k ʃ eː ɡ ɛ ʃ ɛ kː eː
ébreszt	eː b r ɛ s t
buzgóbb	b u z ɡ oː bː
legcinikusabb	l ɛ k t͡s i n i k u ʃ ɒ bː
kommunikatívabb	k o mː u n i k ɒ t iː v ɒ bː
Palesztinával	p ɒ l ɛ s t i n aː v ɒ l
legfelhőtlenebb	l ɛ k f ɛ l ɦ øː t l ɛ n ɛ bː
valótlan	v ɒ l oː t l ɒ n
olyannál	o j ɒ nː aː l
vezetését	v ɛ z ɛ t eː ʃ eː t
bankettek	b ɒ ŋ k ɛ tː ɛ k
pókhálóhártya	p oː k h aː l oː ɦ aː r c ɒ
herével	h ɛ r eː v ɛ l
analitikusok	ɒ n ɒ l i t i k u ʃ o k
csajokat	t͡ʃ ɒ j o k ɒ t
egyenlet	ɛ ɟ ɛ n l ɛ t
hullámvasutak	h u lː aː ɱ v ɒ ʃ u t ɒ k
Brüsszel	b r y sː ɛ l
erőket	ɛ r øː k ɛ t
hattyúdalok	h ɒ cː uː d ɒ l o k
sulid	ʃ u l i d
ábrándok	aː b r aː n d o k
edények	ɛ d eː ɲ ɛ k
tíkfák	t iː k f aː k
rágj	r aː ɡ ʝ
fátyoloz	f aː c o l o z
okozott	o k o z o tː
ostoba	o ʃ t o b ɒ
sajnálják	ʃ ɒ j n aː jː aː k
értékekben	eː r t eː k ɛ ɡ b ɛ n
tanfolyam	t ɒ ɱ f o j ɒ m
Tass	t ɒ ʃː
jómagad	j oː m ɒ ɡ ɒ d
előléptet	ɛ l øː l eː p t ɛ t
tercel	t ɛ r t͡s ɛ l
nyelvtannáci	ɲ ɛ l f t ɒ nː aː t͡s i
feladatainak	f ɛ l ɒ d ɒ t ɒ j i n ɒ k
vonzottátok	v o n z o tː aː t o k
erény	ɛ r eː ɲ
Bükkszentkereszt	b y k s ɛ n t k ɛ r ɛ s t
traktorok	t r ɒ k t o r o k
enzimek	ɛ n z i m ɛ k
buszra	b u s r ɒ
óriásszárcsa	oː r i j aː ʃ s aː r t͡ʃ ɒ
nagyobbfajta	n ɒ ɟ o p f ɒ j t ɒ
vigéc	v i ɡ eː t͡s
nemzetiség	n ɛ m z ɛ t i ʃ eː ɡ
saláták	ʃ ɒ l aː t aː k
szerelmet	s ɛ r ɛ l m ɛ t
objektivitás	o b j ɛ k t i v i t aː ʃ
pofonegyszerűbb	p o f o n ɛ c s ɛ r yː bː
legásatagabb	l ɛ ɡ aː ʃ ɒ t ɒ ɡ ɒ bː
bátyja	b aː cː ɒ
járdán	j aː r d aː n
legaktívabb	l ɛ ɡ ɒ k t iː v ɒ bː
legszentimentálisabb	l ɛ k s ɛ n t i m ɛ n t aː l i ʃ ɒ bː
endokrinológia	ɛ n d o k r i n o l oː ɡ i j ɒ
meggyőződik	m ɛ ɡ ɟ øː z øː d i k
bársonyt	b aː r ʃ o ɲ t
Ildi	i l d i
hagyományba	h ɒ ɟ o m aː ɲ b ɒ
vakok	v ɒ k o k
epre	ɛ p r ɛ
nyávogsz	ɲ aː v o k s
követelőbb	k ø v ɛ t ɛ l øː bː
váltják	v aː l c aː k
entalpiák	ɛ n t ɒ l p i j aː k
dolgokért	d o l ɡ o k eː r t
lápokat	l aː p o k ɒ t
képnek	k eː p n ɛ k
hitelkártyát	h i t ɛ l k aː r c aː t
készpénznek	k eː s p eː n z n ɛ k
orvostanhallgatók	o r v o ʃ t ɒ n ɦ ɒ l ɡ ɒ t oː k
műveltebb	m yː v ɛ l t ɛ bː
passzivitások	p ɒ sː i v i t aː ʃ o k
ráadásul	r aː ɒ d aː ʃ u l
Európában	ɛ u r oː p aː b ɒ n
forgatókönyvek	f o r ɡ ɒ t oː k ø ɲ v ɛ k
pulzusuk	p u l z u ʃ u k
felállított	f ɛ l aː lː iː t o tː
amelyekből	ɒ m ɛ j ɛ ɡ b øː l
homokkövek	h o m o kː ø v ɛ k
magamtól	m ɒ ɡ ɒ m t oː l
termeket	t ɛ r m ɛ k ɛ t
járni	j aː r n i
poklok	p o k l o k
multinacionális	m u l t i n ɒ t͡s i j o n aː l i ʃ
tizenkétszög	t i z ɛ ŋ k eː t͡sː ø ɡ
gyereknek	ɟ ɛ r ɛ k n ɛ k
életben	eː l ɛ d b ɛ n
szaknyelvek	s ɒ k ɲ ɛ l v ɛ k
egyenletes	ɛ ɟ ɛ n l ɛ t ɛ ʃ
kamuka	k ɒ m u k ɒ
izmokon	i z m o k o n
dísze	d iː s ɛ
predesztinál	p r ɛ d ɛ s t i n aː l
hinnék	h i nː eː k
gondolatjeletek	ɡ o n d o l ɒ t j ɛ l ɛ t ɛ k
tör	t ø r
szárkapcsok	s aː r k ɒ p t͡ʃ o k
hordozható	h o r d o s h ɒ t oː
Nagykáta	n ɒ c k aː t ɒ
önarckép	ø n ɒ r t͡s k eː p
piacot	p i j ɒ t͡s o t
szokatlanabb	s o k ɒ t l ɒ n ɒ bː
szekundum	s ɛ k u n d u m
történeteknek	t ø r t eː n ɛ t ɛ k n ɛ k
munkáik	m u ŋ k aː j i k
hazudj	h ɒ z u ɟː
krisztadelfiánus	k r i s t ɒ d ɛ l f i j aː n u ʃ
kurtább	k u r t aː bː
igéből	i ɡ eː b øː l
felbontású	f ɛ l b o n t aː ʃ uː
gén	ɡ eː n
kisimít	k i ʃ i m iː t
máshoz	m aː ʃ h o z
lovagja	l o v ɒ ɡ j ɒ
álarcok	aː l ɒ r t͡s o k
dióhéj	d i j oː ɦ eː j
magazinként	m ɒ ɡ ɒ z i ŋ k eː n t
legkombináltabb	l ɛ kː o m b i n aː l t ɒ bː
hókócsag	h oː k oː t͡ʃ ɒ ɡ
tanítanának	t ɒ n iː t ɒ n aː n ɒ k
megmozgat	m ɛ ɡ m o z ɡ ɒ t
magánnyomozó	m ɒ ɡ aː ɲː o m o z oː
vasárnaponként	v ɒ ʃ aː r n ɒ p o ŋ k eː n t
érjed	eː r j ɛ d
álmatlanságok	aː l m ɒ t l ɒ n ʃ aː ɡ o k
drogokat	d r o ɡ o k ɒ t
falevelekre	f ɒ l ɛ v ɛ l ɛ k r ɛ
megkérdezte	m ɛ kː eː r d ɛ s t ɛ
dajkánk	d ɒ j k aː ŋ k
borszőlő	b o r s øː l øː
csodálatok	t͡ʃ o d aː l ɒ t o k
harács	h ɒ r aː t͡ʃ
Mária	m aː r i j ɒ
pulzusotok	p u l z u ʃ o t o k
kalózt	k ɒ l oː s t
emberekről	ɛ m b ɛ r ɛ k r øː l
felsorol	f ɛ l ʃ o r o l
koan	k oː ɒ n
értékpapír	eː r t eː k p ɒ p iː r
múzsák	m uː ʒ aː k
csirkéim	t͡ʃ i r k eː j i m
sablonjaitok	ʃ ɒ b l o ɲː ɒ j i t o k
ámenek	aː m ɛ n ɛ k
tokmányok	t o k m aː ɲ o k
berozsdásodik	b ɛ r o ʒ d aː ʃ o d i k
Gazsi	ɡ ɒ ʒ i
parfüméria	p ɒ r f y m eː r i j ɒ
bizonyíték	b i z o ɲ iː t eː k
indítani	i n d iː t ɒ n i
nyitottság	ɲ i t o t͡ʃː aː ɡ
számológép	s aː m o l oː ɡ eː p
gargarizál	ɡ ɒ r ɡ ɒ r i z aː l
újságcikkek	uː j ʃ aː k t͡s i kː ɛ k
íróasztal	iː r oː ɒ s t ɒ l
abortusztabletta	ɒ b o r t u s t ɒ b l ɛ tː ɒ
szövetségének	s ø v ɛ t͡ʃː eː ɡ eː n ɛ k
orrüregek	o rː y r ɛ ɡ ɛ k
felhőzet	f ɛ l ɦ øː z ɛ t
énfölöttem	eː ɱ f ø l ø tː ɛ m
legszínpompásabb	l ɛ k s iː m p o m p aː ʃ ɒ bː
nagyító	n ɒ ɟ iː t oː
felvilágosít	f ɛ l v i l aː ɡ o ʃ iː t
eretnekebb	ɛ r ɛ t n ɛ k ɛ bː
merjünk	m ɛ r j y ŋ k
hormonkészítmények	h o r m o ŋ k eː s iː t m eː ɲ ɛ k
valánk	v ɒ l aː ŋ k
felenged	f ɛ l ɛ ŋ ɡ ɛ d
dalt	d ɒ l t
világszerte	v i l aː k s ɛ r t ɛ
leggátlóbb	l ɛ ɡː aː t l oː bː
Imi	i m i
reggelikhez	r ɛ ɡː ɛ l i k h ɛ z
álnok	aː l n o k
gyűjteményekkel	ɟ yː j t ɛ m eː ɲ ɛ kː ɛ l
létrehozására	l eː t r ɛ ɦ o z aː ʃ aː r ɒ
petrezselyme	p ɛ t r ɛ ʒ ɛ j m ɛ
sorába	ʃ o r aː b ɒ
stúdiók	ʃ t uː d i j oː k
Polühümnia	p o l y h y m n i j ɒ
tripper	t r i pː ɛ r
kanárimadarak	k ɒ n aː r i m ɒ d ɒ r ɒ k
visszajelzést	v i sː ɒ j ɛ l z eː ʃ t
mocsarakkal	m o t͡ʃ ɒ r ɒ kː ɒ l
szab	s ɒ b
geometriák	ɡ ɛ o m ɛ t r i j aː k
villijeim	v i lː i j ɛ j i m
Csernobil	t͡ʃ ɛ r n o b i l
faleveled	f ɒ l ɛ v ɛ l ɛ d
rigójancsi	r i ɡ oː j ɒ n t͡ʃ i
alamizsnák	ɒ l ɒ m i ʒ n aː k
áss	aː ʃː
kérdést	k eː r d eː ʃ t
lyukad	j u k ɒ d
kombinációk	k o m b i n aː t͡s i j oː k
szellemű	s ɛ lː ɛ m yː
fotói	f o t oː j i
csuha	t͡ʃ u ɦ ɒ
százhuszonhárom	s aː s h u s o n ɦ aː r o m
sérülékeny	ʃ eː r y l eː k ɛ ɲ
közelebbről	k ø z ɛ l ɛ b r øː l
fogat	f o ɡ ɒ t
percemről	p ɛ r t͡s ɛ m r øː l
dugattyú	d u ɡ ɒ cː uː
adózhat	ɒ d oː s h ɒ t
operaénekes	o p ɛ r ɒ j eː n ɛ k ɛ ʃ
egyezés	ɛ ɟː ɛ z eː ʃ
kappan	k ɒ pː ɒ n
kiscsibék	k i ʃ t͡ʃ i b eː k
körzeté	k ø r z ɛ t eː
ülni	y l n i
fórum	f oː r u m
szeretniük	s ɛ r ɛ t n i j y k
ölnél	ø l n eː l
lexéma	l ɛ k s eː m ɒ
weboldalam	v ɛ b o l d ɒ l ɒ m
rémiszd	r eː m i z d
mák	m aː k
gyászos	ɟ aː s o ʃ
darum	d ɒ r u m
vonzzák	v o n z aː k
kelletsz	k ɛ lː ɛ t͡sː
válla	v aː lː ɒ
vésők	v eː ʃ øː k
Olténia	o l t eː n i j ɒ
fogad	f o ɡ ɒ d
licsi	l i t͡ʃ i
delfin	d ɛ l f i n
súlyemelés	ʃ uː j ɛ m ɛ l eː ʃ
szállítmányok	s aː lː iː t m aː ɲ o k
természetbeni	t ɛ r m eː s ɛ d b ɛ n i
bohó	b o ɦ oː
osztanánk	o s t ɒ n aː ŋ k
lehetetlenség	l ɛ h ɛ t ɛ t l ɛ n ʃ eː ɡ
panaszkönyvről	p ɒ n ɒ s k ø ɲ v r øː l
cilinderek	t͡s i l i n d ɛ r ɛ k
keresőlámpa	k ɛ r ɛ ʃ øː l aː m p ɒ
lázat	l aː z ɒ t
indultál	i n d u l t aː l
higgadt	h i ɡː ɒ tː
javasolta	j ɒ v ɒ ʃ o l t ɒ
hunyok	h u ɲ o k
irtjuk	i r c u k
nyersolaj	ɲ ɛ r ʃ o l ɒ j
ugyebár	u ɟ ɛ b aː r
konténer	k o n t eː n ɛ r
csészétek	t͡ʃ eː s eː t ɛ k
koncert	k o n t͡s ɛ r t
használatára	h ɒ s n aː l ɒ t aː r ɒ
illetlen	i lː ɛ t l ɛ n
egyenruhák	ɛ ɟ ɛ n r u ɦ aː k
hozamaim	h o z ɒ m ɒ j i m
ártalmasság	aː r t ɒ l m ɒ ʃː aː ɡ
tematikus	t ɛ m ɒ t i k u ʃ
ett	ɛ tː
Tököl	t ø k ø l
olyantól	o j ɒ n t oː l
korinthoszi	k o r i n t o s i
Felsőzsolca	f ɛ l ʃ øː ʒ o l t͡s ɒ
egyezkedik	ɛ ɟː ɛ s k ɛ d i k
pillanatnyilag	p i lː ɒ n ɒ t ɲ i l ɒ ɡ
Nyírlövő	ɲ iː r l ø v øː
nevezhető	n ɛ v ɛ s h ɛ t øː
izé	i z eː
szalagjaink	s ɒ l ɒ ɡ j ɒ j i ŋ k
mandzsu	m ɒ n d͡ʒ u
főre	f øː r ɛ
cinke	t͡s i ŋ k ɛ
legapróbb	l ɛ ɡ ɒ p r oː bː
jelentőségű	j ɛ l ɛ n t øː ʃ eː ɡ yː
csárdások	t͡ʃ aː r d aː ʃ o k
gyanúja	ɟ ɒ n uː j ɒ
legtúlzottabb	l ɛ k t uː l z o tː ɒ bː
saram	ʃ ɒ r ɒ m
legfelkészültebb	l ɛ k f ɛ l k eː s y l t ɛ bː
hallgatókat	h ɒ l ɡ ɒ t oː k ɒ t
tanítottuk	t ɒ n iː t o tː u k
sávok	ʃ aː v o k
kivetnivaló	k i v ɛ t n i v ɒ l oː
nyílik	ɲ iː l i k
fúlsz	f uː l s
bicskám	b i t͡ʃ k aː m
szurdok	s u r d o k
farmakológiai	f ɒ r m ɒ k o l oː ɡ i j ɒ j i
fájdalmas	f aː j d ɒ l m ɒ ʃ
mossanak	m o ʃː ɒ n ɒ k
harcok	h ɒ r t͡s o k
humora	h u m o r ɒ
felnéz	f ɛ l n eː z
szeszélyes	s ɛ s eː j ɛ ʃ
keres	k ɛ r ɛ ʃ
ezres	ɛ z r ɛ ʃ
térjen	t eː r j ɛ n
rááll	r aː aː lː
ténye	t eː ɲ ɛ
zsiliped	ʒ i l i p ɛ d
szíveskedjél	s iː v ɛ ʃ k ɛ ɟː eː l
különbözete	k y l ø m b ø z ɛ t ɛ
vesznek	v ɛ s n ɛ k
ajtókért	ɒ j t oː k eː r t
fejvadász	f ɛ j v ɒ d aː s
egyenletek	ɛ ɟ ɛ n l ɛ t ɛ k
egyikig	ɛ ɟː i k i ɡ
szavakká	s ɒ v ɒ kː aː
bevásárlok	b ɛ v aː ʃ aː r l o k
anyaggal	ɒ ɲ ɒ ɡː ɒ l
csaposak	t͡ʃ ɒ p o ʃ ɒ k
viszonylatok	v i s o ɲ l ɒ t o k
tűzoltóság	t yː z o l t oː ʃ aː ɡ
Barbi	b ɒ r b i
legironikusabb	l ɛ ɡ i r o n i k u ʃ ɒ bː
avarjaim	ɒ v ɒ r j ɒ j i m
húsvétvasárnap	h uː ʃ v eː t v ɒ ʃ aː r n ɒ p
undorítóbb	u n d o r iː t oː bː
klub	k l u bː
mondjuk	m o ɲ ɟ u k
könyökükön	k ø ɲ ø k y k ø n
keblem	k ɛ b l ɛ m
jerke	j ɛ r k ɛ
levéltelenebb	l ɛ v eː l t ɛ l ɛ n ɛ bː
mindenben	m i n d ɛ m b ɛ n
márkás	m aː r k aː ʃ
megéhezik	m ɛ ɡ eː ɦ ɛ z i k
tanácsba	t ɒ n aː d͡ʒ b ɒ
bevándorlók	b ɛ v aː n d o r l oː k
bizonytalanság	b i z o ɲ t ɒ l ɒ n ʃ aː ɡ
Flóra	f l oː r ɒ
emelt	ɛ m ɛ l t
Okány	o k aː ɲ
ferdülés	f ɛ r d y l eː ʃ
fiútestvér	f i j uː t ɛ ʃ t v eː r
kutatói	k u t ɒ t oː j i
legöregebb	l ɛ ɡ ø r ɛ ɡ ɛ bː
dalművek	d ɒ l m yː v ɛ k
voltokban	v o l t o ɡ b ɒ n
bokrai	b o k r ɒ j i
mészből	m eː z b øː l
képesítés	k eː p ɛ ʃ iː t eː ʃ
kislány	k i ʃ l aː ɲ
aduknak	ɒ d u k n ɒ k
háborúk	h aː b o r uː k
minőségét	m i n øː ʃ eː ɡ eː t
létrehozás	l eː t r ɛ ɦ o z aː ʃ
gráf	ɡ r aː f
csatahajó	t͡ʃ ɒ t ɒ h ɒ j oː
máktól	m aː k t oː l
fejtettél	f ɛ j t ɛ tː eː l
relatív	r ɛ l ɒ t iː v
oklevelek	o k l ɛ v ɛ l ɛ k
kelletik	k ɛ lː ɛ t i k
vigyázzon	v i ɟ aː zː o n
legilletlenebb	l ɛ ɡ i lː ɛ t l ɛ n ɛ bː
országban	o r s aː ɡ b ɒ n
eredmény	ɛ r ɛ d m eː ɲ
szórakoztató	s oː r ɒ k o s t ɒ t oː
felhőcskék	f ɛ l ɦ øː t͡ʃ k eː k
Pusztaederics	p u s t ɒ ɛ d ɛ r i t͡ʃ
megvalósítására	m ɛ ɡ v ɒ l oː ʃ iː t aː ʃ aː r ɒ
izmosabb	i z m o ʃ ɒ bː
támadt	t aː m ɒ tː
paleontológiai	p ɒ l ɛ o n t o l oː ɡ i j ɒ j i
korát	k o r aː t
szamizdat	s ɒ m i z d ɒ t
verbéna	v ɛ r b eː n ɒ
csinálnál	t͡ʃ i n aː l n aː l
vegyszer	v ɛ c s ɛ r
lencsecsontok	l ɛ n t͡ʃ ɛ t͡ʃ o n t o k
látókörű	l aː t oː k ø r yː
kivégzések	k i v eː ɡ z eː ʃ ɛ k
élete	eː l ɛ t ɛ
némelyiké	n eː m ɛ j i k eː
megválasztás	m ɛ ɡ v aː l ɒ s t aː ʃ
énekért	eː n ɛ k eː r t
fenne	f ɛ nː ɛ
fogolycsere	f o ɡ o j t͡ʃ ɛ r ɛ
mértük	m eː r t y k
hinnetek	h i nː ɛ t ɛ k
kapcsolatosan	k ɒ p t͡ʃ o l ɒ t o ʃ ɒ n
gyökérzet	ɟ ø k eː r z ɛ t
xenotranszplantáció	k s ɛ n o t r ɒ n s p l ɒ n t aː t͡s i j oː
borsó	b o r ʃ oː
ezüstösebb	ɛ z y ʃ t ø ʃ ɛ bː
padjaink	p ɒ ɟː ɒ j i ŋ k
legkomplikáltabb	l ɛ kː o m p l i k aː l t ɒ bː
szükségesekhez	s y k ʃ eː ɡ ɛ ʃ ɛ k h ɛ z
hangosfilm	h ɒ ŋ ɡ o ʃ f i l m
megír	m ɛ ɡ iː r
megszerezhető	m ɛ k s ɛ r ɛ s h ɛ t øː
reggelik	r ɛ ɡː ɛ l i k
Isten	i ʃ t ɛ n
begyakoroltatás	b ɛ ɟ ɒ k o r o l t ɒ t aː ʃ
újig	uː j i ɡ
zeneszerzés	z ɛ n ɛ s ɛ r z eː ʃ
bérgyilkos	b eː r ɟ i l k o ʃ
lábát	l aː b aː t
Kevermes	k ɛ v ɛ r m ɛ ʃ
benzinem	b ɛ n z i n ɛ m
komédián	k o m eː d i j aː n
fészkek	f eː s k ɛ k
bizonyítványt	b i z o ɲ iː t v aː ɲ t
kitört	k i t ø r t
lécci	l eː t͡sː i
kanyaró	k ɒ ɲ ɒ r oː
beírt	b ɛ j iː r t
legbolondabb	l ɛ ɡ b o l o n d ɒ bː
faszenek	f ɒ s ɛ n ɛ k
aktába	ɒ k t aː b ɒ
mestereik	m ɛ ʃ t ɛ r ɛ j i k
narancsszínű	n ɒ r ɒ n t͡ʃ s iː n yː
viszel	v i s ɛ l
namíbiai	n ɒ m iː b i j ɒ j i
web	v ɛ b
vetünk	v ɛ t y ŋ k
kávézás	k aː v eː z aː ʃ
győzelem	ɟ øː z ɛ l ɛ m
patkányméreg	p ɒ t k aː ɲ m eː r ɛ ɡ
pályát	p aː j aː t
ring	r i ŋ ɡ
osztana	o s t ɒ n ɒ
hali	h ɒ l i
unszol	u n s o l
trombita	t r o m b i t ɒ
hangulatkép	h ɒ ŋ ɡ u l ɒ t k eː p
érkeznek	eː r k ɛ z n ɛ k
abortusztörvény	ɒ b o r t u s t ø r v eː ɲ
tájnyelv	t aː j ɲ ɛ l v
favágó	f ɒ v aː ɡ oː
hazugot	h ɒ z u ɡ o t
magazinon	m ɒ ɡ ɒ z i n o n
kajás	k ɒ j aː ʃ
szentesít	s ɛ n t ɛ ʃ iː t
eheti	ɛ h ɛ t i
mondanak	m o n d ɒ n ɒ k
benzol	b ɛ n z o l
űrszondák	yː r s o n d aː k
kapusotok	k ɒ p u ʃ o t o k
együttműködőbb	ɛ ɟː y t m yː k ø d øː bː
méltóságteljes	m eː l t oː ʃ aː k t ɛ jː ɛ ʃ
fehérszemű	f ɛ ɦ eː r s ɛ m yː
találni	t ɒ l aː l n i
unión	u n i j oː n
termel	t ɛ r m ɛ l
kellettem	k ɛ lː ɛ tː ɛ m
vadregényes	v ɒ d r ɛ ɡ eː ɲ ɛ ʃ
tálalhat	t aː l ɒ l ɦ ɒ t
frusztráció	f r u s t r aː t͡s i j oː
faj	f ɒ j
bársonyosabb	b aː r ʃ o ɲ o ʃ ɒ bː
hanyatlások	h ɒ ɲ ɒ t l aː ʃ o k
medikusi	m ɛ d i k u ʃ i
dugattyúk	d u ɡ ɒ cː uː k
szíjak	s iː j ɒ k
jéghideg	j eː k h i d ɛ ɡ
asztallal	ɒ s t ɒ lː ɒ l
graféma	ɡ r ɒ f eː m ɒ
kémcső	k eː m t͡ʃ øː
Istenünk	i ʃ t ɛ n y ŋ k
illetékesség	i lː ɛ t eː k ɛ ʃː eː ɡ
cseppek	t͡ʃ ɛ pː ɛ k
bekezdés	b ɛ k ɛ z d eː ʃ
hírnevek	h iː r n ɛ v ɛ k
célpont	t͡s eː l p o n t
szemétvödrök	s ɛ m eː t v ø d r ø k
énekelnek	eː n ɛ k ɛ l n ɛ k
fésülködik	f eː ʃ y l k ø d i k
korban	k o r b ɒ n
dacaink	d ɒ t͡s ɒ j i ŋ k
töredezettségmentesíthetetlen	t ø r ɛ d ɛ z ɛ t͡ʃː eː ɡ m ɛ n t ɛ ʃ iː t h ɛ t ɛ t l ɛ n
csütörtök	t͡ʃ y t ø r t ø k
adományon	ɒ d o m aː ɲ o n
nyomtatvány	ɲ o m t ɒ t v aː ɲ
nyírhat	ɲ iː r ɦ ɒ t
felépül	f ɛ l eː p y l
delegál	d ɛ l ɛ ɡ aː l
valamihez	v ɒ l ɒ m i ɦ ɛ z
egyeztet	ɛ ɟː ɛ s t ɛ t
tanítómesterek	t ɒ n iː t oː m ɛ ʃ t ɛ r ɛ k
kelletlenkedés	k ɛ lː ɛ t l ɛ ŋ k ɛ d eː ʃ
irtanánk	i r t ɒ n aː ŋ k
orvost	o r v o ʃ t
késnek	k eː ʃ n ɛ k
alap	ɒ l ɒ p
színét	s iː n eː t
emberedre	ɛ m b ɛ r ɛ d r ɛ
nyilvánvalóan	ɲ i l v aː ɱ v ɒ l oː ɒ n
atletizál	ɒ t l ɛ t i z aː l
gyűrődések	ɟ yː r øː d eː ʃ ɛ k
harminchárom	h ɒ r m i n t͡s h aː r o m
politika	p o l i t i k ɒ
deléció	d ɛ l eː t͡s i j oː
nyílj	ɲ iː jː
rázom	r aː z o m
féltékenység	f eː l t eː k ɛ ɲ ʃ eː ɡ
pályákra	p aː j aː k r ɒ
áradások	aː r ɒ d aː ʃ o k
strukturális	ʃ t r u k t u r aː l i ʃ
enniük	ɛ nː i j y k
ágazik	aː ɡ ɒ z i k
padjaitok	p ɒ ɟː ɒ j i t o k
akik	ɒ k i k
igazságosság	i ɡ ɒ ʃː aː ɡ o ʃː aː ɡ
vezető	v ɛ z ɛ t øː
szarvaik	s ɒ r v ɒ j i k
valósabb	v ɒ l oː ʃ ɒ bː
hallok	h ɒ lː o k
szüntelen	s y n t ɛ l ɛ n
pediglen	p ɛ d i ɡ l ɛ n
vonók	v o n oː k
sajtószabadság	ʃ ɒ j t oː s ɒ b ɒ t͡ʃː aː ɡ
soregyen	ʃ o r ɛ ɟ ɛ n
lakosságának	l ɒ k o ʃː aː ɡ aː n ɒ k
papírkosár	p ɒ p iː r k o ʃ aː r
szőnyeg	s øː ɲ ɛ ɡ
számítógépnek	s aː m iː t oː ɡ eː p n ɛ k
négyéves	n eː ɟ eː v ɛ ʃ
rendelő	r ɛ n d ɛ l øː
dologként	d o l o kː eː n t
telítettebb	t ɛ l iː t ɛ tː ɛ bː
kiegészítők	k i j ɛ ɡ eː s iː t øː k
apróbojtorján	ɒ p r oː b o j t o r j aː n
rézzel	r eː zː ɛ l
írd	iː r d
zárszerkezet	z aː r s ɛ r k ɛ z ɛ t
ismerni	i ʃ m ɛ r n i
sejthártya	ʃ ɛ j t h aː r c ɒ
adatállományok	ɒ d ɒ t aː lː o m aː ɲ o k
szektorban	s ɛ k t o r b ɒ n
elektromosságtan	ɛ l ɛ k t r o m o ʃː aː k t ɒ n
toldd	t o l d
turbinák	t u r b i n aː k
leggondterheltebb	l ɛ ɡː o n t ɛ r ɦ ɛ l t ɛ bː
gólyaorrok	ɡ oː j ɒ o rː o k
terjed	t ɛ r j ɛ d
izolált	i z o l aː l t
drinápolyiak	d r i n aː p o j i j ɒ k
analfabéták	ɒ n ɒ l f ɒ b eː t aː k
nagyollsz	n ɒ ɟ o l s
aduk	ɒ d u k
róka	r oː k ɒ
kontaktkutatás	k o n t ɒ k t k u t ɒ t aː ʃ
mestere	m ɛ ʃ t ɛ r ɛ
klimax	k l i m ɒ k s
élnék	eː l n eː k
viharok	v i ɦ ɒ r o k
böglyöm	b ø ɡ j ø m
jógik	j oː ɡ i k
mennyek	m ɛ ɲː ɛ k
adjalak	ɒ ɟː ɒ l ɒ k
pasi	p ɒ ʃ i
urbanizációk	u r b ɒ n i z aː t͡s i j oː k
víztornyok	v iː s t o r ɲ o k
tapasztalatokat	t ɒ p ɒ s t ɒ l ɒ t o k ɒ t
kívánom	k iː v aː n o m
januárja	j ɒ n u aː r j ɒ
cseh	t͡ʃ ɛ
legvitézebb	l ɛ ɡ v i t eː z ɛ bː
programba	p r o ɡ r ɒ m b ɒ
kötötte	k ø t ø tː ɛ
sakktábla	ʃ ɒ k t aː b l ɒ
szalondarabok	s ɒ l o n d ɒ r ɒ b o k
barbárabb	b ɒ r b aː r ɒ bː
termelések	t ɛ r m ɛ l eː ʃ ɛ k
hercegnői	h ɛ r t͡s ɛ ɡ n øː j i
üzemek	y z ɛ m ɛ k
bókol	b oː k o l
nyoszolyák	ɲ o s o j aː k
ismerték	i ʃ m ɛ r t eː k
informatikai	i ɱ f o r m ɒ t i k ɒ j i
teher	t ɛ h ɛ r
tsz	t eː j ɛ s
tragikus	t r ɒ ɡ i k u ʃ
elírás	ɛ l iː r aː ʃ
csomagolás	t͡ʃ o m ɒ ɡ o l aː ʃ
istene	i ʃ t ɛ n ɛ
díszek	d iː s ɛ k
fürt	f y r t
szarhat	s ɒ r ɦ ɒ t
névnapok	n eː v n ɒ p o k
sólet	ʃ oː l ɛ t
racionálisabb	r ɒ t͡s i j o n aː l i ʃ ɒ bː
készlet	k eː s l ɛ t
gyülekezik	ɟ y l ɛ k ɛ z i k
sügér	ʃ y ɡ eː r
email	ɛ m aː j
fonnyaszt	f o ɲː ɒ s t
unna	u nː ɒ
rezervátumok	r ɛ z ɛ r v aː t u m o k
ürügye	y r y ɟ ɛ
szövődmények	s ø v øː d m eː ɲ ɛ k
játékosabb	j aː t eː k o ʃ ɒ bː
renoválás	r ɛ n o v aː l aː ʃ
orvoslás	o r v o ʃ l aː ʃ
konyhaszékek	k o ɲ ɦ ɒ s eː k ɛ k
utánégetők	u t aː n eː ɡ ɛ t øː k
ribanc	r i b ɒ n t͡s
Chicago	t͡ʃ i k aː ɡ oː
darvai	d ɒ r v ɒ j i
társaságot	t aː r ʃ ɒ ʃ aː ɡ o t
Démétér	d eː m eː t eː r
valakiket	v ɒ l ɒ k i k ɛ t
abakuszaink	ɒ b ɒ k u s ɒ j i ŋ k
fóbiás	f oː b i j aː ʃ
Szamarkand	s ɒ m ɒ r k ɒ n d
újhold	uː j ɦ o l d
angyalokkal	ɒ ɲ ɟ ɒ l o kː ɒ l
modernizációk	m o d ɛ r n i z aː t͡s i j oː k
Beszterce	b ɛ s t ɛ r t͡s ɛ
versenyzés	v ɛ r ʃ ɛ ɲ z eː ʃ
pulóver	p u l oː v ɛ r
ellenpápa	ɛ lː ɛ m p aː p ɒ
közismert	k ø z i ʃ m ɛ r t
adói	ɒ d oː j i
elakad	ɛ l ɒ k ɒ d
marslakók	m ɒ r ʃ l ɒ k oː k
mártáson	m aː r t aː ʃ o n
müzlik	m y z l i k
dolmányok	d o l m aː ɲ o k
idősödik	i d øː ʃ ø d i k
vezeklés	v ɛ z ɛ k l eː ʃ
juhval	j u v ɒ l
tárolsz	t aː r o l s
elfogultság	ɛ l f o ɡ u l t͡ʃ aː ɡ
heti	h ɛ t i
behúz	b ɛ ɦ uː z
maláta	m ɒ l aː t ɒ
viszonylat	v i s o ɲ l ɒ t
úszhat	uː s h ɒ t
hívőbb	h iː v øː bː
legpasszívabb	l ɛ k p ɒ sː iː v ɒ bː
gyarapodik	ɟ ɒ r ɒ p o d i k
citromsárga	t͡s i t r o m ʃ aː r ɡ ɒ
valamiből	v ɒ l ɒ m i b øː l
panaszaim	p ɒ n ɒ s ɒ j i m
kordon	k o r d o n
antikvitások	ɒ n t i k v i t aː ʃ o k
lejbe	l ɛ j b ɛ
szimmetriatengely	s i m ɛ t r i j ɒ t ɛ ŋ ɡ ɛ j
példákat	p eː l d aː k ɒ t
bősz	b øː s
legfanatikusabb	l ɛ k f ɒ n ɒ t i k u ʃ ɒ bː
negligál	n ɛ ɡ l i ɡ aː l
előkészítés	ɛ l øː k eː s iː t eː ʃ
lapoz	l ɒ p o z
menetek	m ɛ n ɛ t ɛ k
aláhúz	ɒ l aː ɦ uː z
emóció	ɛ m oː t͡s i j oː
estivé	ɛ ʃ t i v eː
károsabb	k aː r o ʃ ɒ bː
sör	ʃ ø r
injekció	i ɲː ɛ k t͡s i j oː
cserkészlány	t͡ʃ ɛ r k eː s l aː ɲ
enyhén	ɛ ɲ ɦ eː n
diadalmasabb	d i j ɒ d ɒ l m ɒ ʃ ɒ bː
utolérik	u t o l eː r i k
órájában	oː r aː j aː b ɒ n
ügyfélkapu	y c f eː l k ɒ p u
orchidea	o r ɦ i d ɛ ɒ
cirmosok	t͡s i r m o ʃ o k
eleme	ɛ l ɛ m ɛ
talpatlan	t ɒ l p ɒ t l ɒ n
pohárnok	p o ɦ aː r n o k
jussál	j u ʃː aː l
látásunk	l aː t aː ʃ u ŋ k
vezesselek	v ɛ z ɛ ʃː ɛ l ɛ k
gépén	ɡ eː p eː n
kollokvium	k o lː o k v i j u m
másvalami	m aː ʃ v ɒ l ɒ m i
legpiromániásabb	l ɛ k p i r o m aː n i j aː ʃ ɒ bː
tüdejű	t y d ɛ j yː
legelektronikusabb	l ɛ ɡ ɛ l ɛ k t r o n i k u ʃ ɒ bː
olvasson	o l v ɒ ʃː o n
reggelenként	r ɛ ɡː ɛ l ɛ ŋ k eː n t
kórokok	k oː r o k o k
átáll	aː t aː lː
egybeírt	ɛ ɟ b ɛ iː r t
sertésinfluenza	ʃ ɛ r t eː ʃ i ɱ f l u ɛ n z ɒ
csehovi	t͡ʃ ɛ ɦ o v i
mandulagyulladások	m ɒ n d u l ɒ ɟ u lː ɒ d aː ʃ o k
tarhál	t ɒ r ɦ aː l
esztendő	ɛ s t ɛ n d øː
szempontja	s ɛ m p o ɲ c ɒ
körzetektől	k ø r z ɛ t ɛ k t øː l
hivatal	h i v ɒ t ɒ l
őszebb	øː s ɛ bː
retteg	r ɛ tː ɛ ɡ
úttörő	uː tː ø r øː
színtelenebb	s iː n t ɛ l ɛ n ɛ bː
biztosítani	b i s t o ʃ iː t ɒ n i
dolgáért	d o l ɡ aː j eː r t
antimonok	ɒ n t i m o n o k
megszületik	m ɛ k s y l ɛ t i k
vonatkoztatási	v o n ɒ t k o s t ɒ t aː ʃ i
diszpécserek	d i s p eː t͡ʃ ɛ r ɛ k
égzengés	eː ɡ z ɛ ŋ ɡ eː ʃ
centralizációk	t͡s ɛ n t r ɒ l i z aː t͡s i j oː k
vátesz	v aː t ɛ s
akárkik	ɒ k aː r k i k
késhegy	k eː ʃ h ɛ ɟ
szemölcsök	s ɛ m ø l t͡ʃ ø k
olyanokba	o j ɒ n o ɡ b ɒ
telítődik	t ɛ l iː t øː d i k
vakondok	v ɒ k o n d o k
párszor	p aː r s o r
ára	aː r ɒ
födém	f ø d eː m
valójában	v ɒ l oː j aː b ɒ n
balhék	b ɒ l ɦ eː k
váltok	v aː l t o k
törvényszegő	t ø r v eː ɲ s ɛ ɡ øː
összezavar	ø sː ɛ z ɒ v ɒ r
erkölcstelenebb	ɛ r k ø l t͡ʃ t ɛ l ɛ n ɛ bː
habban	h ɒ bː ɒ n
bóján	b oː j aː n
perdül	p ɛ r d y l
csincsilla	t͡ʃ i n t͡ʃ i lː ɒ
nyálka	ɲ aː l k ɒ
körcikk	k ø r t͡s i kː
lerontás	l ɛ r o n t aː ʃ
kezeinket	k ɛ z ɛ j i ŋ k ɛ t
ágú	aː ɡ uː
mellékszereplő	m ɛ lː eː k s ɛ r ɛ p l øː
műszerészek	m yː s ɛ r eː s ɛ k
anorák	ɒ n o r aː k
narancsszínűbb	n ɒ r ɒ n t͡ʃ s iː n yː bː
diófáid	d i j oː f aː j i d
zsinegek	ʒ i n ɛ ɡ ɛ k
kellhet	k ɛ l ɦ ɛ t
jázmin	j aː z m i n
vihar	v i ɦ ɒ r
ostyáitok	o ʃ c aː j i t o k
villákon	v i lː aː k o n
töredezettségmentesítő	t ø r ɛ d ɛ z ɛ t͡ʃː eː ɡ m ɛ n t ɛ ʃ iː t øː
cédrusfája	t͡s eː d r u ʃ f aː j ɒ
felmelegedés	f ɛ l m ɛ l ɛ ɡ ɛ d eː ʃ
helyektől	h ɛ j ɛ k t øː l
tudtalak	t u tː ɒ l ɒ k
zabok	z ɒ b o k
osztható	o s t h ɒ t oː
vitathatatlanabb	v i t ɒ t h ɒ t ɒ t l ɒ n ɒ bː
szervezetekké	s ɛ r v ɛ z ɛ t ɛ kː eː
ásunk	aː ʃ u ŋ k
exférj	ɛ k s f eː r ʝ
mibelőlünk	m i b ɛ l øː l y ŋ k
segédek	ʃ ɛ ɡ eː d ɛ k
bütyke	b y c k ɛ
kiken	k i k ɛ n
legrégibb	l ɛ ɡ r eː ɡ i bː
tanítsunk	t ɒ n iː t͡ʃː u ŋ k
értett	eː r t ɛ tː
hírhedt	h iː r ɦ ɛ tː
megmos	m ɛ ɡ m o ʃ
üss	y ʃː
cetli	t͡s ɛ t l i
bögrében	b ø ɡ r eː b ɛ n
borbolyák	b o r b o j aː k
dadaista	d ɒ d ɒ j i ʃ t ɒ
Moszkva	m o s k v ɒ
meghalad	m ɛ k h ɒ l ɒ d
kötések	k ø t eː ʃ ɛ k
várostérképre	v aː r o ʃ t eː r k eː p r ɛ
beágyaz	b ɛ aː ɟ ɒ z
törniük	t ø r n i j y k
fürdj	f y r ɟ
váltanál	v aː l t ɒ n aː l
számjegy	s aː m j ɛ ɟ
gyümölcshúsok	ɟ y m ø l t͡ʃ h uː ʃ o k
benini	b ɛ n i n i
versenyautók	v ɛ r ʃ ɛ ɲ ɒ u t oː k
elhatárol	ɛ l ɦ ɒ t aː r o l
kurbli	k u r b l i
jogászok	j o ɡ aː s o k
gyógysör	ɟ oː c ʃ ø r
amidet	ɒ m i d ɛ t
jóváhagyás	j oː v aː ɦ ɒ ɟ aː ʃ
hálózatot	h aː l oː z ɒ t o t
foglaltak	f o ɡ l ɒ l t ɒ k
