karak	ˈk a . r a k
nakhoda	n a ˈx o d a
irama	i r a m a
penelitian	p ə . n ə . l i . ˈt i . a n
mencium	m ə ɲ t͡ʃ i u m
zikir	ˈz i k ɪ r
padus	p a . d u s
kebakaran	k ə ˈb a . k a ˈr a n
torsi	t o r . s i
sijil	s i d͡ʒ ɪ l
patahan	p a ˈt a h a n
aldehida	a l d e ˈh i d a
pelarian	p ə . l a . ˈr i . a n
j	d͡ʒ e
eco	ˈe . t͡ʃ o
kerepek	k ə ˈr ɛ p ə k̚
penggiling	p ə ŋ . ɡ ɪ . l ɪ ŋ
dukung	ˈd u . k ʊ ŋ
lokalisir	l o k a l i s ɪ r
makanan	m a k a . n a n
J	d͡ʒ e
menyatakan	m ə ɲ a ˈt a k a n
ajara	ˈa d͡ʒ a r a
rancang	ˈr a n . t͡ʃ a ŋ
cahaya	t͡ʃ a ˈh a j a
angkruk	ˈa ŋ k r ʊ k̚
kandelir	k a n . d ə . ˈl ɪ r
perwakilan	p ə r w a ˈk ɪ l a n
krans	ˈk r a n s
hipernim	h i p ə r ˈn ɪ m
singgasana	s i ŋ . ɡ a . s a . n a
obesitas	o b ɛ . s i . t a s
argiria	a r ˈɡ i r i a̯
menggempita	m ə ŋ . ɡ ə m . p i . t a
ustaz	ˈʊ s t a z
lensa	l ɛ n s a
yo	j oː
jiwa	d͡ʒ i . w a
pemeriksaan	p ə m ə r ɪ k ˈs a a n
terpanjang	t ə r ˈp a n d͡ʒ a ŋ
ancak	ˈa n t͡ʃ a k̚
tekidanto	t ɛ . k i . d a n . t o
seri	ˈs e . r i
bunting	b ʊ n . t ɪ ŋ
micin	m i . t͡ʃ i n
Sabrina	ˈs a b r i n a
antolong	a n ˈt o l ɔ ŋ
mengingat	m ə ŋ ˈɪ ŋ a t̚
antaladan	a n . t a . ˈl a . d a n
seru	s ə ˈr u
kali	k a . l i
Sunda	ˈs ʊ n d a
baginda	b a ɡ i n d a
maljum	ˈm a l d͡ʒ u m
sepur	s ə ˈp u r
anjal	ˈa n d͡ʒ a l
analitis	a n a ˈl i t ɪ s
kumpulan	k ʊ m ˈp ʊ l a n
wizurai	w i ˈz u r a i̯
frekwensi	f r e k . w ɛ n . s i
salam	ˈs a l a m
nyiur	ˈɲ j u r
gundik	ˈɡ u n d i ʔ
elektris	ɛ l ɛ k . t r ɪ s
selalu	s ə l a l u
taat	ˈt a . ʔ a t̚
suka	ˈs u k a
L	ɛ l
negoisasi	n ɛ . ɡ o . s i . a . s i
kahar	ˈk a h a r
basantara	b a . s a n . ˈt a . r a
idap	ˈɪ d a p̚
KK	k a . k a
tanda	ˈt a n d a
stasi	s t a s i
fotosel	f o ˈt o s ɛ l
pleidoi	ˈp l e i . d o i̯
ekaristi	ɛ k a r i s t i
kapanewon	k a . p a . n e . w ɔ n
bikini	b i ˈk i n i
ompol	ˈo m . p o l
beruang	b ə ˈr u a̯ ŋ
badi	ˈb a d i
mangkuk	ˈm a ŋ k ʊ k̚
benik	b ə ˈn ɪ k̚
difraksi	d i . ˈf r a k . s i
perjaka	p ə r . ˈd͡ʒ a . k a
pranatal	p r a . ˈn a . t a l
karunia	k a r u n i a̯
oligarkis	o . l i . ˈɡ a r . k ɪ s
gulana	ɡ u l a n a
sepatu	s ə . p a . t u
memimpin	m ə ˈm ɪ m p ɪ n
dirgahayu	d i r . ɡ a . h a . j u
alel	ˈa . l ɛ l
ritsleting	r i t . s l ə . t i ŋ
kapitan	k a ˈp i t a n
cantik	t͡ʃ a n . t i k
Norwegia	n ɔ r . w e . ɡ i a̯
weker	w ɛ . k ə r
layanan	l a ˈj a n a n
kapan	k a . p a n
terima	t ə ˈr i m a
sosialisme	s o s i a l ˈɪ s m ə
lenga	l ə . ˈŋ a
perintah	p ə ˈr ɪ n t a h
busana	b u . s a . n a
menyusun	m ə . ɲ u . s ʊ n
daur	ˈd a ʊ r
seronok	s ə . ˈr o . n ɔ ʔ
inflasi	ɪ n . ˈf l a . s i
veteriner	v ɛ . t ə . ˈr i . n ɛ r
kaki	ˈk ä . k i
KTSP	k a t e ˈɛ s p e
ecer	ˈɛ t͡ʃ ɛ r
berat	b ə ˈr a t
hanya	h a . ɲ a
hidayah	h i ˈd a j a h
pengecaman	p ə . ŋ ə . ˈt͡ʃ a m . a n
qanun	q a n u n
pleno	ˈp l e n o
tapa	t a . p a
cadang	ˈt͡ʃ a . d a ŋ
gen	ˈɡ ɛ n
adaptif	ˈa d a p . t ɪ f
magang	ˈm a . ɡ a ŋ
slang	s ə l a ŋ
campur	t͡ʃ a m . p ʊ r
bahtera	b a h . t ə . r a
tenggorok	t̪ ə ŋ . ˈɡ o . r o k̚
baronsai	b a . r o n . s a i̯
pala	p a . l a
butun	ˈb u t u n
bakpau	b a k . p a ʊ̯
kilang	k i l a ŋ
besikal	b ə ˈs i . k a l
humanisme	h u . m a . ˈn ɪ s . m ə
memperkokoh	m ə m p ə r ˈk o k ɔ h
tekor	t ə . k o r
andir	ˈa n d ɪ r
mari	m a . r i
sagu	ˈs a ɡ o
avtur	ˈa f t ʊ r
tantangan	t a n ˈt a ŋ a n
kasar	ˈk a . s a r
batik	b a t ɪ k
ansos	a n . s o s
ester	ˈɛ s . t ə r
bantahan	b a n ˈt a h a n
ligamen	l i ˈɡ a m ɛ n
parang	ˈp a r a ŋ
bibi	ˈb i b i
anting	a n t i ŋ
balairung	b a . ˈl a i̯ . r ʊ ŋ
lues	l u . e s
kabuki	k a ˈb u k i
apa	a p a
aluakas	a l u ˈa k a s
apen	ˈa p ə n
tukar	ˈt u k a r
publisitas	p u b l i ˈs i t a s
laler	ˈl a . l ə r
cengkerawak	t͡ʃ ə ŋ . k ə . r a . w a k
asidulan	a s i . ˈd u . l a n
adpis	ˈa t̚ p ɪ s
kicauan	k i ˈt͡ʃ a u̯ a n
keseruan	k ə s ə ˈr u a n
asesmen	a s ɛ s m ə n
instrumen	ɪ n . ˈs t r u . m ɛ n
segel	s ɛ ɡ ə l
tertinggal	t ə r ˈt ɪ ŋ ɡ a l
Waruna	w a . r u . n a
jumlah	ˈd͡ʒ ʊ m l a h
magfirah	m a ʔ ˈf i r a h
andege	a n ˈd e ɡ e
anamolepo	a n a m o ˈl e p o
bersuasana	b ə r . ˈs u . w ä . r ä
gada	ɡ a d a
pembinaan	p ə m b i ˈn a a n
jasuke	d͡ʒ a ˈs u k e
heterogen	h e . t e . ˈr o . ɡ ɛ n
keras	k ə ˈr a s
angko	ˈa ŋ k o
diode	d i ˈo d ə
jasmani	d͡ʒ a s ˈm a n i
dojo	d o . d͡ʒ o
lubang	ˈl u b a ŋ
daster	ˈd a s t ɛ ɾ
fonemis	f o ˈn e m ɪ s
magis	ˈm a . ɡ ɪ s
Allah	ɑ l l ɑ h
tengok	ˈt e . ŋ ɔ k
bawang	ˈb a w a ŋ
ku	k u
anuitas	a . n u . ˈi . t a s
asmaraguna	a s . m a . r a . ˈɡ u . n a
keponakan	k ə p o ˈn a k a n
kedutaan	k ə d u t a a n
albatros	a l . ˈb a . t r ɔ s
pirus	ˈp i r ʊ s
audit	ˈa u̯ . d ɪ t
tiri	ˈt i r i
kacung	ˈk a t͡ʃ ʊ ŋ
langau	l a ŋ a u̯
kor	ˈk ɔ r
berbicara	b ə r b i t͡ʃ a r a
jujitsu	d ʒ u . d ʒ ɪ t . s u
letak	l ə ˈt a ʔ
ampa	ˈa m p a
gunung	ˈɡ u n u ŋ
memberikan	m ə m b ə r i k a n
tustel	t u s . t ɛ l
semak	s ə ˈm a ʔ
pistol	ˈp ɪ s t ɔ l
lauh	ˈl a ʊ h
determinasi	d e . t ɛ r . m i . ˈn a . s i
semah	s ə ˈm a h
cangklek	ˈt͡ʃ a ŋ k l e k̚
aforestasi	a f o r ɛ s ˈt a s i
efektif	ˈɛ f ɛ k̚ t ɪ f
bagi	b a . ɡ i
rantau	ˈr a n . t a u̯
fasakh	ˈf a s a ʔ
visus	ˈv i s ʊ s
tasbih	ˈt a s b ɪ h
zakat	ˈz a k a t̚
puji	p u . d͡ʒ i
unggah	ˈu ŋ ɡ a h
mendiamkan	m ə n d i a m k a n
memola	m ə ˈm o l a
SHUN	ɛ s h a ˈu ɛ n
dikau	d i k a u̯
ampilalas	a m p i ˈl a l a s
kertas	k ə r ˈt a s
ASEAN	a ˈs e a n
sarkas	ˈs a r k a s
anglung	a ŋ . l u ŋ
sulfur	ˈs ʊ l . f ʊ r
bersedia	a b o n ə m ɛ n
semong	s ə ˈm ɔ ŋ
arjer	ˈa r . d͡ʒ ɛ r
alas	a . l a s
puja	p u . d͡ʒ a
takar	ˈt a k a r
jenasah	d͡ʒ ə ˈn a s a h
penyelenggaraan	p ə . ɲ ə . l ə ŋ . ɡ a . ˈr a . a n
rindang	ˈr ɪ n d a ŋ
panekuk	p a . n ə . k u k
sungai	s u ŋ a i̯
basmi	b a s . m i
h	h a
ekskursi	ɛ k s ˈk ʊ r s i
gandar	ˈɡ a n . d a r
ansai	ˈa n . s a i̯
betonase	b ə t o ˈn a s ə
inset	i n s ɛ t
anakia	ˈa n a k i a̯
peranti	p ə ˈr a n t i
alodna	a . ˈl ɔ t . n a
paro	ˈp a r o
nyonya	ɲ o ɲ a
andurabian	a n d u r a ˈb i a n
antulawo	a n . t u . ˈl a . w o
bakpia	b a ʔ p i a̯
ahin	ˈa h ɪ n
tabal	ˈt a . b a l
elipsis	e . ˈl ɪ p . s ɪ s
jadwal	d͡ʒ a t̚ w a l
parah	ˈp a r a h
batangan	b a . t a ŋ . a n
anangkolaki	a n a ŋ k o ˈl a k i
kinase	k i . ˈn a . s ə
kekuasaan	k ə k u a ˈs a a n
graha	ɡ r a . h a
maja	ˈm a d͡ʒ a
helikopter	h e . l i . ˈk ɔ p . t ə r
gelis	ɡ ə . ˈl ɪ s
belasting	b ə . l a s . t i ŋ
sipil	s i p ɪ l
jenawi	d͡ʒ ə ˈn a w i
argo	ˈa r . ɡ o
asumsi	a ˈs ʊ m s i
sembrono	s ə m . ˈb ə̆ r o . n o
gandeng	ˈɡ a n . d ɛ ŋ
daun	ˈd a ʊ n
atmosferis	a t m ɔ s ˈf ɛ r ɪ s
keparat	k ə . p a . r a t
syabas	ˈʃ a . b a s
arunika	a . r u . ˈn i . k a
wuku	ˈw u . k u
bukti	b u k . t i
kwasiorkor	k w a s i ˈɔ r k ɔ r
lipur	l i . p ʊ r
naskah	ˈn a s . k a h
asmara	a s . m a . r a
hai	h a ɪ
dosen	d o . s ɛ n
tambur	ˈt a m b ʊ r
ribosom	r i ˈb o s ɔ m
capung	ˈt͡ʃ a p ʊ ŋ
patriarki	p a . t r i . ˈa r . k i
berdasar	b ə r ˈd a s a r
perhentian	p ə r ˈh ə n t j a n
kruk	k r ʊ k
s'lalu	s l a . l u
geostasioner	ɡ e o s t a s i ˈo n ɛ r
aliah	a l i a h
keramik	k ə ˈr a m ɪ k̚
siang	s i . a ŋ
materai	m a . t ə . r a i
bancak	b a n t͡ʃ a ʔ
honje	ˈh ɔ n d͡ʒ e
berus	b ə ˈr ʊ s
indra	i n . d r a
geman	ɡ ə ˈm a n
harta	h a r . t a
guru	ɡ u . r u
Batam	ˈb a t a m
wortel	w o r . t ə l
sertifikat	s e r t i f i k a t
fiat	ˈf i a t
turun	ˈt u . r ʊ n
jelata	d͡ʒ ə . l a . t a
ikhlas	i x l a s
ateisme	a t e ˈɪ s m ə
jelas	d͡ʒ ə ˈl a s
salim	ˈs a l ɪ m
tepis	t ə . ˈp ɪ s
flan	ˈf l a n
menara	m ə ˈn a r a
angka	a ŋ k a
ekonomis	ɛ k o ˈn o m ɪ s
memperburuk	m ə m p ə r ˈb u r ʊ k̚
cempaka	t͡ʃ ə m . p a . k a
tautan	t a ˈʊ t a n
mudigah	m u ˈd i ɡ a h
aksiomatik	a k . s i . o . ˈm a . t ɪ k
balot	b a l ɔ t̚
ekstrinsik	ɛ k s . ˈt r ɪ n . s ɪ k
syahadat	ʃ a ˈh a . d a t̚
Anda	ˈa n d a
Irlandia	ɪ r ˈl a n d i a̯
ketat	k ə ˈt a t
membata	m ə m ˈb a t a
tahi	t a . h i
arya	a r . j a
slank	s l ɑ ŋ k
Mbojo	ˈm b o j o
pameget	p a . m ə . ɡ ə t
Indra	i n . d r a
tuwung	ˈt ʊ w ʊ ŋ
akrilamida	a k r i l a ˈm i d a
sentralistis	s ɛ n t r a ˈl ɪ s t ɪ s
C	t͡ʃ e
Surabaya	s u r a ˈb a j a
gamang	ˈɡ a m a ŋ
asal	ˈa . s a l
agih	ˈa ɡ ɪ h
antunga	a n . ˈt u . ŋ a
ngab	ŋ a b
pengucapan	p ə ŋ . u . ˈt͡ʃ a p . a n
ensiklopedi	ɛ n s i k l o ˈp ɛ d i
kelar	k ə . l a r
beban	b ə ˈb a n
nirkarat	n i r k a r a t
Jakarta	d͡ʒ a ˈk a r t a
dosin	ˈd o . s i n
finansial	f i n a n ˈs i a l
hiperaktivitas	h i . p ə r . a k . t i . ˈv i . t a s
gagal	ˈɡ a . ɡ a l
duktus	ˈd ʊ k̚ t ʊ s
abortus	ˈa b ɔ r t̪ ʊ s
tangga	ˈt a ŋ ɡ a
ꦢꦺꦱ	d e . s ɔ
Maret	ˈm a r ə t
romantis	r o ˈm a n t ɪ s
peria	p ə ˈr i a̯
sebar	s ə ˈb a r
aora	a . ˈo . r a
petik	p ə . ˈt ɪ k
marmer	ˈm a r m ə r
agmaman	a ɡ ˈm a m a n
amoh	ˈa m ɔ h
amin	ˈa . m ɪ n
spesifik	s p ɛ ˈs i f ɪ k̚
etika	ˈɛ t i k a
datang	ˈd a t a ŋ
pronomina	p r o . n o . ˈm i . n a
afirmasi	a f ɪ r ˈm a s i
kaf	k a f
harimau	h a ˈr i m a u̯
alpukat	a l p u k a t
netra	n ə t . r a
Daffa	ˈd a f a
lepra	l ɛ p r a
angsana	a ŋ ˈs a n a
tamtama	t a m ˈt a m a
langka	ˈl a ŋ k a
tegak	t ə ˈɡ a k̚
kompet	ˈk ɔ m p ɛ t̚
m	ɛ m
KY	ˈk a j e
aplaus	a p . l a . u s
sampir	ˈs a m p ɪ r
tunjangan	t ʊ n ˈd͡ʒ a ŋ a n
hipotenusa	h i p o t ə ˈn u s a
mudra	m u d . r a
lengah	ˈl ɛ ŋ a h
Petrus	ˈp ɛ t r ʊ s
nafiri	n a ˈf i r i
anfakah	a n ˈf a k a h
anta	ˈa n t a
wewenang	w ə . w ə . ˈn a ŋ
ampot	ˈa m p ɔ t̚
daidanco	d a i . d a n . t͡ʃ o
katode	k a . t o . d ə
produk	ˈp r o . d ʊ k
perunggu	p ə . ˈr ʊ ŋ . ɡ u
karsa	k a r s a
balumba	b a ˈl ʊ m b a
Belanda	b ə . l a n . d a
kanstin	ˈk a n . s t ɪ n
khalayak	x a ˈl a j a ʔ
peringatan	p ə r ˈɪ ŋ a t̚ a n
penjahat	p ə n ˈd͡ʒ a h a t̚
pakaian	p a ˈk a j a n
asuhan	a . ˈs ʊ h . a n
mantel	ˈm a n . t ə l
resesi	r ɛ ˈs ɛ s i
seprei	s ə p . r e i
gang	ɡ a ŋ
laku	ˈl a k u
soang	s o a̯ ŋ
pulau	ˈp u l a u̯
menganiayai	m ə ŋ a n i a j a i
kehidupan	k ə . h i . ˈd ʊ p . a n
penjagaan	p ə n ˈd͡ʒ a . ɡ a . a n
manti	ˈm a n t i
serdadu	s ə r ˈd a d u
ibukota	i . b u . k o . t a
piket	p i k ɛ t̚
pokok	ˈp o k ɔ k̚
alasan	ˈa l a s a n
pantau	ˈp a n t a u̯
lasik	l a . s i k
Habel	h a b e l
pecah	p ə ˈt͡ʃ a h
tebusan	t ə . b u . s a n
gaz	ˈɡ a z
aksara	a k . s a . r a
berlibur	b ə r ˈl i b ʊ r
risalah	r i ˈs a l a h
dorna	d o r n a
PHBS	p e h a ˈb e ɛ s
semir	s ə ˈm i r
sintas	ˈs ɪ n t a s
bobot	ˈb o . b ɔ t̚
rakyat	ˈr a k j a t
akil	a . k ɪ l
angkrok	ˈa ŋ k r ɔ k̚
lateral	l a . t ə . ˈr a l
lelangit	l ə . ˈl ä . ŋ ɪ t̪̚
cuitan	t͡ʃ u ˈɪ t̚ a n
epitel	ˈɛ p i t ɛ l
insaf	i n . s a f
Februari	f ɛ b r u ˈa r i
amer	ˈa m ɛ r
keluar	k ə . l u . a r
fatamorgana	f a t a m ɔ r ˈɡ a n a
antrap	ˈa n t r a p̚
aler	ˈa l ɛ r
soba	s o . b a
silabis	s i . ˈl a . b ɪ s
bentar	b ə n ˈt a r
belanjaan	b ə ˈl a n . d͡ʒ a ʔ a n
masih	m a . s i h
pemeruman	p ə m ə ˈr u m a n
kebut	k ə ˈb ʊ t̚
praktik	ˈp r a k̚ t ɪ k̚
cendana	t͡ʃ ə n . d a . n a
delesi	d e . l e . s i
eksponen	ɛ k s . ˈp o . n ɛ n
abalalu	a b a ˈl a l u
asbabulwurud	a s . b a . b ʊ l . ˈw u . r ʊ t
autokrasi	a u t o k r a s i
makna	ˈm a ʔ n a
bengkel	ˈb ɛ ŋ k ɛ l
sulit	ˈs u l ɪ t̚
kotor	k o t o r
afsun	ˈa f s ʊ n
tamatan	t a ˈm a t̚ a n
arus	ˈa . r ʊ s
blek	b l ɛ k
mudah	m u d a h
debus	d ə ˈb ʊ s
bupati	b u . p a . t i
angsang	ˈa ŋ s a ŋ
kebidanan	k ə . b i . ˈd a n . a n
kolega	k o ˈl e ɡ a
tato	ˈt a t o
membawa	m ə m ˈb a w a
pupuk	ˈp ʊ p ʊ ʔ
parwa	ˈp a r w a
margin	ˈm a r . ɡ ɪ n
agihan	a ɡ i h a n
agung	ˈa ɡ ʊ ŋ
videografer	v i d e o ˈɡ r a f ə r
instrumentasi	ɪ n . s t r u . m ɛ n . ˈt a . s i
kini	ˈk i n i
ampul	a m . p ʊ l
petahana	p ə t a ˈh a n a
ankanan	a n ˈk a n a n
deaminasi	d e a m i ˈn a s i
rapat	ˈr a p a t
beli	b ə ˈl i
desalinasi	d e . s a . l i . ˈn a . s i
bangku	ˈb ä ŋ . k u
tenggeret	t ə ŋ ˈɡ ɛ r ɛ t
feodalisme	f e o d a l ˈɪ s m ə
sadeu	ˈs a d ɘ
berapa	b ə . r a . p a
vasodilatasi	v a s o d i l a ˈt a s i
plan	p l a n
solidaritas	s o . l i . d a . ˈr i . t a s
mertua	m ə r ˈt u a̯
kapal	k a . p a l
kek	k ɛ ʔ
menjijikkan	m ə n . d͡ʒ i . d͡ʒ ɪ ʔ . k a n
tanpa	ˈt a n p a
pekan	p ə k a n
kitab	ˈk i . t a p̚
instruksional	ɪ n . s t r ʊ k . s i . ˈo . n a l
vibrasi	v i . ˈb r a . s i
penyekatan	p ə ɲ ə ˈk a t a n
nuansa	n u ˈa n s a
atur	ˈa t ʊ r
ketimpangan	k ə t ɪ m ˈp a ŋ a n
adempauze	a d ə m . p a u̯ . z ə
etude	e t u d ɛ
molekuler	m o . l ə . ˈk u . l ɛ r
eling	ˈe . l ɪ ŋ
spesifisitas	s p e s i f i ˈs i t a s
radius	r a ˈd i ʊ s
adil	a . d i l
terkait	t ə r ˈk a ɪ t̚
ponpes	ˈp ɔ n p ə s
empal	ə m . ˈp a l
Olimpiade	o . l ɪ m . p i . ˈa . d ə
seharian	s ə . h a . r i . a n
widyaiswara	w i t j a i s ʋ a r a
visum	ˈv i s ʊ m
kandela	k a n . ˈd e . l a
apoking	a . ˈp o . k ɪ ŋ
Habil	h a b ɪ l
estafet	ɛ s . t a . f ɛ t
koki	k o . k i
itas	i t a s
penyiksaan	p ə . ɲ ɪ k . ˈs a . a n
tanya	t a . ɲ a
mengetatkan	m ə ŋ ə t a t̚ k a n
polis	p o . l ɪ s
muwakil	m u w a k i l
ubin	ˈu b i n
blumbak	ˈb l ʊ m b a k̚
serong	ˈs ɛ r ɔ ŋ
mantri	m a n t ə r i
tersebar	t ə r s ə ˈb a r
mengimbuh	m ə ŋ . i m . b u h
sinergi	s i . ˈn ɛ r . ɡ i
jawab	d͡ʒ a . w a p̚
transkripsi	t r a n ˈs k r ɪ p s i
Indonesia	i n . ˈd o . n ɛ . s ɪ . j a
min	ˈm ɪ n
genta	ɡ ə n t a
kamikaze	k a m i k a z e
hilang	h i l a ŋ
taring	t a . r ɪ ŋ
ancaman	a n . t͡ʃ a . m a n
suplai	ˈs ʊ p l a i̯
tamat	ˈt a m a t̚
antardesa	a n t a r ˈd ɛ s a
pemompaan	p ə m ɔ m ˈp a a n
waja	ˈw a d͡ʒ a
tatap	t a . t a p̚
hechting	h ɛ k̚ t ɪ ŋ
apologi	a p o ˈl o ɡ i
Turki	ˈt u r k i
kanonis	k a n o n ɪ s
mag	ˈm ɑ h
adijana	a . d i . ˈd͡ʒ a . n a
transformasi	t r a n s . f ɔ r . ˈm a . s i
iktibar	ɪ ʔ ˈt i b a r
Merkurius	m ɛ r . k u . ˈr i . ʊ s
melekas	m ə l ə ˈk a s
ageisme	a ɡ e ˈɪ s m ə
reduksi	r e ˈd ʊ k s i
berak	b ɛ . r a k
bingar	ˈb i ŋ a r
laman	l a . m a n
sumatif	s u . ˈm a . t ɪ f
doyo	d o . j o
tunda	ˈt ʊ n d a
steker	a b o n ə m ɛ n
puntung	p ʊ n t ʊ ŋ
ananim	ˈa n a n ɪ m
handschoen	h a n . s ə k ʊ n
kap	ˈk a p̚
inversi	ɪ n . ˈv ɛ r . s i
sandar	ˈs a n d a r
papa	p a . p a
asiri	ˈa s i r i
perhatian	p ə r . h a . ˈt i . a n
anggara	a ŋ ˈɡ a r a
retorika	r e t o ˈr i k a
derita	d ə . r i . t a
menikah	m ə n i k a h
binasa	b i . n a . s a
piktogram	p ɪ k . ˈt o . ɡ r a m
keberatan	k ə b ə ˈr a t a n
bawah	ˈb a w a h
tunang	ˈt u . n a ŋ
pura	p u . r a
toilet	ˈt o i̯ . l ɛ t̚
kelapa	k ə ˈl a p a
nasabah	n a ˈs a b a h
kedaluwarsa	k ə . d a . l u . ˈw a r . s a
memilih	m ə . m i . l i h
transparan	t r a n s ˈp a r a n
terjelas	d͡ʒ ə ˈl a s
daidan	d a i . d a n
e	e
terorisme	t e . r ɔ r . ˈɪ s . m ə
autotrof	a u̯ . t o . t r o f
angkasawan	a ŋ k a s a w a n
adiwastra	a d i ˈw a s t r a
awar	ˈa w a r
mesjid	m ə s ˈd͡ʒ ɪ t̚
anua	a . ˈn u . a
Jokowi	d͡ʒ o ˈk o w i
orang	o . r a ŋ
lengkuas	l ə ŋ . ˈk u . a s
meritokratis	m e . r i . t o . ˈk r a . t ɪ s
parut	ˈp a . r ʊ t
influen	ɪ n ˈf l u ɛ n
pinta	ˈp i n t a
gita	ɡ i . t a
gugur	ˈɡ u . ɡ ʊ r
alat	a l a t
ancur	ˈa n . t͡ʃ ʊ r
resep	r ə ˈs ɛ p
amfibi	a m ˈf i b i
aktuator	a k t u ˈa t ɔ r
zalir	ˈz a l i r
bibir	ˈb ɪ . b ɪ r
askese	a s k e s ə
koneksi	k o n ɛ k s i
umur	u m ʊ r
jangka	ˈd͡ʒ a ŋ k a
arloji	a r l o d͡ʒ i
adipenghantar	a d i p ə ŋ ˈh a n t a r
sensei	s e n . s e i
pencucian	p ə n t͡ʃ u t͡ʃ iʲ a n
BNN	b e ˈɛ n ɛ n
sekresi	s ə ˈk r e s i
akeo	a k e o
semayam	s ə ˈm a j a m
dekat	d ə ˈk a t
kontestan	k ɔ n ˈt ɛ s t a n
jang	ˈj a ŋ
mula	m u l a
inspirasi	ɪ n s p i ˈr a s i
hayati	h a . j a . t i
gravir	ˈɡ r a . v ɪ r
segitiga	s ə . ɡ i . t i . ɡ a
peres	ˈp ɛ . r ɛ s
sampai	s a m p a i̯
mitos	m i t o s
estetis	ɛ s ˈt ɛ t ɪ s
ambataron	a m b a ˈt a r ɔ n
prasada	p r a . s a . d a
abur	ˈa b ʊ r
duren	ˈd u . r ɛ n
tamadun	t a . ˈm a . d ʊ n
geulis	ɡ ɘ . ˈl ɪ s
ais	ˈa ʔ ɪ s
warkat	ˈw a r . k a t
amporo	a m ˈp o r o
juta	d͡ʒ u t a
gangsa	ˈɡ a ŋ . s a
magnet	ˈm a k . n ɛ t
aviditas	a . v i . ˈd i . t a s
ꦱꦺꦮ	s e w a
lokapasar	l o k a ˈp a s a r
handasah	h a n ˈd a s a h
handal	h a n d a l
kembang	k ə m ˈb a ŋ
linear	l i ˈn ɛ a r
tobang	t o . b a ŋ
adenosina	a . d e . n o . ˈs i . n a
kaji	k a d͡ʒ i
arwah	ˈa r . w a h
perlengkapan	p ə r . l ə ŋ . ˈk a p . a n
kesenjangan	k ə . s ə n . d͡ʒ a ŋ . a n
memakan	m ə . m a k a n
berantas	b ə ˈr a n t a s
dekan	d e k a n
kehujanan	k ə ˈh u d͡ʒ a n a n
anumerta	a n u . m ə r . t a
katoda	k a . t o . d a
Jepang	d͡ʒ ə ˈp a ŋ
pemuliaan	p ə m u ˈl i a̯ a n
herbisida	h ɛ r b i ˈs i d a
aerasi	a e ˈr a s i
kelahiran	k ə . l a . ˈh ɪ r . a n
arhir	ˈa r . h ɪ r
dosa	d o s a
onigiri	o . n i . ɡ i . r i
cabai	ˈt͡ʃ a b a j
jenazah	d͡ʒ ə ˈn a z a h
kecap	k ɛ t͡ʃ a p
panas	p a . n a s
sapa	ˈs a . p a
pit	ˈp ɪ t
kobak	ˈk o b a ʔ
amplokan	a m ˈp l o k a n
sementara	s ə m ə n ˈt a r a
angki	ˈa ŋ k i
lenjer	l ə n ˈd͡ʒ ə r
angin	ˈa ŋ i n
pionir	p i o n ɪ r
anaheha	a n a ˈh e h a
kop	k o p
satah	ˈs a t a h
keripik	k ə ˈr i p ɪ k̚
akar	a . k a r
kopitiam	k o p i t i a m
alwah	ˈa l w a h
Iduladha	i d u l ˈa d a
bak	b a k
emoji	e . m o . d͡ʒ i
titinada	t i . t i . ˈn a . d a
mentol	ˈm ɛ n . t ɔ l
dokumentografi	d o k u m ɛ n t o ˈɡ r a f i
wajah	ˈw a . d͡ʒ a h
piranti	p i ˈr a n t i
perabuan	p ə r ˈa b u a n
selak	ˈs e . l a k
deduktif	d e ˈd ʊ k t ɪ f
sentimen	s ɛ n . ˈt i . m ɛ n
fantastis	f a n ˈt a s t ɪ s
harap	h a . r a p
akresi	a . ˈk r e . s i
proklamasi	p r o k l a ˈm a s i
maestro	m a . ˈɛ s . t r o
romusya	r o . m u . ʃ a
adodui	ˈa d o d u i̯
kontingensi	k ɔ n . t i . ˈŋ ɛ n . s i
kenyataan	k ə . ɲ a . ˈt a . a n
duka	d u . k a
hijau	ˈh i d͡ʒ a w
pajanan	p a . ˈd͡ʒ a n . a n
badek	ˈb a . d ə k
komisi	k o ˈm i . s i
terbit	t ə r ˈb ɪ t̚
asalamualaikum	a s . s a . ˌl a m . m u . a . l a j ˈk u m
otot	ˈɔ t ɔ t
kekosongan	k ə k o ˈs o . ŋ a n
kesukaran	k ə . s u . ˈk a r . a n
isu	ˈɪ s u
sopir	ˈs o p ɪ r
bidadari	b i . d a . d a . r i
obrol	ˈɔ b r ɔ l
tirta	t i r . t a
berdarah	b ə r ˈd a r a h
batur	ˈb a t ʊ r
ketersediaan	k ə . t ə r . s ə . d i . ˈa . a n
fiskal	ˈf ɪ s . k a l
suara	s u . ˈw ä . r ä
pasokan	p a ˈs ɔ k a n
pernah	p ə r . n a h
japri	d͡ʒ a . p r i
damkar	d a m . k a r
tegas	t ə ˈɡ a s
antik	a n . t i k
taaruf	t a a r u f
kesegarisan	k ə . s ə . ɡ a . ˈr ɪ s . a n
audiometri	a u̯ . d i . o . ˈm e . t r i
hayat	h a . j a t̚
Bibel	ˈb i . b ə l
merusak	m ə r u s a ʔ
rongga	ˈr ɔ ŋ . ɡ ä
ucul	u . t͡ʃ u l
wol	ˈw o l
chindo	t͡ʃ i n d o
bungsu	b u ŋ s u
harmonisasi	h a r . m o . n i . ˈs a . s i
memberantakkan	m ə m . b ə . r a n . t a k . k a n
raga	r a . ɡ a
antariksawan	a n t a r ɪ k s a w a n
kehausan	k ə . h a ʊ s . a n
etik	ˈɛ t ɪ k
teokratis	t e o ˈk r a t ɪ s
homeostasis	h o m e o ˈs t a s ɪ s
jazirah	d͡ʒ a ˈz i r a h
ini	ˈi n i
ligan	ˈl i . ɡ a n
obsidian	ɔ p . s i . ˈd i . a n
kusuma	k u s u m a
bayangan	b a ˈj a ŋ a n
siram	ˈs i . r a m
sapu	ˈs a . p u
rela	ˈr e . l a
amput	ˈa m p ʊ t̚
nisbah	ˈn ɪ s b a h
Surakarta	s u r a k a r t a
memberi	m ə m b ə r i
anghun	a ŋ . h u n
diperkokoh	d i p ə r ˈk o k ɔ h
kompetisi	k ɔ m p ə ˈt i s i
deplesi	d e ˈp l e s i
duit	d u . i t
muamalah	m u a m a l a h
kartografer	k a r t o ˈɡ r a f ə r
permutasi	p ə r m u ˈt a s i
akselerasi	a k s e l ə ˈr a s i
praktek	ˈp r a k̚ t ɛ k̚
lapis	ˈl a . p ɪ s
cakram	t͡ʃ a k . r a m
Ngawi	ŋ a ˈw i
pasang	ˈp a . s a ŋ
tabu	ˈt a b u
embrio	ɛ m ˈb r i o
WA	w e . ʔ a
heng	h ɛ ŋ
agar	ˈa ɡ a r
cenderasa	t͡ʃ ə n . d ə . r a . s a
piadah	p i ˈa d a h
bayu	b a j u
benda	b ə n . d a
membangun	m ə m ˈb a ŋ u n
wagyu	w a . ɡʲ u
altitudo	a l t i ˈt u d o
ijazah	ˈɪ d͡ʒ a z a h
jadi	d ʒ a . d i
sri	s ə r i
Finlandia	f ɪ n ˈl a n d i a̯
asid	ˈa s ɪ t
menghukum	m ə ŋ . h u . k ʊ m
kimus	ˈk i m ʊ s
perserikatan	p ə r . s ə . r i . ˈk a t . a n
meong	ˈm e . o ŋ
canggih	t͡ʃ a ŋ . ɡ i h
komet	ˈk o . m ɛ t̚
bibit	ˈb i b ɪ t̚
astana	a s . t a . n a
keruh	k ə ˈr ʊ h
amanra	ˈa m a n r o
Callista	ˈk a l i s t a
gelita	ɡ ə l i t a
sabo	s a . b o
devisa	d e . ˈv i . s a
ḍiri	a b o n ə m ɛ n
Belarus	b e ˈl a r ʊ s
cowok	t ʃ o . w o ʔ
kecam	k ə . ˈt͡ʃ a m
swatantra	s ʋ a t a n t r a
tayamum	t a ˈj a m ʊ m
plak	p l a k
psikolog	p ə s i ˈk o l ɔ k̚
digdaya	d i ɡ . d a . j a
resorpsi	r e ˈs ɔ r p s i
sa	s a
pecutan	p ə ˈt͡ʃ ʊ t a n
rendah	r ə n d a h
keanekaragaman	k ə . a . n ɛ . k a . r a . ɡ a . m a n
akidah	ˈa k i d a h
konjungtiva	k ɔ n d͡ʒ ʊ ŋ ˈt i v a
batang	b a t a ŋ
riol	ˈr i . ɔ l
situasional	s i t u a s i ˈo n a l
membranofon	m ɛ m b r a ˈn o f ɔ n
I	i
impas	ˈɪ m p a s
anfal	a n . f a l
KHS	k a ˈh a ɛ s
beledu	b ə l ə d u
kolektivitas	k o l ɛ k t i ˈv i t a s
bersenandung	b ə r s ə ˈn a n d ʊ ŋ
fajar	ˈf a d͡ʒ a r
transfigurasi	t r a n s f i ɡ u ˈr a s i
menghadap	m ə ŋ . ˈh a . d a p
makan	m a . k a n
balik	ˈb a l ɪ k̚
Isa	i s a
nasi	ˈn a s i
julang	ˈd͡ʒ u l a ŋ
ambong	ˈa m b ɔ ŋ
gender	ˈɡ ɛ n d ə r
sendawa	s ə n . d a . w a
penerapan	p ə . n ə . ˈr a p . a n
mantan	ˈm a n t a n
seterika	s ə . t ə . r i . k a
amporang	a m ˈp o r a ŋ
personalitas	p ə r s o n a ˈl i t a s
elektrode	ɛ . l ɛ k . t r o . d e
kitas	k i . t a s
incung	ˈɪ n t͡ʃ ʊ ŋ
mukminin	m ʊ ʔ ˈm i n ɪ n
editor	ˈɛ d i t ɔ r
Indo	ˈɪ n d o
afdeling	a f . d e . l i ŋ
kemenakan	k ə m ə ˈn a k a n
tukang	ˈt u . k a ŋ
watas	ˈw a t a s
pembakuan	p ə m . b a . ˈk u . a n
bruder	b r u d ə r
timah	ˈt i m a h
abam	ˈa b a m
berambang	b ə . ˈr a m . b a ŋ
eceran	ˈɛ t͡ʃ ɛ r a n
peta	p ə ˈt a
apek	a . p ɛ k
barah	ˈb a . r a h
aruna	ˈa r u n a
Maroko	m a . ˈr o . k o
arapota	a . r a . ˈp o . t a
umi	ˈʊ m i
y	j e
pikir	ˈp i k ɪ r
pembilang	p ə m ˈb i l a ŋ
rames	ˈr a . m ə s
pengudaraan	p ə ŋ u d a ˈr a a n
pemufakatan	p ə m u f a ˈk a t a n
adikara	a d i . k a . r a
mukbang	ˈm ʊ k b ɑ ŋ
slogan	s ə̆ l o . ɡ a n
akelit	ˈa k ɛ l ɪ t̚
sabit	ˈs a b ɪ t̚
kunjung	ˈk ʊ n . d͡ʒ ʊ ŋ
penegakan	p ə . n ə . ˈɡ a k . a n
Injil	ˈɪ n . d͡ʒ ɪ l
andalas	a n . ˈd a . l a s
empati	ɛ m ˈp a t i
Italia	ɪ ˈt a l i a̯
kencana	k ə n . t͡ʃ a . n a
kening	ˈk ə . n ɪ ŋ
aktan	ˈa k̚ t a n
meninggal	m ə ˈn ɪ ŋ ɡ a l
nekrokrasi	n e k r o k r a s i
grup	ˈɡ r ʊ p̚
aeropolis	a e r o ˈp o l ɪ s
jernih	d͡ʒ ə r ˈn i h
membutir	m ə m ˈb u t i r
Palu	p a . l u
rogol	ˈr ɔ . ɡ ɔ l
berubah	b ə r ˈʊ b a h
bakcang	b a ʔ . t͡ʃ a ŋ
suvenir	s u v ə ˈn ɪ r
amplek	ˈa m p l ɛ k̚
mahakuasa	m a h a k u a s a
giat	ˈɡ i a t̚
malik	ˈm a . l ɪ ʔ
jagung	ˈd͡ʒ a ɡ ʊ ŋ
mengencingi	m ə . ŋ e n . c i ŋ . i
mencatat	m ə n ˈt͡ʃ a t a t̚
sinse	s i n . s e
lulusan	l u ˈl ʊ s a n
idealisme	i . d e . a l . ˈɪ s . m ə
pandemi	p a n ˈd e m i
akseptasi	a k . s ɛ p . ˈt a . s i
onagata	o . n a . ɡ a . t a
alir	ˈa . l ɪ r
fluks	ˈf l ʊ k s
anggana	a ŋ ˈɡ a n a
udah	u . d a h
gala	ɡ a l a
sprint	ˈs p r ɪ n t
sanawiah	s a n a ˈw i a h
dana	d a . n a
idep	ˈɪ d ə p̚
staf	s t a f
pengacakan	p ə ŋ . ˈa t͡ʃ a k . a n
alokai	ˈa l o k a i̯
ortu	o r . t u
majusi	m a ˈd͡ʒ u s i
ampu	ˈa m . p u
mampu	m a m p u
ꦔꦺꦴꦏꦺꦴ	ŋ ɔ k ɔ
wicara	w i . t͡ʃ a . r a
lusin	ˈl u s i n
anjing	ˈa n d͡ʒ i ŋ
hembus	h ə m ˈb u s
pelembapan	p ə . l ə m . ˈb a p . a n
swasta	s w a s t a
bangsat	b a ŋ . s a t
cagar	ˈt͡ʃ a . ɡ a r
isama	i s a m a
alanggaya	a l a ŋ ˈɡ a j a
perasat	p ə . ˈr a . s a t
bacot	b a ˈc o t
amar	ˈa m a r
kabus	k a b ʊ s
greha	ɡ r ə . h a
celapa	t͡ʃ ə . l a . p a
rusak	r u . s a k̚
meletus	m ə l ə t u s
brahmana	b r a h ˈm a n a
cemani	t͡ʃ ə . m a . n i
eksperimen	ɛ k s p ɛ ˈr i m ɛ n
ayah	a . j a h
tabut	ˈt a b ʊ t̚
amra	a m r a
pelan	p ə ˈl a n
rungu	ˈr u . ŋ u
regu	r ə ˈɡ u
bersama	b ə r s a m a
tindas	ˈt ɪ n d a s
spesies	s p ɛ . ˈs i . ɛ s
aboi	ˈa . b o i̯
esa	ə . s a
muka	m u k a
yudisium	j u d i ˈs i ʊ m
alamete	a l a ˈm ɛ t e
kepatuhan	k ə . p a . ˈt ʊ h . a n
kepada	k ə ˈp a d a
ramai	ˈr a m a i̯
difusi	d i ˈf u s i
IP	ˈi . p e
punya	ˈp u ɲ a
muluk	ˈm u . l ʊ ʔ
bihun	b i . h u n
sini	ˈs i n i
DIY	d e i ˈj e
kelas	k ə ˈl a s
sembilan	s ə m . ˈb i . l ä n
kuintal	ˈk w i n t a l
aib	aʲ i b
penghancuran	p ə ŋ h a n ˈt͡ʃ ʊ r a n
resleting	r e s . l ɛ . t i ŋ
buka	ˈb u k a
sambilan	s a m . ˈb ɪ l . a n
dusta	ˈd u s t a
iga	ˈɪ ɡ a
peradilan	p ə r . a . ˈd ɪ l . a n
membunuh	m ə m b u n ʊ h
engkau	ə ŋ k a u̯
tahap	ˈt a . h a p
gastrointestinal	ɡ a s . t r o . ɪ n . t ɛ s . ˈt i . n a l
penguatan	p ə ŋ u ˈa t̚ a n
iklan	ˈɪ k l a n
cogan	t͡ʃ o . ɡ a n
takoyaki	t a . k o . j a . k i
adhesif	a b o n ə m ɛ n
gandu	ˈɡ a n d u
sadir	ˈs a d ɪ r
rem	ˈr ɛ m
IPM	i ˈp ɛ ɛ m
sana	ˈs a n a
fonem	ˈf o n ɛ m
coli	t͡ʃ o . l i
sumo	s u . m o
rabies	r a . ˈb i . ɛ s
lobang	ˈl o b a ŋ
tempeleng	t ə m . ˈp e . l ɛ ŋ
bagel	ˈb a ɡ ə l
sedang	s ə ˈd a ŋ
boikot	ˈb o i̯ k ɔ t̚
artikula	a r . t i . ˈk u . l a
peka	ˈp e . k a
kosakata	k o . s a . ˈk a . t a
gerus	ɡ ə . ˈr ʊ s
kemanusiaan	k ə m a n u ˈs i a̯ a n
benih	b ə n ɪ h
interferensi	ɪ n t ə r f ə ˈr ɛ n s i
pembangkang	p ə m ˈb a ŋ k a ŋ
tepar	ˈt ɛ p a r
swafoto	s w a . f o . t o
beradab	b ə r ˈa d a p̚
perulangan	p ə r . ˈʊ l a ŋ . a n
galat	ˈɡ a l a t̚
kopra	ˈk o . p r a
utama	ˈu t a m a
hina	h i n a
elang	ˈə l a ŋ
sitoplasma	s i t o ˈp l a s m a
maka	ˈm a k a
jerami	d͡ʒ ə ˈr a m i
biku	b i . k u
penganjur	p ə ŋ ˈa n d͡ʒ ʊ r
rumus	ˈr u m ʊ s
formatif	f ɔ r . ˈm a . t ɪ f
tar	t a r
lokalisasi	l o k a l i s a s i
ketombe	k ə ˈt ɔ m b e
ketumbar	k ə ˈt ʊ m b a r
jeneng	ˈd͡ʒ ɛ . n ɛ ŋ
punia	p u . n i a̯
cita	t͡ʃ i . t a
takeyari	t a . k e . y a . r i
kolusi	k o ˈl u s i
gagak	ˈɡ a . ɡ a ʔ
bel	b ɛ l
persneling	p ə r . s n e . l i ŋ
awam	ˈa w a m
duane	d u ˈa n ə
gading	ɡ a . d i ŋ
ilah	ˈɪ l a h
perpanjangan	p ə r p a n ˈd͡ʒ a ŋ a n
simak	ˈs i m a ʔ
munsyi	m u n . ʃ i
luwes	ˈl u w ə s
uban	ˈu . b a n
endap	ə n . ˈd a p
kais	ˈk a . ɪ s
bam	ˈb a m
ilopasia	ɪ l o ˈp a s i a̯
dorong	d o r o ŋ
pelapukan	p ə . l a . ˈp ʊ k . a n
angkatan	a ŋ ˈk a t a n
dong	ˈd ɔ ŋ
uskup	u s . k ʊ p
poros	ˈp ɔ . r ɔ s
kolam	ˈk o . l a m
adenoma	a . d e . n o . m a
gravitasi	ɡ r a v i ˈt a s i
keibodan	k e i . b o . d a n
kayas	k a ˈj a s
kring	k r ɪ ŋ
lada	ˈl a d a
bugil	ˈb u ɡ ɪ l
tahu	ˈt a u
borgol	ˈb ɔ r ɡ ɔ l
auban	a u . b a n
determinisme	d e . t ɛ r . m ɪ n . ˈɪ s . m ə
Yogyakarta	j o ɡ j a k a r t a
asam	ˈa s a m
Nyonya	ɲ o ɲ a
titrasi	t i ˈt r a s i
mutasi	m u . t a . s i
bakiak	b a . k i . a k
balabad	b a ˈl a b a t̚
mewah	ˈm ɛ w a h
klem	ˈk l ɛ m
perban	p ə r . b a n
kendala	k ə n ˈd a l a
H	h a
kompi	ˈk ɔ m p i
akut	a . k u t
ketan	k ə ˈt a n
siomay	ˈs j o m a j
kartel	k a r . t ɛ l
margarin	m a r ˈɡ a r ɪ n
kusta	k ʊ s t a
seudati	s ɘ ˈd a t i
psikologis	p ə s i k o ˈl o ɡ ɪ s
aporia	a . p o . ˈr i . a
edaran	e . ˈd a r . a n
asyik	a . ʃ ɪ k
hibah	ˈh i b a h
warita	w a ˈr i t a
cerutu	t͡ʃ ə ˈr u t u
vasokonstriksi	v a s o k ɔ n s ˈt r ɪ k s i
koroner	k o ˈr o . n ɛ r
aneka	a n ɛ . k a
punca	ˈp ʊ n . t͡ʃ a
lansia	l a n ˈs i a
rehabilitasi	r e h a b i l i ˈt a s i
tangkap	ˈt a ŋ k a p̚
sima	ˈs i . m a
profesor	p r o ˈf ɛ . s ɔ r
sandang	ˈs a n d a ŋ
tabur	ˈt a b ʊ r
persentil	p ə r . ˈs ɛ n . t ɪ l
tuntut	t u n . t ʊ t
sebentar	s ə ˈb ə n t a r
tampung	ˈt a m p ʊ ŋ
dewana	d ɛ ˈw a n a
sutra	s u . t r a
edema	ˈe d e m a
matkul	m a t . k ʊ l
agen	ˈa . ɡ ɛ n
Bima	ˈb i m a
kemacetan	k ə m a t͡ʃ ə t ˈa n
vokal	ˈv o . k a l
persada	p ə r . s a . d a
kenan	k ə . ˈn a n
kriptogamik	k r ɪ p t o ˈɡ a m ɪ k
galak	ɡ a . l a k
aritmetika	a . r i t . m ɛ . t i . k a
pecut	p ə . ˈt͡ʃ ʊ t
sabar	ˈs a b a r
resistor	r e ˈs ɪ s t ɔ r
sarden	ˈs a r d ɛ n
kajur	ˈk a d͡ʒ u r
opium	ˈɔ p i ʊ m
sudah	ˈs u d a h
keterangan	k ə . t ə . r a . ŋ a n
katun	ˈk a t u n
rasio	ˈr a s i o̯
buta	b u . t a
oase	o ˈa s ə
herbarium	h ɛ r . b a . ˈr i . ʊ m
syogun	ʃ o . ɡ u n
tentara	t ə n ˈt a r a
debu	d ə ˈb u
eksplikatif	ɛ k s p l i ˈk a t ɪ f
sungkit	s ʊ ŋ k ɪ t
balur	ˈb a l ʊ r
kabisat	k a . ˈb i . s a t̚
padi	p a d i
takut	t a . k u t
lurah	ˈl u . r a h
ancumcum	a n ˈt͡ʃ ʊ m t͡ʃ ʊ m
penanda	p ə n a n d a
gigit	ˈɡ ɪ . ɡ ɪ t̚
among	ˈa m ɔ ŋ
loper	l o . p ə r
penguat	p ə ˈŋ u a t
hantu	ˈh a n . t u
tandang	ˈt a n . d a ŋ
reduksionisme	r e . d ʊ k . s i . o . ˈn ɪ s . m ə
waria	ˈw a . r i . j a
suci	s u . t͡ʃ i
bea	ˈb e a̯
ceroboh	ˈt ʃ ə . r o . b o h
baya	b a . j a
lantamal	l a n ˈt a m a l
anjul	ˈa n d͡ʒ ʊ l
lapuk	ˈl a p u k
jalan	d ʒ a . l a n
memperketat	m ə m p ə r k ə t a t
tepat	t ə . p a t
rumah	ˈr u m a h
suf	ˈs ʊ f
Salsabila	ˈs a l s a b i l a
palang	ˈp a l a ŋ
tenggorokan	t̪ ə ŋ . ˈɡ o . r o . k ä n
ahad	ˈa h a t̚
massal	ˈm a s s a l
sudut	ˈs u . d ʊ t
amau	a b u
belahan	b ə ˈl a h a n
nira	n i . r a
devosi	d e v o s i
penderita	p ə n d ə r i t a
momentum	m o . ˈm ɛ n . t ʊ m
tekstur	ˈt ɛ k s t ʊ r
datu	ˈd a t u
bagian	b a ˈɡ iʲ a n
pergelaran	p ə r . ɡ ə . ˈl a r . a n
erotis	ˈɛ r o t ɪ s
jika	ˈd͡ʒ i k a
endorsemen	ɛ n . d ɔ r . s ə . ˈm ɛ n
memodernkan	m ə . m o . d ɛ r n . k a n
penganiaya	p ə ŋ a n i a j a
kadaver	k a . d a . v ə r
kultivar	k ʊ l . ˈt i . v a r
karateka	k a . r a . t e . k a
kastanya	k a s . ˈt a . ɲ a
kegagalan	k ə . ɡ a . ˈɡ a l . a n
membilah	m ə m ˈb i l a h
hasyis	ˈh a ʃ ɪ s
tumbuh	ˈt ʊ m b ʊ h
sarung	s a r ʊ ŋ
sengsai	s ɛ ŋ . s a i
alpiris	a l . ˈp i . r ɪ s
dua	ˈd u w ä
kumulatif	k u m u ˈl a t ɪ f
wanprestasi	w a n p r e s t a s i
konpers	ˈk ɔ n p ɛ r s
lintasan	l ɪ n . ˈt a s . a n
kelab	k ə l a b
ancai	ˈa n t͡ʃ a i̯
unik	ˈu n i k
arbei	a r . b e i̯
Natal	n a . t a l
konduktivitas	k ɔ n . d ʊ k . t i . ˈv i . t a s
urbanisasi	ʊ r b a n i ˈs a s i
belom	b ə . l o m
planetarium	p l a . n e . t a . ˈr i . ʊ m
batara	b a . t a . r a
deduksi	d e ˈd ʊ k s i
hikmah	h i k m a h
kardiologi	k a r . d i . o . ˈl o . ɡ i
biro	b i . r o
bradikardia	b r a . d i . ˈk a r . d i a̯
selaka	s ə . ˈl a . k a
deselerasi	d e s ɛ l ə ˈr a s i
menjadi	m ə n ˈd͡ʒ a d i
korps	ˈk ɔ r p s
antidotum	a n . t i ˈd o . t ʊ m
akte	a k̚ t ə
inferensi	ɪ n . f e . ˈr ɛ n . s i
dongkrak	ˈd ɔ ŋ k r a k̚
prioritas	p r i o ˈr i t a s
mendam	m ə n . ˈd a m
PDIP	p ɛ d ɛ i ˈp ɛ
ideologi	i d e o ˈl o ɡ i
antofilia	a n . t o . f i . ˈl i . a
internasional	i n t ə r n a s i o n a l
kabupaten	k a . b u . p a . t e n
eksperimental	ɛ k s . p ə . r i . ˈm ɛ n . t a l
akselerator	a k . s e . l ə . ˈr a . t ɔ r
luka	ˈl u k a
kuantum	k u ˈa n t ʊ m
anapaso	a n a ˈp a s o
kandungan	k a n ˈd ʊ ŋ a n
henti	h ə n̪ . ˈt̪ i
advisor	a t . ˈv i . s ɔ r
heiho	h e i . h o
ipar	ˈi p a r
mengumpamakan	m ə ŋ u m p a m a k a n
kurawa	k u ˈr a w a
seorang	s ə . o . r a ŋ
sentosa	s ə n . t o . s a
defek	ˈd e f ɛ k̚
kelambu	k ə ˈl a m b u
menampilkan	m ə n a m p i l k a n
penyesuaian	p ə ɲ ə s u ˈa i̯ a n
diperburuk	d i p ə r ˈb u r ʊ k̚
istibra	ɪ s ˈt ɪ p r a ʔ
gempa	ɡ ə m ˈp a
ameto	a . ˈm e . t o
saudara	s a u̯ d a r a
pengawasan	p ə ŋ a ˈw a s a n
asin	ˈa s ɪ n
ambir	ˈa m b ɪ r
kardiovaskuler	k a r d i o v a s ˈk u l ɛ r
renta	ˈr ɛ n t a
penerus	p ə . n ə . ˈr ʊ s
rujak	ˈr u d͡ʒ a ʔ
fakir	ˈf a k ɪ r
elektroda	ɛ . l ɛ k . t r o . d a
metamorfosis	m e t a m ɔ r ˈf o s ɪ s
watan	w a . t a n
promovendus	p r o m o ˈv ɛ n d ʊ s
blangko	b ə̆ l a ŋ k o
loket	a b o n ə m ɛ n
balai	ˈb a l a i̯
mengalir	m ə ŋ . ˈa . l ɪ r
katedral	k a t ə d r a l
penghulu	p ə ŋ . ˈh u . l u
alkana	a l . k a . n a
teori	t e o r i
JPU	d͡ʒ e ˈp e u
sayur	s a j u r
pertumbuhan	p ə r t ʊ m ˈb ʊ h a n
memberhentikan	m ə m b ə r h ə n ˈt i k a n
mukjizat	m ʊ ʔ ˈd͡ʒ i z a t̚
antimikroba	a n t i m i ˈk r o b a
asinkron	a . ˈs ɪ n . k r ɔ n
anungo	a . ˈn u . ŋ o
pejagalan	p ə . d͡ʒ a . ˈɡ a l . a n
penanggalan	p ə n a ŋ ˈɡ a l a n
pemberitahuan	p ə m . b ə . r i . t a . ˈh u . a n
wudu	ˈw u . d u
pertahanan	p ə r t a ˈh a n a n
coba	ˈt͡ʃ o b a
bausastra	b a . u . s a s . t r a
apang	ˈa p a ŋ
perdata	p ə r ˈd a t a
mencekokkan	m ə n . t͡ʃ ə . k o ʔ . k a n
Maria	m a . ˈr i . a
terbang	t ə r . b a ŋ
makaroni	m a . k a . ˈr o . n i
meninggali	m ə ˈn i ŋ . ɡ a ˈl i
acar	ˈa t͡ʃ a r
averoisme	a . v e . r o . ˈɪ s . m ə
anoda	a . n o . d a
antor	ˈa n t ɔ r
samurai	s a . m u . r a i
padri	p a d r i
soleh	ˈs o . l ɛ h
mengemasi	m ə ɲ ə m a s i
gelar	ɡ ə . ˈl a r
pemandian	p ə m a n ˈd i a n
ider	i d ə r
gula	ˈɡ u . l a
cedera	t͡ʃ ə . d ə . r a
adat	a . d a t
pelatihan	p ə l a ˈt ɪ h a n
makmum	ˈm a ʔ m ʊ m
permusyawarahan	p ə r m u ʃ a w a ˈr a h a n
ransel	ˈr a n . s ə l
kasuistik	k a s u ˈɪ s t ɪ k̚
karna	k a r . n a
frater	f r a t ə r
takal	ˈt a . k a l
iotasisme	i o t a ˈs ɪ s m ə
lompat	ˈl ɔ m p a t̚
bina	ˈb i n a
redaman	r ə . ˈd a m . a n
pedupaan	p ə d u ˈp a a n
bapao	b a . p a o
pengeluaran	p ə ŋ ə ˈl u a r a n
akatopi	a k a ˈt o p i
wibu	w i . b u
sekrup	s ə . k r u p
kawasan	k a . w a . s a n
algojo	a l ˈɡ o d͡ʒ o
margasatwa	m a r . ɡ a . ˈs a t . w a
imperialisme	ɪ m p ɛ r i a ˈl ɪ s m ə
ako	a k e o
abir	ˈa b ɪ r
ambekdarma	a m b ə k̚ ˈd a r m a
wanda	ˈw a n . d a
calon	ˈt͡ʃ a . l o n
permanen	p ə r ˈm a n ɛ n
mandraguna	m a n . d r a . ˈɡ u . n a
waralaba	w a r a ˈl a b a
voli	ˈv o . l i
kuas	ˈk u a s
cucu	ˈt͡ʃ u . t͡ʃ u
khilafah	x i . l a . f a h
tuhan	t u . h a n
babango	b a . ˈb a . ŋ o
mahram	ˈm a h r a m
ditangkap	d i ˈt a ŋ k a p̚
kanti	ˈk a n . t i
zen	z ɛ n
ragil	ˈr a . ɡ ɪ l
antarpemain	a n t a r p ə ˈm a ɪ n
amanat	ˈa m a n a t̚
administratur	a t̚ m i n ɪ s t r a t ʊ r
biwara	b i . ˈw a . r a
yakin	ˈj a k ɪ n
mawas	ˈm a w a s
pengadaan	p ə ŋ . ˈa d a . a n
ambekpati	a m b ə k̚ ˈp a t i
cuat	ˈt͡ʃ u . a t
dedak	d ə . ˈd a k
anjiman	a n ˈd͡ʒ i m a n
lajak	ˈl a d͡ʒ a k̚
darah	ˈd a r a h
fermentasi	f e r m e n ˈt a s i
jauhar	ˈd͡ʒ a u̯ h a r
skalar	s k a . l a r
beton	b ə . t o n
penganiayaan	p ə ŋ a n i a j a a n
unta	ˈʊ n t a
instrumental	ɪ n . s t r u . ˈm ɛ n . t a l
merupakan	m ə r u p a k a n
intipan	ɪ n ˈt ɪ p̚ a n
terburuk	t ə r ˈb u r ʊ k̚
utan	u . t a n
pangkat	ˈp a ŋ k a t̚
cetera	t͡ʃ ə . t ə . r a
Georgia	ɡ e ɔ r ˈɡ i a
ribu	ˈr i b u
membanguni	m ə m b a ˈŋ ʊ n i
kurung	ˈk u . r ʊ ŋ
wangsa	w a ŋ . s a
aplikan	a p̚ ˈl i k a n
mama	ˈm a m a
d	d e
takwim	ˈt a k w ɪ m
gudang	ɡ u d a ŋ
pesumo	p ə . s u . m o
tutorial	t u . t o . ˈr i . a l
prinsip	ˈp r ɪ n s ɪ p̚
bravo	ˈb r a . v o
awaagama	a . w a . a . ˈɡ a . m a
Aceh	a t͡ʃ e h
anggrang	ˈa ŋ . ɡ r a ŋ
ulama	u . l a . m a
marhaban	m a r ˈh a b a n
tagih	ˈt a ɡ ɪ h
diberhentikan	d i b ə r h ə n ˈt i k a n
samcan	s a m . t͡ʃ a n
membuka	m ə m ˈb u k a
halusinasi	h a l u s i ˈn a s i
lang	ˈl a ŋ
visa	ˈv i s a
palisade	p a l i ˈs a d ə
PPDB	p e . p e . d e . b e
gergasi	ɡ ə r . ˈɡ a . s i
ambis	ˈa m . b ɪ s
ketinggalan	k ə ˈt i ŋ . ɡ a . l a n
eutanasia	e u t a n a ˈs i a
bapak	b a p a ʔ
kutang	k u . t a ŋ
kohesi	k o ˈh e s i
pemberontakan	p ə m b ə r ɔ n ˈt a k a n
mengemban	m ə ŋ ə m ˈb a n
jurang	ˈd͡ʒ u . r a ŋ
ancala	a n t͡ʃ a l a
pantat	ˈp a n t a t̚
kaliks	ˈk a l ɪ k s
ragu	ˈr a ɡ u
kuilu	k u ˈi . l u
paroki	p a . r o . k i
sarapan	s a ˈr a p̚ a n
baiduri	b a i̯ . d u . r i
ergonomi	e r ɡ o ˈn o m i
lengket	ˈl ɛ ŋ k ɛ t̚
nahas	ˈn a h a s
tinta	t i n . t a
tajin	t a . d͡ʒ ɪ n
gimnasium	ɡ ɪ m n a ˈs i ʊ m
kedaton	k ə ˈd a t ɔ n
agul	ˈa ɡ ʊ l
kebugaran	k ə . b u . ˈɡ a r . a n
Wates	ˈw a t ə s
infeksius	ɪ n . f ɛ k . ˈs i . ʊ s
muhrim	ˈm ʊ h r ɪ m
x	ɛ k s
KPR	k a . ˈp e . ɛ r
linier	l i ˈn i ɛ r
muda	m u . d a
mol	ˈm ɔ l
sadar	s a . d a r
pabrikasi	p a b r i ˈk a s i
kelembapan	k ə . l ə m . ˈb a p . a n
moda	ˈm o . d a
mendung	m ə n d u ŋ
lihat	l i h a t̚
baling	ˈb a l ɪ ŋ
disebar	d i s ə ˈb a r
hikmat	ˈh ɪ k m a t̚
hop	h o p
banjir	ˈb a n . d͡ʒ ɪ r
syuriken	ʃ u . r i . k ɛ n
pemacu	p ə . ˈm a . t͡ʃ u
bungsut	ˈb ʊ ŋ s ʊ t̚
jataka	d͡ʒ a ˈt a k a
kompleks	ˈk ɔ m p l ɛ k s
tangguh	ˈt a ŋ ɡ ʊ h
hemisfer	h e ˈm i . s f ɛ r
turus	ˈt u . r ʊ s
anggap	ˈa ŋ ɡ a p̚
ansambel	a n ˈs a m b ə l
pertemuan	p ə r . t ə . ˈm u . a n
intoleransi	ɪ n t o l e ˈr a n s i
terowongan	t ə r o ˈw ɔ ŋ a n
LPMP	ɛ l p e ˈɛ m p e
mizab	ˈm i z a p̚
China	ˈt͡ʃ ɪ n a
menyiarkan	m ə ɲ i a r k a n
bertambah	b ə r ˈt a m b a h
beha	b e . h a
parlementer	p a r l ə m ɛ n t ɛ r
reforestasi	r e f o r ɛ s ˈt a s i
musyawarah	m u ʃ a ˈw a r a h
rasa	r a . s a
lakuan	l a ˈk u a n
raksasa	r a k ˈs a s a
apakah	a p a . k a h
wanara	w a . n a . r a
ancut	ˈa n . t͡ʃ ʊ t
pahala	p a . h a . l a
ditemukan	d i t ə ˈm u k a n
pendek	ˈp e n . d e k
dolfin	ˈd ɔ l . f i n
adicita	a d i ˈt͡ʃ i t a
instruktur	ɪ n . ˈs t r ʊ k . t ʊ r
pangkuan	p a ŋ ˈk u a n
huruf	ˈh u r ʊ f
antesis	a n ˈt e s ɪ s
kafilah	k a ˈf i l a h
hedon	h e . d o n
penggalian	p ə ŋ ˈɡ a l i a n
amali	a . ˈm a . l i
arkunel	a r . ˈk u . n ɛ l
eksplorasi	ɛ k s p l o ˈr a s i
pedagogi	p e d a ˈɡ o ɡ i
Sulut	s u . l u t
dingin	d i ŋ ɪ n
andem	ˈa n d ə m
delman	ˈd e l . m a n
awuta	ˈa w u . t a
hadirat	h a ˈd i r a t̚
persenyawaan	p ə r s ə ɲ a ˈw a a n
bendu	b ə n . ˈd u
darat	ˈd a r a t
kecil	k ə ˈt͡ʃ i l
laher	l a . h ə r
monsun	m u n s o n
apsara	a p . s a . r a
persatuan	p ə r s a ˈt u a n
November	n o . ˈv ɛ m . b ə r
kokoh	ˈk o k ɔ h
mangkat	ˈm a ŋ k a t̚
dewan	ˈd ɛ w a n
monomer	m o ˈn o m ɛ r
ancuan	a n ˈt͡ʃ u a n
genderuwo	ɡ ə n . d ə . ˈr u . w o
tipu	t i . p u
aborigin	a . b o . r i . ɡ ɪ n
performer	p ə r ˈf ɔ r m ə r
apokdim	a . ˈp ɔ ʔ . d ɪ m
mungkir	ˈm u ŋ k i r
perkara	p ə r . k a . r a
arigol	ˈa . r i . ɡ ɔ l
pengurangan	p ə ŋ u ˈr a ŋ a n
antarbahasa	a n t a r b a ˈh a s a
ri	r i
baktau	b a k . t a ʊ̯
polimer	p o . ˈl i . m ɛ r
reanimasi	r e a n i m a s i
bulbul	ˈb ʊ l b ʊ l
vulkanologi	f u l k a n o ˈl o ɡ i
wanaternak	w a n a ˈt ə r n a k
lembar	l ə m b a r
apo	ˈa . p o
ajar	a . d͡ʒ a r
cakrawala	t͡ʃ a k . r a . w a . l a
perolehan	p ə r o ˈl ɛ h . a n
umat	ˈu m a t̚
Juni	ˈd͡ʒ u . n i
pramulansia	p r a . m u . l a n . s i a
mana	m a . n a
romusa	r o . m u . s a
kontestasi	k ɔ n t ɛ s ˈt a s i
pemabuk	p ə m a b u k
tidak	ˈt i . d a k
resmi	r ə s . m i
fantosmia	f a n ˈt ɔ s m i a̯
q	k
perdana	p ə r d a n a
dengar	d ə . ŋ a r
rasisme	r a ˈs ɪ s m ə
stoples	ˈs t ɔ p l ɛ s
sungsang	ˈs ʊ ŋ s a ŋ
gilik	ˈɡ i l ɪ k̚
TPS	t e . ˈp e . ɛ s
sasana	s a . s a . n a
ambiguitas	a m b i ɡ u ˈi t a s
hadir	h a . d ɪ r
resonansi	r e . s o . ˈn a n . s i
cuaca	t͡ʃ u . a . t͡ʃ a
menggarisi	m ə ŋ . ɡ a . r i s . i
kirik	ˈk i . r ɪ ʔ
pemulangan	p ə . m u . ˈl a ŋ . a n
nah	n a h
bahaya	b a ˈh a j a
pelepah	p ə . l ə . ˈp a h
ardi	ˈa r . d i
asrok	ˈa s . r ɔ k
didik	d i d ɪ ʔ
paru	ˈp ä . r u
lantama	l a n ˈt a m a
lawan	l a . w a n
aborsi	ˈa b ɔ r s i
tanduk	t a n d u k
Arab	ˈa r a p̚
klaver	ˈk l a . v ə r
makalah	m a . ˈk a . l a h
samsek	s a m . s ə k
tenge	ˈt e ŋ e
menatapi	m ə . n a . t a p . i
kahrab	ˈk a h r a p̚
dayah	ˈd a j a h
kompresor	k ɔ m ˈp r ɛ s ɔ r
kaca	k a t͡ʃ a
sentral	ˈs ɛ n t r a l
turunan	t u ˈr u n a n
qasar	ˈq a . s a r
ambil	ˈa m b ɪ l
hiu	ˈh i . u
apologia	a p o ˈl o ɡ i a̯
saat	s a . ʔ a t
termin	t ə r ˈm ɪ n
transparansi	t r a n s p a ˈr a n s i
handuk	h a n d ʊ k̚
tempura	t ə m . p u . r a
anyam	ˈa ɲ a m
sake	s a . k e
gabah	ˈɡ a b a h
fluida	f l u ˈi d a
resistansi	r e s ɪ s ˈt a n s i
awetan	a . ˈw ɛ t . a n
terpidana	t ə r . p i . ˈd a . n a
a	a
frekuensi	f r e k u ˈɛ n s i
kedatangan	k ə ˈd a t a ŋ a n
wasbak	w a s b a k̚
jelus	d͡ʒ ə ˈl ʊ s
Skotlandia	s k ɔ t ˈl a n d i a̯
cuek	c u e ʔ
bisban	ˈb ɪ s b a n
geng	ɡ ɛ ŋ
hidrokarbon	h i . d r o . ˈk a r . b ɔ n
borang	ˈb ɔ r a ŋ
amuk	ˈa m ʊ k̚
papir	ˈp a p ɪ r
hitung	ˈh i t ʊ ŋ
imprimatur	i m p r i m a t u r
ganjar	ˈɡ a n d͡ʒ a r
memutakhirkan	m ə m u t a x i r k a n
usul	ˈu s ʊ l
apotek	a p o . t e k
standardisasi	s t a n . d a r . d i . s a . s i
Maryam	ˈm a r . j a m
abu	a b u
mu	m u
menambah	m ə n a m b a h
layang	ˈl a . j a ŋ
narasi	n a . ˈr a . s i
sela	ˈs e . l a
pangkal	ˈp a ŋ k a l
ensambel	ɛ n ˈs a m b ə l
kuwu	ˈk u . w u
maklumat	m a ʔ ˈl u m a t̚
falak	ˈf a l a k̚
mendoa	m ə n d o a
tablig	ˈt a b l ɪ k̚
anjar	ˈa n d͡ʒ a r
ditografi	d i t o ˈɡ r a f i
sprei	s ə p . r e i
bandung	ˈb a n . d ʊ ŋ
cam	ˈt͡ʃ a m
teladan	t ə l a d a n
menyanggah	m ə ˈɲ a ŋ ɡ a h
surya	s u r . j a
rambut	ˈr ä m . b u t̪̚
pendukung	p ə n ˈd u k ʊ ŋ
waktu	w a k . t u
teh	ˈt ɛ h
tindakan	t ɪ n . d a . k a n
tsuru	ʃ u . r u
antanik	a n ˈt a n ɪ k̚
lapang	l a p a ŋ
kempis	k ə m ˈp ɪ s
terkenal	t ə r k ə n a l
angai	ˈa ŋ a i̯
udon	u . d o n
pendekatan	p ə ŋ . d ə . ˈk a t . a n
prabu	p r a . b u
mantap	ˈm a n t a p̚
menghadirkan	m ə ŋ . h a . d i r . k a n
simpangan	s ɪ m . ˈp a ŋ . a n
curah	ˈt͡ʃ u . r a h
pengen	p ɛ . ŋ ɛ n
telur	t ə ˈl u r
gayung	ɡ a j u ŋ
watak	ˈw a . t a ʔ
angkar	ˈa ŋ k a r
lakon	ˈl a k ɔ n
grahita	ɡ r a . h i . t a
Tamil	ˈt a m ɪ l
M	ɛ m
memproklamasikan	m ə m p r o k l a m a ˈs i k a n
abilah	ˈa b i l a h
tir	ˈt ɪ r
kosmonaut	k ɔ s m o n a u̯ t̚
adimanusia	a . d i . m a . n u . ˈs i . a
onderdil	o n . d ə r . d i l
perembesan	p ə . r ə m . b ə s . ˈa n
Kristen	ˈk r ɪ s . t ə n
gletser	ˈɡ l ɛ t s ə r
hadap	ˈh a d a p̚
Islandia	ɪ s ˈl a n d i a̯
giling	ˈɡ i l ɪ ŋ
buni	ˈb u n i
datuk	ˈd a t ʊ k̚
indikator	ɪ n d i ˈk a t ɔ r
parpol	p a r . p o l
penyederhanaan	p ə . ɲ ə . d ə r . h a . ˈn a . a n
ambu	ˈa m b u
penjelajah	p ə n d͡ʒ ə ˈl a d͡ʒ a h
agraris	ˈa ɡ r a r ɪ s
penganggaran	p e ŋ . a ŋ . ˈɡ a r . a n
kewarganegaraan	k ə w a r ɡ a n ə ɡ a ˈr a a n
memindai	m ə . m i n . d a i̯
lalat	ˈl a . l a t̚
belajar	b ə . l a . d͡ʒ a r
mengatakan	m ə ŋ a ˈt a k a n
basahan	b a ˈs a h a n
pengendali	p ə . ŋ ə n . ˈd a . l i
kucing	ˈk u t͡ʃ ɪ ŋ
flop	ˈf l ɔ p̚
seprai	s ə p . r a i
ah	ˈa h
bioinformatika	b i o . ɪ n . f ɔ r . m a . ˈt i . k a
anuhuai	a . n u . ˈh u . a i̯
sistemis	s ɪ s . ˈt e . m ɪ s
barid	ˈb a r ɪ t̚
Malingsia	m ä l ɪ ŋ . s i a
sein	s e ɪ̯ n
sumuran	s u ˈm u r a n
takikardia	t a . k i . ˈk a r . d i a̯
mengendalikan	m ə . ŋ ə n . d a . l i . k a n
pengoplos	p ɘ ŋ . o p . l o s
dari	d a . r i
wihara	w i . h a . r a
liana	ˈl i a̯ n a
potongan	p ɔ ˈt ɔ ŋ a n
dijelaskan	d i d͡ʒ ə ˈl a s k a n
pengaktifan	p ə ŋ a k ˈt i f a n
kadaster	k a d a s t ə r
amah	a m a h
sensitivitas	s ɛ n s i t i ˈv i t a s
inventarisasi	ɪ n . v ɛ n . t a . r i . ˈs a . s i
dolar	ˈd o l a r
mengamankan	m ə ŋ ˈa m a n k a n
tempat	t ə m p a t
bawi	b a . w i
hijrah	h i d͡ʒ r a h
klinikal	k l i . n i . k a l
algoritmik	a l ɡ o ˈr ɪ t̚ m ɪ k̚
mantul	ˈm a n t ʊ l
puas	ˈp u a s
alot	ˈa l ɔ t̚
bahu	ˈb ä . h u
anyir	a ɲ ɪ r
angrem	a ŋ r ə m
edisi	ˈɛ d i s i
fotoelektrisitas	f o t o ɛ l ɛ k̚ t r i ˈs i t a s
perak	ˈp e . r a k
adiyuswa	a d i ˈj ʊ s w a
siomai	s i ˈo m a j
losin	ˈl o . s i n
guna	ɡ u n a
bustan	ˈb ʊ s t a n
cakalang	t͡ʃ a . ˈk a . l a ŋ
diperkeruh	d i p ə r k ə ˈr ʊ h
awak	a w a k
asat	ˈa s a t̚
galer	ɡ a . l e r
peduli	p ə d u l i
ᬰᬶᬯ	s i w a
z	z
wilis	ˈw i . l ɪ s
deflasi	d e ˈf l a s i
markas	ˈm a r . k a s
moci	m o t͡ʃ i
burung	ˈb u . r ʊ ŋ
afiliator	a f i l i ˈa t ɔ r
menel	ˈm e n e l
kolektivisme	k o l ɛ k t i ˈv ɪ s m ə
terlalu	t ə r l a l u
sayang	ˈs a j a ŋ
diploma	d i ˈp l o m a
pelopor	p ə ˈl o p ɔ r
nestapa	n ə s ˈt a p a
defleksi	d e . ˈf l ɛ k . s i
permukaan	p ə r . m u . k a . a n
adutan	ˈa d ʊ t a n
diam	d i . a m
dunia	d u . n i . a
doa	d o a
terbesar	t ə r b ə ˈs a r
handelar	h a n ˈd ə l a r
sekong	s e . k o ŋ
iklim	i k . l ɪ m
harus	h a . r ʊ s
Bulgaria	b ʊ l ˈɡ a r i a̯
bumbung	ˈb u m b u ŋ
suket	ˈs u k ə t̚
ikan	i k a n
defile	d e ˈf i l e
orangtua	o . r a ŋ . t u . a
taksaka	t a k ˈs a k a
konsultatif	k ɔ n . s ʊ l . ˈt a . t ɪ f
pap	p a p
juag	ˈd͡ʒ u a k̚
bakero	b a k e r o
laki	ˈl a k i
go	ɡ o
batuan	b a ˈt u a n
determinan	d e . t ɛ r . ˈm i . n a n
akhlak	ˈa x l a k
Bengkulu	b ə ŋ ˈk u l u
degeneratif	d e ɡ e n ə ˈr a t ɪ f
belantara	b ə . l a n . t a . r a
persen	p ə r ˈs ɛ n
ambyok	ˈa m b j ɔ k̚
liturgis	l i . ˈt ʊ r . ɡ ɪ s
anvian	a n . ˈv i . a n
biostatika	b i . o . s t a . ˈt i . k a
maktub	ˈm a k t u b
automasi	a u̯ t o ˈm a s i
ambulralra	a m b ʊ l ˈr a l r a
penuntut	p ə . n u n . t ʊ t
kenceng	k ə n . t͡ʃ ə ŋ
sarasehan	s a . r a . ˈs ɛ h . a n
datar	ˈd a t a r
mencekoki	m ə ɲ . t͡ʃ ə . k o . k i
klasikal	k l a ˈs ɪ k . a l
prematur	p r e . ˈm a . t ʊ r
penera	p ə . n ə . r a
kaprodi	k a . ˈp r o . d i
amleng	ˈa m . l ə ŋ
hakam	ˈh a . k a m
mempengaruhi	m ə m . p ə . ŋ a . r u h . i
awelat	a . ˈw e . l a t̚
tuai	t u a i̯
rasuah	r a . s u . a h
toksik	ˈt ɔ k . s ɪ k
rokok	ˈr o k o ʔ
menyita	m ə . ɲ i . t a
membakar	m ə m . b a . k a r
polen	ˈp o l ə n
badar	ˈb a . d a r
badul	ˈb a . d ʊ l
sepeda	s ə ˈp ɛ . d a
G	ɡ e
terwelu	t ə r ˈw ɛ . l u
lazuardi	l a z u a r d i
setempat	s ə t ə m ˈp a t̚
awota	ˈa w o . t a
pihak	ˈp i h a ʔ
ingin	i . ŋ i n
Ahad	ˈa h a t̚
menemukan	m ə n ə ˈm u k a n
abahan	ˈa b a h a n
radikalisasi	r a d i k a l ˈɪ s a s i
umbul	ˈʊ m . b ʊ l
pencitraan	p ə ŋ t͡ʃ i ˈt r a a n
kamuflase	k a m u f l a s ə
ken	k ɛ n
independen	i n . d ə . p ɛ n . d ə n
surga	ˈs ʊ r ɡ a
kolon	ˈk o l ɔ n
bayam	ˈb a . j a m
jarum	ˈd͡ʒ a r u m
semalem	s ə . m a . l ə m
suami	ˈs u a̯ . m i
pejamu	p ə . ˈd͡ʒ a . m u
samper	s a m p ə r
bab	b a b
BNPT	b e ɛ n ˈp e t e
śāsana	s a . s a . n a
Jateng	d͡ʒ a ˈt ə ŋ
liyan	ˈl i j a n
amben	ˈa m b ə n
wajib	ˈw a d͡ʒ ɪ p
tegap	t ə ˈɡ a p̚
pekerjaan	p ə . k ə r . d ʒ a . ʔ a n
tahun	ˈt a . h ʊ n
losmen	l o s . m ɛ n
bendel	b ə n ˈd ə l
teriyaki	t ɛ . r i . j a . k i
emas	ə m a s
tawar	t a w a r
sentul	s ə n . ˈt ʊ l
menurun	m ə ˈn u r ʊ n
seka	ˈs ɛ k a
jamu	ˈd͡ʒ a m u
tadarus	t a d a r u s
junta	ˈd͡ʒ ʊ n . t a
menjaga	m ə n ˈd͡ʒ a ɡ a
kontes	ˈk ɔ n t ɛ s
paleontologi	p a . l e . ɔ n . t o . ˈl o . ɡ i
gagu	ˈɡ a ɡ u
adiafora	a d i a ˈf o r a
kaftan	ˈk a f t a n
bineka	b i . ˈn e . k a
langcia	l a ŋ . t͡ʃ i a̯
sendratari	s ə n . d r a . t a . r i
praperadilan	p r a . p ə r . a . ˈd ɪ l . a n
kumpul	ˈk ʊ m p ʊ l
lumbung	ˈl ʊ m b ʊ ŋ
gatal	ɡ a . t a l
graf	ˈɡ r a f
polah	ˈp o l a h
tengkujuh	t ə ŋ ˈk u d͡ʒ ʊ h
siluet	s i . ˈl u . ɛ t
pelanggar	p ə . ˈl a ŋ . ɡ a r
aswa	a s . w a
keik	k ɛ . i k
goban	ɡ o . b a n
mulai	m u . l a i̯
elektromagnetisme	ɛ l ɛ k t r o m a k n ɛ t ˈɪ s m ə
jelita	d͡ʒ ə l i t a
beber	ˈb ɛ b ɛ r
konsumerisme	k ɔ n s u m ɛ r ˈɪ s m ə
anggong	ˈa ŋ ɡ ɔ ŋ
komplot	k o m p l o t
anaweli	a . n a . ˈw e . l i
nyanyi	ɲ a ɲ i
granat	ɡ r a . n a t̚
berbeda	b ə r ˈb ɛ d a
terpal	t ə r ˈp a l
kubak	ˈk u b a ʔ
kailan	k a . i . l a n
sedawa	s ə . d a . w a
berbahasa	b ə r b a ˈh a s a
berjibaku	b ə r . d͡ʒ i . b a . k u
anglo	a ŋ . l o
madrasah	m a d ˈr a s a h
sami	ˈs a m i
gelak	ɡ ə ˈl a k
kernet	k ə r ˈn ɛ t̚
gapura	ɡ a p u r a
rumput	ˈr ʊ m p ʊ t̚
duli	d u l i
abras	a b . r a s
ambyang	ˈa m bʲ a ŋ
menyebar	m ə ɲ ə ˈb a r
kerbau	k ə r b a u̯
anastilosis	a . n a . s t i . ˈl o . s ɪ s
bahwa	b a h . w a
jalu	d͡ʒ a . l u
kastil	k a s . t ɪ l
lupa	l u . p a
voucer	ˈv o u̯ t͡ʃ ə r
candra	t͡ʃ a n . d r a
jijik	d͡ʒ i . d͡ʒ ɪ ʔ
IPA	i . ˈp a
persiapan	p ə r . s i . ˈa p . a n
hakim	ˈh a k ɪ m
gaga	ˈɡ a . ɡ a
lauk	ˈl a . ʊ ʔ
bekintangon	b ɛ k ɪ n ˈt a ŋ ɔ n
kersen	ˈk ɛ r s ə n
makasih	m a . k a . s ɪ h
spaning	s p a . n i ŋ
utara	u t a r a
syahbandar	ʃ a h . b a n . d a r
monarki	m o ˈn a r k i
badak	ˈb a . d a ʔ
alfuil	a l ˈf u ɪ l
terung	t ə . ˈr ʊ ŋ
romo	ˈr o m o
letjend	l ə t ˈd͡ʒ ə n d
alami	ˈa l a m i
menggarisbawahi	m ə ŋ . ɡ a . r i s . b a . w a h . i
lajur	ˈl a d͡ʒ u r
alarm	ˈa l a r m
nabi	ˈn a b i
wafat	ˈw a f a t̚
ana	a n a
sponsor	ˈs p ɔ n . s ɔ r
rasional	r a s i ˈo n a l
kerosin	k e ˈr o s ɪ n
amane	ˈa m a n ɛ
pembelahan	p ə m b ə ˈl a h a n
eklips	ɛ k . l i p s
kardiolog	k a r . d i . ˈo . l ɔ k
fleksibel	f l ɛ k . ˈs i . b ə l
mukminat	m ʊ ʔ ˈm i n a t̚
kabur	k a . b ʊ r
pendarahan	p ə n . d a . ˈr a h . a n
empiris	ɛ m ˈp i r ɪ s
cultuurstelsel	k ʊ l t ʊ r s t ɛ l s ə l
buruk	ˈb u r u k
hamba	h a m . b a
mengabsen	m ə ŋ . a p . s e n
dilah	ˈd i l a h
bang	b a ŋ
antum	ˈa n t ʊ m
umbi	ˈʊ m . b i
lantas	ˈl a n t a s
ambyur	ˈa m bʲ ʊ r
menghadiri	m ə ŋ . h a . d i r . i
marhabanan	m a r h a ˈb a n a n
verano	v e ˈr a n o
tromol	ˈt r o . m o l
altar	ˈa l t a r
PM	ˈp e ɛ m
dawat	ˈd a w a t̚
toko	ˈt o . k o
anggrek	ˈa ŋ ɡ r ɛ ʔ
jentera	d͡ʒ ə n t ə r a
klitik	k l i . t i k
membulat	m ə m ˈb u l a t
lanca	l a n . t͡ʃ a
satwa	ˈs a t̚ w a
termoregulasi	t ɛ r . m o . r e . ɡ u . ˈl a . s i
anak	a . n a k
semangka	s ə . m a ŋ . k a
kilap	ˈk i l a p̚
tempur	t ə m ˈp ʊ r
kelurahan	k ə . l u . ˈr a h . a n
persidangan	p ə r s i ˈd a ŋ a n
aningo	a . ˈn i . ŋ o
aktris	ˈa k t r ɪ s
PR	p ɛ . ɛ r
telaah	t ə . l a . ʔ a h
inventaris	ɪ n . v ɛ n . ˈt a . r ɪ s
nila	n i . l a
aslosin	a s . ˈl o . s ɪ n
lali	ˈl a l i
jadul	ˈd͡ʒ a d ʊ l
pengguna	p ə ŋ ˈɡ u n a
ganjaran	ɡ a n ˈd͡ʒ a r a n
jala	d͡ʒ a l a
mengecam	m ə . ŋ ə . ˈt͡ʃ a m
kontributor	k ɔ n . t r i . ˈb u . t ɔ r
semen	s ə ˈm ɛ n
laksmana	l a k s . m a . n a
kebo	k ə ˈb o
lahir	ˈl a . h ɪ r
takraw	ˈt a k̚ . r a w
tiris	ˈt i r i s
o	o
honji	h o n . d͡ʒ i
seko	s e . k o
ampor	ˈa m p ɔ r
lekong	l e . k o ŋ
banyak	b a ɲ a k
rektum	ˈr ɛ k̚ t ʊ m
brankar	b r a n k a r
kardiovaskular	k a r d i o v a s ˈk u l a r
satu	ˈs ä . t̪ u
rokade	r o ˈk a d ə
berketombe	b ə r k ə ˈt ɔ m b e
tiram	ˈt i r a m
farsakh	ˈf a r s a x
pengenalan	p ə ŋ ə ˈn a l a n
undangan	ʊ n . ˈd a ŋ . a n
pulut	ˈp u l ʊ t̚
tempel	ˈt ɛ m p ɛ l
D	d e
tenggelam	t ə ŋ ɡ ə ˈl a m
yang	ˈj a ŋ
rembes	ˈr ɛ m b ɛ s
layan	ˈl a j a n
joli	ˈd͡ʒ o l i
hentai	h ɛ n . t a i̯
kamber	ˈk a m . b ə r
anaye	ˈa n a j ɛ
propana	p r o . p a . n a
tukul	ˈt u . k ʊ l
bayang	ˈb a . j a ŋ
lempira	l e m ˈp i r a
budi	b u . d i
bakwan	b a ʔ w a n
jawi	ˈd͡ʒ a . w i
laskar	l a s ˈk a r
pecahan	p ə . t͡ʃ a . h a n
pek	p ɛ k
kesejahteraan	k ə s ə d͡ʒ a h t ə ˈr a a n
atan	ˈa t a n
mengurutkan	m ə ŋ u ˈr u t k a n
duri	ˈd u . r i
cerita	t͡ʃ ə . r i . t a
panduan	p a n . ˈd u . a n
halia	h a l i a
dorongan	d ɔ ˈr ɔ ŋ a n
kanji	k a n . d͡ʒ i
harapan	h a . ˈr a p . a n
senantiasa	s ə n a n t i ˈa s a
dom	ˈd ɔ m
target	ˈt a r ɡ ɛ t̚
kudeta	k u ˈd ɛ t a
latih	ˈl a t ɪ h
digali	ˈd i . ɡ a l i
patik	ˈp a . t ɪ k
hukuman	h u ˈk u . m a n
lengan	ˈl ə . ŋ ä n
kajian	k a . ˈd͡ʒ i . a n
hosti	h o s t i
celaan	t͡ʃ ə ˈl a a n
merk	m ɛ r k
arif	ˈa r ɪ f
demang	d ə ˈm a ŋ
tadah	ˈt a d a h
tebang	t ə . ˈb a ŋ
anehe	ˈa n e h e
nabatah	n a b a t a h
pengumuman	p ə ŋ u ˈm ʊ m a n
bhayangkara	b a . j a ŋ . k a . r a
rekonsiliasi	r e . k ɔ n . s i . l i . ˈa . s i
ekor	ɛ . k o r
bazar	b a . z a r
kenek	k ə ˈn ɛ k
lomba	ˈl ɔ m b a
ketahanan	k ə t a ˈh a n a n
sangat	s a . ŋ a t
eka	e . k a
limit	ˈl i m ɪ t̚
gugus	ˈɡ u ɡ ʊ s
mendengar	m ə n . d ə . ŋ a r
teorema	t e o ˈr ɛ m a
folklor	ˈf ɔ l ʔ . l ɔ r
film	ˈf ɪ l ə m
pariwisata	p a . r i . w i . s a . t a
hadiah	h a ˈd i j a h
santap	ˈs a n . t a p̚
temu	t ə ˈm u
gelora	ɡ ə l o r a
majelis	m a ˈd͡ʒ ə l ɪ s
l	ɛ l
artropoda	a r t r o ˈp o d a
montase	m ɔ n . ˈt a . s ə
adik	ˈa . d ɪ k
mendobrak	m ə n d o b r a k
pengungsi	p ə ŋ . ˈʊ ŋ . s i
sehat	s ɛ h a t̚
prakiraan	p r a . k i . ˈr a . a n
senter	ˈs ɛ n t ə r
konfeti	k o n . f e . t i
jurnalisme	d͡ʒ ʊ r . n a . ˈl ɪ s . m ə
taun	ˈt a . ʊ n
khizanatulkitab	x i z a n a t ʊ l ˈk i t a p̚
patiseri	p a . t i . s ə . ˈr i
pemrograman	p ɛ m r o ˈɡ r a m a n
anggas	ˈa ŋ ɡ a s
simposium	s ɪ m . p o . ˈs i . ʊ m
masjid	ˈm a s d͡ʒ ɪ t̚
kardiologis	k a r . d i . o . ˈl o . ɡ ɪ s
parlemen	p a r l ə ˈm ɛ n
sujud	ˈs u d͡ʒ ʊ t̚
nepotisme	n e p ɔ t̚ ˈɪ s m ə
sabun	ˈs a b ʊ n
karam	ˈk a . r a m
Ibrani	i ˈb r a n i
homo	h o . m o
gua	ɡ u a
pangkalan	p a ŋ ˈk a l a n
pada	ˈp a d a
hanzi	h a n . z i
anggal	ˈa ŋ . ɡ a l
insidental	ɪ n . s i . ˈd ɛ n . t a l
zalim	ˈz a l ɪ m
dadih	d a . d i h
gampar	ɡ a m . p a r
galuh	ɡ a l u h
nazar	ˈn a z a r
ergonomis	e r ɡ o ˈn o m ɪ k
proyek	ˈp r o . j ɛ k
timbang	ˈt ɪ m . b a ŋ
tengar	t ə ˈŋ a r
urip	ˈu . r ɪ p̚
salpeter	s a l . p ɛ . t ə r
awur	ˈa w ʊ r
seniman	s ə ˈn i m a n
paha	ˈp a h a
aliran	a . ˈl ɪ r . a n
SAKIP	ˈs a k ɪ p̚
Belarusia	b e l a ˈr u s i a̯
bagong	b a . ɡ ɔ ŋ
warak	ˈw a . r a k
anido	ˈa n i d o
khatam	ˈx a t a m
perkataan	p ə r . k a . ˈt a . a n
meraja	m ə r a d͡ʒ a
Sarawak	s a ˈr a w a ʔ
andala	a n ˈd a l a
toh	ˈt ɔ h
gagah	ˈɡ a . ɡ a h
garuda	ɡ a ˈr u d a
hidrogen	h i d r o ɡ ɛ n
mandu	ˈm ʌ n . d ʊ
lanjar	ˈl a n d͡ʒ a r
Estonia	e s ˈt o n i a̯
kemudahan	k ə m u ˈd a h a n
pola	ˈp o l a
panko	p a n . k o
amerta	a m ə r . t a
uduk	ˈu . d ʊ k
mazbah	ˈm a z b a h
adoptif	ˈa d ɔ p . t ɪ f
lubuk	ˈl u b ʊ k̚
sublimasi	s ʊ p l i ˈm a s i
erti	ə r . t i
ꦱꦺꦴꦕ	s o t͡ʃ ɔ
kofte	ˈk ɔ f t e
gaul	ɡ a u l
baksis	ˈb a k s ɪ s
bodoh	ˈb o d ɔ h
Jatim	ˈd͡ʒ a t i m
hibrida	h i ˈb r i d a
belum	b ə ˈl ʊ m
adisi	a . ˈd i . s i
baki	ˈb a k i
eter	ˈɛ t ə r
pelepasan	p ə l ə ˈp a s a n
balikan	b a l i k a n
subyek	s u b . j ɛ k
toto	t o t o
tua	t u . a
balo	ˈb a l o
menganiaya	m ə ŋ a n i a j a
arit	a . r i t
gakari	ɡ a . k a . r i
wasana	w a ˈs a n a
badam	ˈb a d a m
amputan	a m ˈp ʊ t a n
awo	ˈa w o
bohong	b o . h o ŋ
alawatae	a l a ˈm ɛ t e
indoktrinasi	ɪ n . d ɔ k . t r i . ˈn a . s i
khawatir	x a ˈw a t ɪ r
unggul	u ŋ ɡ ʊ l
mager	ˈm a ɡ ə r
dansa	d a n . s a
aloun	a . ˈl o . ʊ n
awat	a . w a t
perbani	p ə r . ˈb a . n i
memunculkan	m ə . m u n . t͡ʃ ʊ l . k a n
pekerti	p ə k ə r ˈt i
absolusi	a b s o l u s i
evaluasi	ɛ v a l u ˈa s i
kejuruan	k ə . d͡ʒ u . ˈr u . a n
pemda	p ə m ˈd a
bajing	ˈb a . d͡ʒ ɪ ŋ
kidal	k i d a l
perobatan	p ə r ˈɔ b a t a n
Austria	a ʊ s ˈt r i a
percuma	p ə r t͡ʃ u m a
komunis	k o ˈm u n ɪ s
jujutsu	d ʒ u . d ʒ ʊ t . s u
am	ˈa m
prei	p r e i
amoa	ˈa m o a̯
versi	ˈv ɛ r s i
selada	s a l a d a
faring	ˈf ä . r i ŋ
N	ɛ n
gejala	ɡ ə . ˈd͡ʒ a . l a
bidan	b i . d a n
menjaring	m ə n ˈd͡ʒ a r i ŋ
Anatolia	a . n a . t o . ˈl i . a
antok	ˈa n t ɔ k̚
limas	ˈl i m a s
bobrok	b o . b r ɔ k
mayat	ˈm a j a t̚
gereja	ɡ ə ˈr ɛ d͡ʒ a
PSK	p ɛ ˈɛ s k a
landasan	l a n . d a . s a n
saja	ˈs a d͡ʒ a
reses	ˈr e . s ɛ s
hewani	h e ˈw a n i
babka	ˈb a p . k a
membantah	m ə m . b a n . t a h
sungut	ˈs u ŋ ʊ t
loh	ˈl ɔ h
gerbang	ɡ ə r . ˈb a ŋ
bukak	ˈb u k a k̚
dasar	ˈd a s a r
remas	r ə . ˈm a s
puri	p u . r i
gempita	ɡ ə m . p i . t a
dokumen	d o ˈk u m ɛ n
dramatis	d r a ˈm a t ɪ s
objektivitas	ɔ p d͡ʒ ɛ k t i ˈf i t a s
alpa	a l . p a
bendahari	b ə n . d a . h a . r i
cara	t͡ʃ a . r a
pernyataan	p ə r . ɲ a . ˈt a . a n
syal	ʃ a l
aniaya	a n i . a . j a
cilik	ˈt͡ʃ i . l ɪ k
aftab	ˈa f t a p̚
keasaman	k ə a ˈs a m a n
agresi	a ɡ . r ɛ . s i
BBLR	b e b e ˈɛ l ɛ r
seminar	s ə ˈm i n a r
serampang	s ə ˈr a m p a ŋ
litigasi	l i . t i . ˈɡ a . s i
amudi	ˈa m u d i
alis	ˈʔ ä . l i s
menit	m ə ˈn ɪ t
mastautin	m a s ˈt a u̯ t ɪ n
ganti	ɡ a n . t i
ramal	r a m a l
sarana	s a . r a . n a
perpaduan	p ə r p a ˈd u a n
zakar	ˈz a k a r
pengaturan	p ə ŋ a ˈt ʊ r a n
malem	m a . l ə m
taklimat	t a ʔ ˈl i m a t̚
kiai	ˈk i a i̯
kebupatian	k ə b u p a ˈt i a n
kapten	ˈk a p̚ t ɛ n
pelumas	p ə ˈl u m a s
hedonisme	h e . d o . n i s . m ə
stereotipe	s t e r e o ˈt i p ə
babaun	b a . ˈb a . ʊ n
riskan	r i s . k a n
anjang	ˈa n d͡ʒ a ŋ
himpunan	h ɪ m ˈp ʊ n a n
mendarahi	m ə n . d a . ˈr a h . i
vetsin	v ɛ t . ʃ i n
aktivisme	a k̚ t i v ɪ s m ə
sempurna	s ə m . p u r . n a
kegiatan	k ə . ɡ i . ˈa t . a n
betik	b ə . ˈt ɪ k
kandung	ˈk a n d ʊ ŋ
spoelhoek	s p ʊ l h ʊ k̚
apanase	a p a ˈn a s ə
ponsel	p o n s ɛ l
manga	ˈm a n ɡ a
sarkastis	s a r ˈk a s t ɪ s
secang	s ə . t͡ʃ a ŋ
sanak	s a . n a ʔ
balobo	b a ˈl o b o
obi	o . b i
membeli	m ə m . b e . l i
E	e
bulu	ˈb u . l u
dargah	ˈd a r ɡ a h
sempoa	s ə m p o a
biologis	b i o ˈl o ɡ ɪ s
disposisi	d i s . p o . s i . s i
perpindahan	p ə r p ɪ n ˈd a h a n
dehidrasi	d e h i ˈd r a s i
pemanfaatan	p ə . m a n . f a . ˈa t . a n
sambungan	s a m . ˈb ʊ ŋ . a n
uber	u b ə r
gusi	ˈɡ u . s i
ketentuan	k ə t ə n ˈt u a n
bilang	ˈb i l a ŋ
songket	s o ŋ k ɛ̀ t
mual	ˈm u a l
terasi	t ə ˈr a s i
komplementer	k ɔ m . p l ə . ˈm ɛ n . t ɛ r
