ܚܛܗܐ	ħ tˤ aː h a
ܣܗܕ	s ɑː h e dː
ܕܪܢܦܝܣܐ	d a r n ɑː f iː s ɑː
ܥܘܣܪܐ	ʕ u s s ə r ɑː
ܣܠܐ	s a l l ɑː
ܓܠܦ	d͡ʒ aː l e p
ܣܘܟܢܐ	s ɑ w k ɑː n ɑː
ܒܪܩܘܒܠ	b a r q uː w l
ܚܘܒܐ	x u b b ɑː
ܐܚܐ	ʔ a x ɑː
ܚܘܛܒܪܩܐ	x u tˤː b a r q ɑː
ܬܪܥܣܪ	t r eː s a r
ܚܙܕܓ	x a z d ɪ d͡ʒ
ܣܟܘܛܝܐ	s k o tˤ i jː j ɑː
ܚܐܪ	x ɑː j e rː
ܒܣܝܡܬܐ	b a s i mː t ɑː
ܣܘܗܕܐ	s o hː d ɑː
ܡܟܡܥܬܐ	m a t͡ʃ m a ʕː t ɑː
ܡܓܪܒܢ	m ɡ a r v ɪ n
ܫܥܬ	ʃ a ʔ ɪ θ
ܩܢܐ	q ɑː n eː
ܥܪܝܨܘܬܐ	ʕ ə r iː sˤ uː θ ɑː
ܡܐܪܐ	m a ʔ r ɑ
ܡܢܬܐ	m ə n ɑː t ɑː
ܬܟܠܘܢܐ	t ɪ k l oː n aː
ܣܩܠܩ	s a q l ɪ q
ܡܐܢܠ	m ʔ a n n ɪ l
ܠܒܨܝܪ	l a w sˤ i rː
ܙܘܥܢܝܐ	z a w ʕ ɑː n ɑː j ɑː
ܬܦܩ	t aː f ɪ q
ܥܣܪ	ʔ ɪ s s a r
ܠܣܘܛܘ	l eː s oː tˤ oː
ܐܙܝܕܝܐ	ʔ eː z iː ɑː j ɑː
ܫܘܝܘܬܐ	ʃ oː j uː t ɑː
ܟܝܡܝܐ	k iː m iː j ɑː
ܒܪܙܝܠ	b r ɑː z i lː
ܒܕܩܬ	b ɑ dː q e tː
ܐܬܝܢܐ	ʔ ɑː θ j ɑː n ɑː
ܪܦܦܐ	r ə p ɑː p ɑː
ܣܥܪܬܐ	s ə ʕ a r t ɑː
ܡܛܠܬܐ	m ə tˤ a l l ə θ ɑː
ܡܨܘܪܢܝܬܐ	m ə sˤ oː r ɑː n iː t ɑː
ܩܪܘܫܬܐ	q ə r u ʃ t ɑː
ܡܣܡܐ	m a s m eː
ܒܨܠܐ	b ɪ sˤ l aː
ܚܕܥܣܝܪܝܐ	x a d ɪ ʕ s iː r ɑː j ɑː
ܪܚܩܐ	r ɪ x q ɑː
ܓܝܒܘܬܝ	j iː b uː t iː
ܐܝܣܪܬܐ	ʔ iː s ɑ rː t ɑː
ܨܒܥܐ	sˤ a b b ɑː ʕ ɑː
ܡܥܓܠܢܐ	m ə ʕ a ɣ l ɑː n ɑː
ܚܛܝܬܐ	x a tˤ tˤ aː j ə t aː
ܡܥܠܬܐ	m a ʕ ʕ a l t ɑː
ܬܠܐ	t ɑː l eː
ܓ̰ܘܪܒܐ	d͡ʒ u r b ɑː
ܬܪܘܕܐ	t a r w aː ð aː
ܙܓܪ	z ɑ ɣː e rː
ܦܨܚ	p aː sˤ ə x
ܚܫܘܠܐ	x aː ʃ oː l a
ܒܣܝܡܐ	b a s s iː m aː
ܚܙܝܘܢܐ	x ɪ z j oː n aː
ܦܢܕܩܐ	p ɪ n d ə q ɑː
ܝܬܘܢ	ʔ iː t o n
ܡܚܪ	m ə x ɑ rː
ܨܘܪ	sˤ o rː
ܡܢܚ	m a n n ɪ x
ܓܪܓ	d͡ʒ ɑː r a d͡ʒ
ܥܝܪܐ	ʕ iː r ɑː
ܡܠܘܦܐ	m a l uː p eː
ܠܟܣܝܩܘܢ	l ɪ k s iː q o nː
ܢܨܒ	n aː sˤ u
ܡܘܚܒܐ	m u x x ɪ b b ɑː
ܨܦܪܐ	sˤ a p p ɑː r ɑː
ܣܡܘܩܐ	s m oː q aː
ܦܬܐ	p aː θ ɑː
ܒܘܥܕܐ	b u ʕ d aː
ܩܪܣܝܐ	q eː r ɑ sː j ɑː
ܩܘܡܐ	q oː m ɑː
ܪܕܐ	r ɑː d eː
ܚܒܫ	x ɑː w e ʃː
ܡܛܪܝܬܐ	m a tˤ tˤ ɑː r iː θ ɑː
ܥܒܕܝܫܘܥ	ʔ oː d iː ʃ o ʔ
ܗܕܝ	h a d iː
ܛܒܝܥܐ	tˤ w i ʔ a
ܚܠܠܢܬܐ	x a l l i l ɑ nː t ɑː
ܚܐܪܘܬܐ	x iː r uː t ɑː
ܣܦܩܐܝܬ	s ɑ pː q ɑː ʔ iː t
ܐܟܘܡܬܐ	k a m t a
ܒܨܝܪܘܬܐ	b ə sˤ iː r uː θ ɑː
ܝܘܠܦܢܐ	j u l p ɑː n ɑː
ܛܘܪܝܐ	tˤ uː r ɑː j ɑː
ܫܘܐܠܐ	ʃ u ʔ ɑː l ɑː
ܫܛܚܐ	ʃ ɪ tˤ x aː
ܡܢܬܡܠܝ	m n ɑ θː m ɑː l iː
ܡܙܕܥܢܐ	m a z d ə ʕ ɑː n ɑː
ܡܟܬܒܬܐ	m a x t o t ɑː
ܛܢܟܐ	tˤ a n k ɑː
ܦܢܟܐ	p a ŋ k ɑː
ܩܝ	q a j
ܐܒܪܗܡ	ʔ a v r ɑ h ɑ m
ܡܚܐ	m a x h eː
ܒܪܣܡ	b a r s ɪ m
ܫܪܝܟܘܬܐ	ʃ a r r iː k uː t ɑː
ܚܘܣܪܢܐ	x u s r ɑː n ɑː
ܓܪܒܝܐ	d͡ʒ a r b ə j ɑː
ܡܝܬ	m i θː
ܣܝܕ	s ɑː j e dː
ܓܢܒܪܐ	ɡ a b b aː r aː
ܡܕܢܚ	m a ð n a x
ܡܚܒܪ	m a x b ɪ r
ܣܘܕ	s a w w ɪ d
ܬܚܘܬ	t ə x oː θ
ܚܘܛܡܠܠܐ	x uː tˤ ɑː m a l l ɑː l ɑ
ܐܣܛܘܢܝܐ	ʔ ɪ s tˤ oː n iː j ɑː
ܐܢܐ	ɑ n n e
ܬܠܝܬܝܐ	t l iː t ɑː j ɑː
ܡܪܥܝܢܐ	m a r ʕ ə j aː n aː
ܕܦܬܪܐ	d i p t ɑː r ɑː
ܣܓܝܐܐ	s a ɡ ɡ iː ʔ ɑː
ܫܘܪܛܐ	ʃ u r tˤ ɑː
ܒܩܘܪܒܐ	b ə q u r b ɑː
ܒܠܘܢܐ	b ɑː l oː n ɑː
ܚܪܝܦܐ	x a r r iː p ɑː
ܝܗܘܕܝܐ	h uː d aː j aː
ܩܗܐ	q a h eː
ܣܒܐ	s ɑː v ɑː
ܨܚܬܝܢ	s a x t e nː
ܡܫܬܘܬܐ	m ɪ ʃ t uː t ɑː
ܛܠܦܣܢܐ	tˤ l a p s ɑː n eː
ܕܒܘܫܐ	d a b b uː ʃ ɑː
ܫܗܐ	t͡ʃ a h eː
ܬܪܝܢܐ	t r a j j ɑː n ɑː
ܡܬܚ	m ɑː t e xː
ܡܚܘܒܐ	m a x uː b eː
ܡܐܝܟ	m a x
ܟܢܘܢܐ	k a n uː n eː
ܩܦܠܐܘܢ	q iː p ɑː l iː j u n
ܡܚܙܐ	m a x z eː
ܬܪܢܓܘܠܬܐ	t a r n u lː t ɑː
ܩܘܪܢܝܬܐ	q u r n iː t ɑː
ܝܟܛܐ	j a x tˤ ɑː
ܚܠܘܠܐ	x l uː l aː
ܣܘܟܢ	s a w k ɪ n
ܩܢܝܬܐ	q a n n iː t ɑː
ܡܒܕܒܕ	m b a ð b ɪ ð
ܡܠܝ	m ɑː l iː
ܬܪܘܩܬܐ	t ɑː r o qː t ɑː
ܚܪܒ	x ɑː r uː
ܡܬܩܢܐ	m a θ q ə n ɑː
ܡܓܪܓܫ	m ə ɡ a r ɡ ɪ ʃ
ܒܨܝܪ	b ə sˤ iː r
ܟܢܝܫܝܐ	k ə n iː ʃ ɑː j ɑː
ܡܟܦ	m a k ɪ p
ܡܠܝܘܢ	m i l j oː n
ܣܡܘܩܬܐ	s m a q t a
ܬܠܬܝܢܝܐ	t l ɑː θ iː n ɑː j ɑː
ܣܦܕܝܬܐ	s p a d iː θ a
ܟܠܟܠ	k a l k ɪ l
ܡܚܠܠ	m ə x a l l ɪ l
ܡܕܘܪ	m a d w ɪ r
ܠܦܐ	l a p p ɑː
ܫܒܠ	ʃ a b b ɪ l
ܢܩܕܐ	n a q ə d ɑː
ܦܪܝܫܐܝܬ	p ə r iː ʃː ʔ ɑ i θː
ܚܠܝܦܐ	x ə l iː p ɑː
ܡܦܪܫ	m a p r ɪ ʃ
ܬܘܪܓܡܐ	t u r d͡ʒ i mː m ɑː
ܐܦܓܢܣܛܢ	ʔ a f ɣ ɑː n ɪ s tˤ ɑː n
ܚܡܫܬ	x a m ʃ a θː
ܚܬܐ	x aː t eː
ܥܘܕܠܐ	ʔ uː d ɑː l eː
ܡܡܝܬ	m a m j ɪ t
ܬܢܓܝܓܠܐ	t ɪ n ɡ i ɣː l ɑː
ܡܟܠܝܐ	m a k l j ɑː
ܐܚܪܢܐ	x eː n ɑː
ܡܙܗܪܢܐ	m z a h r ɑː n ɑː
ܐܕܝ	ʔ a d d a j
ܡܨܝܬ	m a sˤ j ɪ θ
ܫܪܘܝܐ	ʃ a r w ɑː j ɑː
ܫܩܝܬܐ	ʃ ɑː q iː t ɑː
ܝܗܘܘ	ʔ iː w ɑ wː
ܬܦܨܝܠܐ	t a p sˤ iː l ɑː
ܥܬܝܩܬܐ	ʕ a t t i qː t ɑː
ܬܘ	t ɑ w
ܒܘܪܟܐ	b u r r aː x aː
ܟܠܝ	k u l l iː
ܣܦܣ	s aː p ɪ s
ܪܓܘܠܐ	r a w uː l a
ܐܣܛܘܢܐ	ʔ ɪ s s tˤ oː n ɑ
ܐܘܪܚܐ	u r x ɑː
ܐܝܪܢ	ʔ i r ɑː n
ܙܕܘܥܬܐ	z d o ʕ θ aː
ܕܢܒܘܣܬܐ	d a m b u s t a
ܗܕܩ	h a d d ɪ q
ܚܐܨ	ħ aː j ɪ sˤ
ܡܨܥܝܐ	m ɪ sˤ ʕ ɑː j ɑː
ܡܬܠ	m a t t ɪ l
ܡܪܟܒܐ	m a r k ə w ɑː
ܗܘܪܡܙܕ	h u r m iː z d
ܡܙܡܪ	m z a m m ɪ r
ܦܠܣܛܝܢܝܐ	p a l ɪ s tˤ iː n ɑː j ɑː
ܢܬܝܓܐ	n a t t iː d͡ʒ ɑː
ܡܥܢܝܐ	m a ʕ n ɑː j ɑː
ܟܪܡܠܫ	k a r m l ɪ ʃ
ܬܫܥܣܪܐ	t͡ʃ a ʕ ɪ s r eː
ܡܪܝܡ	m a r j a m
ܐܠܐ	ʔ ɪ l l aː
ܟܠܢܝܐ	k u l l ɑː n ɑː j ɑː
ܫܚܠܦ	ʃ a x l ɪ p
ܬܘܡܢܐ	t u m m ə n ɑː
ܟܘܐ	k a w w eː
ܪܘܓܙܐ	r u ɣ z ɑː
ܡܚܦܪܦ	m x a p r ɪ p
ܐܢܬ	ʔ a t
ܡܐܣܝܢܐ	m ə ʔ a s j ɑː n ɑː
ܡܒܠ	l aː b ɪ l
ܡܬܩܠܐ	m ɑ θ q ɑː l ɑː
ܫܡܥܐ	ʃ ɪ m ʕ ɑː
ܚܡܝܡܐ	x a m iː m ɑː
ܡܚܪܐ	m a x x ɑː r ɑː
ܡܢܐ	m ɑː n eː
ܡܟܫܛ	m a k ʃ ɪ tˤ
ܕܥܒܪ	d a ʕ w a r
ܕܡܕܡ	d a m d ɪ m
ܦܬܚ	p aː t ɪː x
ܙܢܓܒܝܠܐ	z a n ɡ ə v iː l ɑː
ܗܡܙܡܢܐ	h a m z m ɑː n ɑː
ܒܨܝܪܐ	b ə sˤ iː r ɑː
ܦܣܘܩܐ	p aː s oː q aː
ܫܦܬܝܐ	ʃ ɪ p t iː j ɑː
ܡܨܘܝܢܝܬܐ	m ə sˤ oː j ɑː n iː t ɑː
ܦܪܝܫܝܐ	p ə r iː ʃ ɑː j ɑː
ܢܒܝܐ	n v iː j aː
ܦܛܝܚܐ	p a tˤ iː x a
ܢܩܦ	n ɑː q e pː
ܡܨܢܥܬܐ	m a sˤ n a ʕ θ ɑː
ܚܝܬܐ	x a j j θ aː
ܒܝܕ	b j a d
ܝܬܒܬܐ	j a t t aː v ə t aː
ܒܟܐ	b ɑː x eː
ܥܝܢܗ	ʕ a j n e hː
ܕܘܓܠܐ	d u ɡ l aː
ܠܗܐ	l aː h eː
ܐܚܕܐ	ʔ ɪ x d ɑː
ܣܩܘܡܐ	s q o m ɑː
ܡܬܡܡ	m t a m m ɪ m
ܚܕܐ	x ð aː
ܢܝܚܐ	n iː x ɑː
ܗܠ	h a l
ܬܫܥܐ	t ɪ ʃ ʔ ɑː
ܦܛܪܝܩܐ	p a tˤ r iː q ɑː
ܡܫܬܐ	m a ʃ t eː
ܡܐܟܢܝܘܬܐ	m ɑ ʔː k eː n ɑː j uː t ɑː
ܬܓܪܝܐ	t a ɡ ɡ ɑː r ɑː j ɑː
ܪܝܫܐ	r eː ʃ ɑː
ܐܢܫܐ	n aː ʃ aː
ܛܥܝܫܐ	tˤ ə ʕ iː ʃ ɑː
ܣܒܝܪܐ	s ə w iː r ɑː
ܡܥܪܒ	m a ʔ r a v
ܡܩܕܪ	m i q d a r
ܕܫܕܫ	d a ʃ d ɪ ʃ
ܡܘܢܛܢܓܪܝܐ	m o n tˤ ɪ n eː ɡ r ɑː j ɑː
ܛܒܐ	tˤ aː w eː
ܟܪܘܛܝܐ	k r o aː tˤ i j aː
ܡܓܪܫ	m a ɡ r ɪ ʃ
ܡܩܪܛܢܐ	m ə q a r tˤ ɑː n eː
ܡܥܡܘܢܐ	m a ʕ m oː n ɑː
ܫܘܡܪ	ʃ uː m ɪ r
ܚܐܪܐ	x iː r ɑː
ܐܘܫܥܢܐ	o ʃ a ʕ n ɑː
ܟܪܣܢܐ	k a r s aː n aː
ܫܬܝܬܝܐ	ʃ t iː t ɑː j ɑː
ܪܚܩ	r aː ħ ɪ q
ܫܘܝܨܪܝܐ	ʃ ə v a j sˤ r ɑː j ɑː
ܐܠܦܝܢ	ʔ a l p e nː
ܡܘܣܦ	m oː s ɪ pː
ܫܦܝܪ	ʃ a p p i rː
ܟܝܪܐ	x ə j ɑː r ɑː
ܡܣܓܐ	m a s ɡ eː
ܬܪܡܠܐ	t a r m ɑː l ɑː
ܚܕܬ	x a d d i t
ܢܚܢܚܬܐ	n a x n a x t ɑː
ܓܢܓܙ	d͡ʒ a n d͡ʒ ɪ z
ܐܐܪܝܐ	ʔ ɑː ʔ a r ɑː j ɑː
ܫܪܫܐ	ʃ ɪ r ʃ ɑː
ܨܝܢܝܐ	sˤ iː n ɑː j ɑː
ܡܠܦܢܬܐ	m a l p a n iː θ a
ܓܙܐܝܪܝܐ	d͡ʒ a z ɑː j i r ɑː j ɑː
ܗܕܪ	h a d ɪ r
ܥܠܥܠܐ	ʕ a l ʕ ɑː l ɑː
ܡܓܪܓܡ	m ɡ a r ɡ ɪ m
ܐܙܠ	ʔ ɑː z e lː
ܫܠܨ	ʃ aː l ɪ sˤ
ܥܝܢ	ʕ eː n
ܬܐܓܘܪܬܐ	t e ʔ ɣ u r tː ɑ
ܫܒܛܢܝܐ	ʃ a v tˤ aː n aː j aː
ܛܠܝܐ	tˤ a l j aː
ܚܘܠܢܐ	x u l l ɑː n ɑː
ܒܘܪܟܬܐ	b u r k ə θ ɑː
ܠܬ	l e t
ܫܓܠ	ʃ ɑː ɣ ə l
ܠܘܚܝܬܐ	l u x iː θ ɑː
ܚܘ	x uː
ܠܥܙܪ	l a ʕ ɑː z a r
ܓܠܝܐ	d͡ʒ ɪ l j ɑː
ܗܠܟ	h ɑː l e xː
ܚܕܬܐ	x a d t eː
ܟܝܠܐ	k a j j ɑː l ɑː
ܝܠܕܐ	j a l d ɑː
ܚܕܪ	x aː d ɪ r
ܕܝܢܨܘܪܐ	d iː n ɑː sˤ oː r ɑː
ܬܘܣܦܬܐ	t ɑ w s a p t ɑː
ܩܐܡ	q ɑː j e mː
ܕܪܒܐ	d ɪ r b ɑː
ܣܢܓܠ	s ɪ n ɡ ɑ lː
ܟܘܝܬ	k w e t
ܐܣܝܐ	ʔ ɑ sː iː j ɑ
ܐܝܕܐ	ʔ iː d ɑː
ܓܘܪܓܐ	ɡ o r d͡ʒ ɑː
ܓܚܟ	d͡ʒ ɑː x ɪ t͡ʃ
ܡܐܣܪܬܐ	m e ʔ s ɑ rː t ɑː
ܐܘܢܐ	ʔ aː w ɑː n ɑː
ܬܫܡܫܝܬܐ	t ɪ ʃ m ɪ ʃ j ɑː t eː
ܐܘܡܬܢܝܐ	ʔ u m t ɑː n ɑː j ɑː
ܪܘܒܥܐ	r u v ʕ ɑː
ܣܝܩܘܡܐ	s e̝ q oː m ɑː
ܚܘܕܬܐ	x u d ɑː t ɑː
ܡܛܪܡܫ	m tˤ a r m ɪ ʃ
ܩܫܝܐ	q ɪ ʃ j aː
ܓܢܒ	d͡ʒ ɑː n ɪ vː
ܒܢܝܐ	b a n n aː j aː
ܟܡܕ	k ɑː m e ðː
ܡܕܝܢܬܘܢܝܬܐ	m ə ð iː t t oː n iː θ ɑː
ܢܨܪܝܐ	n ɑ sˤː r ɑː j ɑː
ܓܘܝܒܐ	d͡ʒ u j j ɑː v ɑː
ܬܥܠܐ	t a ʕ l ɑː
ܟܝܢܐ	k j ɑː n ɑː
ܐܫܟܐ	ʃ ɪ k θ a
ܒܪܟܐ	b a ɾ kʰ ä
ܛܐܣ	tˤ ɑː j e sː
ܡܦܣܢܘܬܐ	m a p s ɑː n uː t ɑː
ܬܘܢܣ	t uː n ɪ s
ܐܟܪܬܐ	a k k ɑ rː t ɑː
ܟܪܝܐ	k ɪ r j ɑː
ܐܢܫܘܬܐ	n ɑː ʃ uː t ɑː
ܥܣܪܝܐ	ʕ ɪ s r a j j eː
ܬܘܠܬܐ	t u l l ə θ ɑː
ܟܘܟܝܬܐ	k oː x iː t ɑː
ܩܝܡ	q ɑː j eː m
ܢܦܫܐ	n a f ʃ ɑː
ܗܘܪ	h ɑː w ɑ rː
ܓܡܝܟܐ	d͡ʒ a m ɑ jː k aː
ܐܘܝܘܬܐ	ʔ a w j uː θ ɑː
ܦܘܫܐ	p oː ʃ ɑː
ܠܩܕܡܐ	l a q ɑː m ɑː
ܨܢܥ	sˤ ɑː n e ʕː
ܥܒܘܝܐ	ʔ ɪ b b oː j a
ܒܣܡ	b ɑː s e mː
ܡܟܠܒܢ	m k a l b ɪ n
ܣܗܪܐ	s a h r ɑː
ܝܪܚܐ	j a r x ɑː
ܡܕܪܟܢܘܬܐ	m a d r ə x ɑː n uː t ɑː
ܝܡܝܢܐ	j a m m iː n ɑː
ܩܪܛܝܣܐ	q a r tˤ eː s ɑː
ܨܢܕܘܩܐ	sˤ a n d uː q ɑː
ܥܢܐ	ʕ ɑː n eː
ܐܟܝܬܘ	a k iː t uː
ܐܓܪܝܬܐ	i d͡ʒ d͡ʒ a r j ɑː t e
ܝܬܝܪ	j a t t iː r
ܦܘܫܝܐ	f uː ʃ i j ɑː
ܫܬܝܬܐ	ʃ a t eː θ a
ܩܘܢܕܝܢܘܣ	q eː w a n d eː n o sː
ܚܘܪܘܬܐ	x oː r uː θ a
ܡܘܫܟܠܐ	m ʊ ʃ kʰ ɪ l ä
ܡܘܕܝ	m oː d iː
ܗܕܟ	h aː d a x
ܕܪܓܐ	d a r ɑː
ܬܘܢܐ	t a w w ɑː n ɑː
ܙܪܓܐ	z a r a
ܣܡܪܢܐ	s ə m a q r ɑː j ɑː
ܕܒܘܫܬܐ	d a b b u ʃː t ɑː
ܕܡܝܟܐ	d ə m iː x ɑː
ܒܢܓܠܕܫ	b a n ɡ ə l ɑː d eː ʃ
ܝܐܠܗ	j a l l ɑː
ܬܚܒܪܬܐ	t a x b a r t ɑː
ܫܘܪܛܝܐ	ʃ u r tˤ aː j ɑː
ܐܢܝܘܬܐ	ɑː n ɑː j uː t ɑː
ܨܠܐ	sˤ aː l eː
ܬܪܝܢ	t r e nː
ܥܪܒܢܐ	ʕ a r b ɑː n ɑː
ܥܘܪܦܢܐ	ʕ u r p ɑː n ɑː
ܪܡܘܢܕܐ	r ɪ m uː n ɑː d ɑː
ܣܦܝܢܬܐ	s p iː t t ɑː
ܓܠܣ	ɡ l ɑː s
ܩܝܪ	q ɑː j ɪ rː
ܐܟܘܬܝܐ	a x w ɑː θ ɑː j ɑː
ܟܡܐ	k ə m aː
ܫܩܠ	ʃ ɑː q e lː
ܚܕܝܐ	x ɪ ð j a
ܢܩܒܬܐ	n q ɪ p θ a
ܘܙܝܪܐ	w a z z iː r ɑː
ܡܐܙܠܬܐ	m eː ʔ z a l t ɑː
ܢܒܓܐ	n oː ɡ ɑː
ܐܪܒܥܣܪܐ	a r b a ʕ ɪ s r eː
ܫܘܪܛܝܬܐ	ʃ u r tˤ a jː θ ɑː
ܐܦܘܟܕܘ	a f o k aː d oː
ܢܦܠ	n ɑː p e lː
ܠܒܢܢܝܐ	l j u n ɑː n ɑː j ɑː
ܡܙܓ	m a z e
ܕܠܐ	d ə l ɑː
ܫܠܡܐ	ʃ a l m ɑː
ܢܡܣܐ	n ɪ m s aː
ܙܥܘܪܐ	sˤ uː r ɑː
ܨܦܢܝܐ	sˤ p a n j a
ܐܪܘܢܐ	ʔ ɑː r oː n ɑː
ܐܝܡܝܠ	ʔ iː m a j l
ܡܛܚܢܐ	m a tˤ x ɑː n ɑː
ܙܠ	z e lː
ܟܝܠܘܡܝܛܪܐ	k iː l oː m iː tˤ r ɑː
ܗܘܝܐ	h ɑː w ɑː j ɑː
ܐܪܒܥܡܐܐ	ʔ a r b a ʕ m ə ʔ ɑː
ܓܘܬܬܐ	d͡ʒ u t t ɑː
ܠܩܝܫܐܝܬ	l q iː ʃ ɑː ʔ iː t
ܡܫܚܛܐ	m a ʃ ɑː x a tˤ tˤ ɑː
ܝܒܫ	j aː v ɪ ʃ
ܐܘܪܢܘܣ	ʊː r ɑː n o s
ܥܪܦ	ʕ a r r ɪ p
ܫܘܥܐ	t͡ʃˤ oː ʕ a
ܫܡܝܐ	ʃ m a j j ɑː
ܡܒܠܕܪ	m ə b a l d ɪ r
ܟܬܘܒܬܐ	k ɑː t o wː t ɑː
ܬܚܬܘܝܐ	t a ħ t oː j aː
ܡܕܪܫܬܐ	m a d r a ʃ t ɑː
ܬܫܪܝܢ	t i ʃ r iː n
ܟܘܪܣܝܐ	k u r s ə j ɑː
ܦܫܝܡܐ	p ə ʃ iː m ɑː
ܥܝܩܐ	ʕ iː q ɑː
ܢܣܝܪܐ	n ə s iː r ɑː
ܒܢܦܫܐ	b ɑː n a f ʃ ɑː
ܡܥܪܒܐ	m a ʔ ə r v ɑː
ܬܩܢ	t a q q ɪ n
ܨܘܒܝܐ	sˤ oː b ɑː j ɑː
ܣܠܘܦܝܬܐ	s a l l oː p iː θ ɑ
ܡܬܥܠ	m t a ʕ ɪ l
ܣܠܘܒܢܝܐ	s l o v eː n i j aː
ܐܝܩܪܬܐ	ʔ iː q a r t ɑː
ܐܪܝܬܪܐ	ʔ eː r i θː r eː
ܗܘܠܢܕܐ	h oː l a n d ɑː
ܥܟܒܝܬܐ	ʔ a t͡ʃ t͡ʃ ɑː v iː t ɑː
ܟܐܢܐ	k eː n aː
ܕܠܩܒ	d a l q uː
ܫܡܘܢܝ	ʃ m uː n iː
ܡܐܝܐ	m a ʔ ɑː j ɑː
ܒܠܢܐ	b a l l ɑː n ɑː
ܠܥܣ	l a ʔ ɪ s
ܡܥܠܠ	m ə ʕ a l l ɪ l
ܦܪܫܘܢܐ	p ɪ r ʃ oː n aː
ܝܒܫܐ	j a v ʃ ɑː
ܕܘܟܬܢܝܐ	d u k ə t ɑː n ɑː j ɑː
ܐܓܪܘܬܐ	ɡ ɑː r ɑː w ɑː t eː
ܛܒܥ	tˤ ɑː b e ʔː
ܡܐܬ	m ɑː j e tː
ܐܡܘܪܐ	ʔ a m uː r ɑː
ܚܫܢܐ	x a ʃ ʃ ɑː n ɑː
ܪܚܦ	r ɑː x e pː
ܓܢܕܘܪܐ	d͡ʒ i n d uː r ɑː
ܚܓܐ	ħ ɪ ɡ ɡ aː
ܕܪܐ	d ɑː r eː
ܣܡܠܐ	s i m m aː l aː
ܡܬܠܓܢܝܬܐ	m a t l ə ɣ ɑː n iː t ɑː
ܥܢܒܝܬܐ	ʔ ɪ n w iː θ aː
ܚܝܦܐ	x a j f ɑː
ܡܒܝܢ	m a b j ɪ n
ܒܘܫ	b u ʃː
ܬܠܬ	t a l ɪ t
ܡܪܒܥܐ	m ə r a b ʕ ɑː
ܚܝܘܬ	x a j j u tː
ܙܝܡܒܒܘܐ	z i mː b ɑ bː w eː
ܦܬܚܐ	p ə θ ɑː x ɑː
ܒܪܙܝܠܝܐ	b r ɑː z iː l i jː j ɑː
ܡܚܠܝܬܐ	m a x l a j t ɑː
ܒܥܐ	b a ʔ eː
ܬܓܓ	t a ɡ ɡ ɪ ɣ
ܡܫܘܬܦ	m ə ʃ ɑ w t ɪ p
ܐܪܒܥܒܫܒܐ	a r b oː ʃ eː b ɑː
ܪܘܣܝܐ	r uː s i j ɑː
ܫܡܥܚܙܘܝܐ	ʃ ɪ m ʕ ə x ɪ z w ɑː j ɑː
ܡܕܗܐ	m ə h a d d eː
ܙܝܬܐ	z a j t ɑː
ܠܓܘ	l ə ɡ oː
ܬܐܘܕܘܪܘܣ	t eː ʔ o d oː r o sː
ܒܘܡܒܐ	b o m b ɑː
ܪܟܒ	r a k k uː
ܝܘܡܐ	j a w m ɑː
ܐܪܟܐ	ʔ a r k ɑː
ܫܘܦܐ	ʃ ɑ w p ɑː
ܛܒܝܒܐ	tˤ v iː v ɑː
ܡܪܟܒܬܐ	m a r k oː t ɑː
ܚܪܙܦ	x a r z ɪ p
ܚܘܛܡܠܠ	x uː tˤ ɑː m a l l i l
ܦܠܣܛܝܢܐ	p a l ɪ s tˤ iː n ɑː
ܕܠܡܐ	d a l m ɑː
ܐܢܛܘܢܝܘܣ	a n tˤ ʊː n j o s
ܢܘܨܦܐ	n u sˤ p ɑ
ܟܡܒܘܕܝܐ	k ɑ mː b oː ð iː j ɑː
ܣܪܥܦ	s a r ʕ ɪ p
ܐܠܦܐ	ʔ a l p ɑː
ܓܪܥ	d͡ʒ ɑ r r e ʔ
ܡܬܢܐ	m ə t a n n eː
ܢܦܫܗ	n a f ʃ e hː
ܢܗܪܐ	n a h r ɑː
ܨܠܝܒܝܐ	sˤ l iː w ɑː j ɑː
ܡܘܒܠܐ	m a w b ə l ɑː
ܟܬܪ	k ɑː θ e rː
ܐܪܢܒܐ	h a r n uː w a
ܛܒܬܐ	tˤ oː t ɑː
ܡܚܡ	m a x x ɪ m
ܡܚܕܘܪܐ	m a x d uː r ɑː
ܚܝܬ	x a j j a t
ܚܡܬܐ	x a m θ ɑː
ܚܘܓܬܐ	x o ɣ t ɑː
ܝܘܬܪܢܐ	j u t r ɑː n ɑː
ܩܠܥ	q aː l e ʔ
ܡܐܝܟܐ	m eː t͡ʃ aː
ܣܐܩ	s ɑː j ɪ qː
ܚܣܟ	x a s s ɪ x
ܐܝܪܠܢܕܐ	ʔ a j r l a n d ɑː
ܐܡܝܪܘܬܝܐ	ʔ a m i rː w ɑː θ ɑː j ɑː
ܓܗܢܐ	d͡ʒ eː h a n n ɑː
ܐܘܫܦܐ	ʔ u ʃ p ɑː
ܩܘܣܛܢܛܝܢܘܦܘܠܝܣ	q u s tˤ a n tˤ iː n uː p oː l i sː
ܡܩܢܛܪܢ	m ə q a n tˤ r ɪ n
ܝܠܝܕܐ	l iː d aː
ܐܫܬܥܣܪ	ʃ t ɑː s a r
ܒܨܐ	b aː sˤ eː
ܒܣܝܡܝܬܐ	b a s s i m j aː θ aː
ܓܝܠܣܬܐ	d͡ʒ iː l ɑ sː t aː
ܦܬܘܪܐ	p ɑː t oː r ɑː
ܫܘܫܐ	ʃ uː ʃ ɑː
ܐܒܗܬܐ	ʔ a v ɑː h ɑː t eː
ܗܦܟܐ	h a p p ɑː x ɑː
ܥܡܢܘܐܝܠ	ʕ a m m a n u v ɪ l
ܟܠܒ	k ɑː l ɑ wː
ܓܘܐ	d͡ʒ ɑː v ɑː
ܡܚܕܝܐ	m ɪ x d ɑː j ɑː
ܠܒܒ	l a b b ɪ w
ܪܓܠܐ	r a d͡ʒ d͡ʒ ɑː l ɑː
ܡܠܘܝ	m ɑː l ɑː w iː
ܩܘܪܐܢ	q u r ʔ ɑː n
ܣܐܡܐ	s e ʔː m ɑː
ܓܪܕܒܘܠܐ	d͡ʒ a r d ɑː b uː l eː
ܠܒܢܢܝܬܐ	l i b n ɑː n eː t ɑː
ܩܫܐ	q a ʃ a
ܪܓܝܙܐ	r ə ɣ iː z ɑː
ܡܚܪܡܛ	m x a rˤ m ɪ t͡ʃˤ
ܬܪܩ	t ɑː r e qː
ܪܒܝܥܐ	r v iː j ɑː
ܓܡܝ	d͡ʒ aː m iː
ܠܘܘܝܐ	l u w ɑː j ɑː
ܐܒܓܕ	a b d͡ʒ a d
ܒܚܝܐ	b iː x a jː j eː
ܩܪܥܐ	q a r a
ܒܢܝܡܝܢ	b ɪ n j ɑː m eː n
ܬܘܪܬܐ	t aː w i r t ɑː
ܡܫܢܐ	m ə ʃ a n n eː
ܫܐܝܠܐܝܬ	ʃ iː l ɑː ʔ iː t
ܫܘܠܐ	ʃ uː l ɑː
ܡܝܠܛܝܐ	m iː l eː tˤ ɑː j ɑː
ܓܠܐ	d͡ʒ ɑː l eː
ܡܘܠܕܢܐ	m ɑ w l d ɑː n ɑː
ܟܘܒܐ	k u b b ɑː
ܐܝܛܠܝܐ	ʔ iː tˤ ɑː l iː j ɑː
ܥܕܬܐ	ʔ eː t a
ܫܥܫ	ʃ ɑː ʔ ɪ ʃː
ܠܩܛ	l a q q ɪ tˤ
ܡܠܚܡܢܝܬܐ	m ə l a x m ɑː n i t ɑː
ܦܪܕܝܣܩܐ	p a r d e s q ɑː
ܓܪܘܣܬܐ	ɡ a r ɪ s t a
ܢܘܚ	n o x
ܩܝܢܐ	q iː n aː
ܕܩܠܬ	d ɪ q l a t
ܡܙܕܕܩܢܐ	m ɪ z d a d q ɑː n ɑː
ܕܝܠܢܝܐ	d iː l ɑː n ɑː j ɑː
ܦܘܪܬܩܠܬܐ	p u r t ə q ɑ l t ɑː
ܓܘܢ	ɡ o nː
ܟܬܝܒܐ	k ə θ iː w aː
ܠܒܢܢ	l j u n ɑ nː
ܡܡܠܐ	m a m l eː
ܕܩܪ	d aː q e rː
ܟܝܕܢ	t͡ʃ a jː d ɑ nː
ܩܪܩܦܬܐ	q a r q a p t aː
ܟܗܪܟܘܒܐ	t͡ʃˤ ə h ɑ rː t͡ʃˤ uː w ɑː
ܬܫܘܝܬܐ	t ɪ ʃ w iː t ɑː
ܩܡܝܫܘܥ	q a m iː ʃ u
ܩܪܐ	q ɑː r eː
ܡܫܡܫܢ	m ə ʃ a m ʃ ɪ n
ܐܚܟܝ	a x t͡ʃˤ iː
ܫܗܘܐ	t͡ʃ e h w a
ܡܫܬܐܠܢܐ	m ɪ ʃ t a ʔ l ɑː n ɑː
ܐܬܢܘܣ	ɑː t eː n o sː
ܐܣܦܢܝܐ	ʔ ɪ s p ɑː n i j ɑː
ܨܐܪ	sˤ aː j eː r
ܡܝܪܩܢܐ	m a j r ə q aː n aː
ܡܫܘܕܥ	m ə ʃ ɑ w d ɪ ʕ
ܫܘܐ	ʃ w ɑː
ܓܝܢܐ	ɡ iː n eː
ܡܚܪܒ	m a x r u
ܗܪܘܡܐ	h iː r oː m ɑː
ܡܣܡܣܡܢܐ	m ə s a m s ə m ɑː n ɑː
ܐܒܐ	ʔ a v ɑː
ܢܡܝܒܝܐ	n ɑː m iː v i j ɑː
ܟܟܡܟܐ	t͡ʃ e k m a t͡ʃ ɑː
ܚܠܦܫܡܐ	x ə l ɑ pː ʃ ə m ɑː
ܐܟܝܕ	ʔ a k k i dː
ܛܝܡܐ	tˤ iː m ɑː
ܬܪܒܝܬܐ	t a r b iː t ɑː
ܦܠܝܛܐ	p a l l iː tˤ ɑː
ܠܟܝ	l e x
ܟܠܝܐ	k ɪ l j ɑː
ܘܠܐ	w ɑː l eː
ܢܒܚ	n ɑː v ɪ xː
ܐܣܛܘܟܣܐ	ʔ ɪ s tˤ u x s ɑː
ܣܒܬܐ	s a w t ɑː
ܬܠܦܐ	t ɪ l p ɑː
ܓܘܐܝܬ	ɡ ɑː w ɑː ʔ i θː
ܨܐܡ	sˤ ɑː ʔ e mː
ܕܘܫܐ	d oː ʃ ɑː
ܠܒܢܬܐ	l ə v ɪ t t ɑː
ܐܚܪܐܝܬ	x ɑː r ɑː ʔ i θː
ܬܫܥܡܐܐ	t ə ʃ a ʕ m ə ʔ ɑː
ܓܘܢܢܐ	ɡ ɑ w n ɑː n ɑː
ܠܫܢܐ	l ɪ ʃ ʃ ɑː n ɑː
ܢܪܡܣܝܢ	n a r aː m s iː n
ܪܩܐ	r a q q aː
ܒܢܐܦܠ	b ɑː n iː p ɑ lː
ܐܘܩܝܢܘܣ	ʔ uː q ə j ɑː n o sː
ܡܙܢܓܪ	m d͡ʒ a n ɡ ɪ r
ܡܬܚܙܐ	m ɪ θ ħ ə z eː
ܡܣܬܟܝܢܐ	m ɪ s t a k j ɑː n ɑː
ܡܠܕ	m a j l ɪ d
ܕܘܟܢܐ	d u k ɑː n eː
ܣܢܐܓܪܬܐ	s n iː ɣ a r t ɑː
ܘܘ	w a w
ܦܪܣܝܐ	p ɑ rː s ɑː j ɑː
ܢܘܒܐ	n oː b ɑː
ܟܘܟܒܐ	k a w x ə v aː
ܩܐܬ	q aː j ɪ ħ
ܥܪܒܐ	r ɑː v ɑː
ܐܘܪܘܦܐ	ʔ uː r oː p eː
ܐܫܬܡܐܐ	ʔ ɪ ʃ t a m ə ʔ ɑː
ܒܝܠܕܪܐ	b i lː d ɑː r ɑː
ܬܘܒ	t a w w ɪ b
ܒܪܩܐ	b a r r ɑː q ɑː
ܒܪܩܝܐ	b ɪ r q ɑː j ɑː
ܝܗܘܐ	ʔ iː w ɑː
ܟܝܠܗ	k a j l e hː
ܡܓܚܟܢܐ	m a d͡ʒ x i t͡ʃ t͡ʃ ɑː n ɑː
ܪܛܒܐ	r a tˤ ə w ɑː
ܣܒܪ	s ɑː w e rː
ܦܘܬܚܐ	p u t t ɑː x ɑː
ܡܐܟܠ	m a ʔ x ə l
ܡܝܛܪܐ	m iː tˤ r ɑː
ܕܠܬ	d a l l a t
ܟܪܒ	k ɑː r e bː
ܐܪܝܬܐ	ɑ r j ɑː
ܦܪܢܓܝܐ	p r a n d͡ʒ ə j ɑː
ܦܘܢܕܐ	p u n d ɑː
ܙܢܝܘܬܐ	z aː n j uː t a
ܒܡܪܘܡܐ	b a m r ɑ wː m eː
ܢܘܪܢܝܐ	n uː r ɑː n ɑː j ɑː
ܥܪܝܨܐ	ʕ ə r iː sˤ ɑː
ܬܫܟܝܐ	t͡ʃ eː x ɑː j ɑː
ܣܘܓܠܐ	s u ɡ ɡ ɑː l ɑː
ܡܬܚܡܐ	m ə t a x m ɑː
ܐܟܪ	ʔ ɑː t͡ʃ ɪ rː
ܓܒܪܬܐ	d͡ʒ v a rː t aː
ܡܪܣܣܢܐ	m r a s s ɑː n ɑː
ܒܛܪܝܬܐ	b a tˤ tˤ ɑː r iː t ɑː
ܓܘܢܩܐ	d͡ʒ oː n q a
ܐܒܘ	ʔ a w uː
ܐܝܟܢܝܘܬܐ	ʔ a j k a n n ɑː j uː θ ɑː
ܫܒܥܬ	ʃ o ʕ ɑ θː
ܓܒܪܐ	d͡ʒ a v r ɑː
ܩܢܘܢܐ	q ɑː n oː n ɑː
ܟܡ	k ɪ m
ܠܝܡ	l aː j ɪ m
ܪܒ	r a b
ܐܓܘܣܛܘܣ	ɑː ɣ u s tˤ o sː
ܒܘܠܒܠܐ	b u l b ɑː l ɑː
ܙܥܦܪܢܐ	z a ʕ p r ɑː n ɑː
ܛܘܣܐ	tˤ ɑ w s ɑː
ܡܣܒܐ	m a s w ɑː
ܒܚܪܝܢ	b a x r e nː
ܥܛܡܐ	ʔ a tˤ m a
ܝܦܢ	j a p a nː
ܟܠܟ	k a l ɪ k
ܟܘܫܦܐ	k u ʃ p ɑː
ܡܦܫܛ	m a p ʃ ɪ tˤ
ܕܟܝܐ	d ɪ x j ɑː
ܬܡܢܥܣܪ	t m a n j a s s a r
ܫܒܥܐ	ʃ a v v ɑː
ܐܫܘܪ	ʔ aː ʃ oː r
ܬܘܪܟܝܐ	t u r k ɑː j ɑː
ܫܘܡܪܝܐ	ʃ uː m ə r ɑː j ɑː
ܬܡܢܝܐ	t m a n j ɑː
ܝܩܘܪܬܐ	j a q q u rː t ɑː
ܫܓܫ	ʃ a ɡ ɡ ɪ ʃ
ܡܬܚܐ	m ɪ t x ɑː
ܓܘܢܚܐ	d͡ʒ u n x ɑː
ܥܡܬܐ	ʔ a m t ɑː
ܡܘܗܒܬܐ	m a w h a v t ɑː
ܡܕܪܟ	m a d r ɪ x
ܡܙܝܥ	m a z j ɪ ʕ
ܝܡܝܢܐܝܬ	j a m m iː n ɑː ʔ i θː
ܠܘܝܐ	l eː w ɑː j ɑː
ܕܐܟܝܘܬܐ	d ɑː x iː uː t ɑː
ܡܫܪܝܐ	m a ʃ r j ɑː
ܡܪܕܘܬܐ	m a r d uː t ɑː
ܠܘܟܣܡܒܘܪܓܐ	l u k s ɪ m b u r d͡ʒ aː
ܐܘܘܐ	ʔ u v v a
ܚܒܩ	x a b b ɪ q
ܣܘܦܪܐ	s u p r ɑː
ܩܐܪ	q aː ʔ ɪ r
ܨܢܕܘܩܬܐ	sˤ a n d u qː t ɑː
ܡܝܒܫܢܐ	m j a w ʃ ɑː n ɑː
ܛܡܛܐ	tˤ ɑː m ɑː tˤ ɑː
ܕܡܟ	d ɑː m e xː
ܡܬܫܘܫ	m t a ʃ w ɪ ʃ
ܐܣܝܬܐ	ɑː s iː t ɑː
ܡܚܫܒ	m a x ʃ ɪ w
ܡܓܠܕܢܐ	m a ɡ l ə d ɑː n ɑː
ܕܘܕܠܝܢܐ	d oː d ɪ d j aː n eː
ܣܒܥ	s ɑ w eː
ܓܕܝܐ	d͡ʒ a d j ɑː
ܘܠܝܐ	w ɑː l i j ɑː
ܩܡܘܙܐ	q ɑː m oː z ɑː
ܡܥܘܩܐ	m ə ʔ a w w q ɑː
ܠܡܣܘ	l a m a s s uː
ܡܘܢܚܐ	m u n n ɑː x ɑː
ܡܐܦܝܬܐ	m eː ʔ p iː θ ɑː
ܚܐܛ	x ɑː ʔ e tˤː
ܡܢܘܢܐ	m n a w n eː
ܡܚܨܐ	m x aː t͡ʃˤ eː
ܠܝܒܪܝܐ	l i wː r i j ɑː
ܩܘܪܝܩܘܣ	q u r j aː q oː s
ܓܠܓܠ	ɡ a l ɡ ɪ l
ܚܠܝܡܐ	x ə l iː m ɑː
ܐܪܕܝܟܠܐ	a r d i xː l ɑː
ܥܡܘܪܐ	ʕ ɑː m oː r ɑː
ܬܦܢܟ	t a p n i x
ܚܘܝܨܐ	x u j j ɑː s ɑː
ܐܠܘ	ʔ a l uː
ܨܦܐ	sˤ aː p eː
ܟܐܡ	t͡ʃˤ aː j ɪ m
ܬܟܠܐ	t a k l ɑː
ܛܦܝܬܐ	tˤ a p eː θ a
ܡܝܩܪܐ	m ə j a q q r aː
ܕܡܝܢܐ	d a m j ɑː n ɑː
ܐܘܟܪܢܝܐ	ʔ u k r ɑː n i j ɑː
ܐܪܒܥ	ʔ a r b a ʔ
ܚܡܫܒܫܒܐ	x a m ʃ oː ʃ aː b a
ܒܛܝܒܛܘ	b ɑː tˤ iː b ɑː tˤ oː
ܕܪܟ	d ɑː r e xː
ܡܚܠܦ	m a x l ɪ p
ܐܟܠܩܪܨܐ	ɑː x ɪ l q a r sˤ ɑː
ܛܥܐ	tˤ ɑː ʕ eː
ܕܘܟܬܘܪܐ	d o x t oː r eː
ܟܡܝܥܐ	t͡s ɪ mː j ɑː
ܕܝܬܩܐ	d iː j ɑː t eː q e
ܙܟܘ	z ɑː x oː
ܝܪܩܐ	j a r q ɑː
ܣܦܣܠܐ	s a f s eː l ɑː
ܚܒܝܒܐ	x a b b iː w ɑː
ܕܘܟܬܘܪ	d o x t o r
ܠܥܠ	ʔ u l l u l
ܡܬܦܪܥܢܐ	m ɪ t p a r ʕ ɑː n ɑː
ܐܩܠܐ	a q l ɑː
ܫܢܬܐ	ʃ a n t ɑː
ܡܒܣܚ	m b ā s i ḥ
ܕܗܘ	d ə a w aː
ܩܛܘܡܐ	q ə tˤ oː m ɑː
ܡܨܬ	m a sˤ ɪ θ
ܡܘܬܐ	m a w t aː
ܢܣܒ	n ɑː s e wː
ܐܢܛܪܩܛܝܩܐ	ʔ a n tˤ ɑ r qː tˤ iː q ɑː
ܫܡܚܢܐ	ʃ ɪ m x ɑː n ɑː
ܣܡܩܪܝܐ	s ə m a q r ɑː j ɑː
ܡܦܫ	m a p p ɪ ʃ
ܬܛܠܝܠܐ	t a tˤ l iː l ɑː
ܬܡܙ	t a m m i z
ܬܫܪܝܘܬܐ	t ɪ ʃ r j ɑː w ɑː t eː
ܝܘܗܒܠܬܐ	j u w e lː t ɑː
ܡܝܘܩܪܐ	m j u q q r aː
ܩܐ	q ɑː
ܡܛܐ	m ɑː tˤ eː
ܡܬܡܕܢܚܢܐ	m ɪ θ m a d n ə x ɑː n ɑː
ܬܝܡܢܐ	t a j m n ɑː
ܟܒܝܪܐ	k a b b iː r ɑː
ܪܨܝܦܐ	r ə sˤ iː p ɑː
ܒܬܘܠܬܐ	b t ʊ l t ɑː
ܓܡܠܬܐ	ɡ ə m a l t ɑ
ܐܡܝܪܝܟܝܐ	ʔ ɑː m e r iː k ɑː j ɑː
ܫܒܥܡܐܐ	ʃ a v v ɪ m m ɑː
ܚܡܝܫܝܐ	x m iː ʃ ɑː j ɑː
ܢܘܢܐ	n ʊː n ɑː
ܬܒܪ	t ɑː w e rː
ܡܝܪܛܠܐ	m i r tˤ ə l l ɑː
ܒܢܦܫܝܐ	b ɑː n a f ʃ ɑː j ɑː
ܫܒܘܛܐ	d͡ʒ ə v oː tˤ a
ܐܪܢܒܬܐ	a r n a v t ɑː
ܡܣܚܪ	m a s x ɪ r
ܡܨܥܪ	m sˤ a ʔ ɪ r
ܒܝܢ	b eː n
ܚܝܘܐ	x eː w ɑː
ܬܘܓܘ	t oː ɣ oː
ܡܒܝܐ	m b a j j ɪ ʔ
ܛܘܪܩܝܐ	tˤ u r q ɑː j ɑː
ܕܢܒܐ	d a n v aː
ܐܚܘܕܐ	ʔ ɑː x oː ð ɑː
ܐܢܢܣ	ʔ ɑː n ɑː n ɑ sː
ܢܐܣ	n a ʔ ɪ s
ܠܡܦܝܕܐ	l a m p iː d ɑː
ܛܐܠܢܐ	tˤ a l ɑː n ɑː
ܓܠܝܕܬܐ	d͡ʒ ə l i dː t ɑː
ܙܠܝܡܐ	z ə l iː m ɑː
ܡܦܩܢܐ	m a p q ɑː n ɑː
ܥܣܩܬܐ	s ɪ q θ a
ܥܪܝܘܢܐ	ʔ a r j oː n aː
ܐܬܐ	ʔ ɑː t eː
ܝܘܕܥܐ	j u d d ɑː ʔ ɑː
ܫܗܪܐ	ʃ a h r aː
ܨܠܘܢ	sˤ aː l o nː
ܡܐܟܢܐ	m ɑ ʔː k eː n ɑː
ܥܡܐ	ʔ a m m ɑː
ܗܡܙܡ	h a m z ɪ m
ܩܘܬܝܐ	q u t i jː j ɑː
ܡܝܪܩ	m a j r ɪ q
ܢܗܪܝܢ	n a h r iː n
ܓܘܢܐ	d͡ʒ o n ɑː
ܣܪܛܢܐ	s a r tˤ ɑː n ɑː
ܟܝܡܠܐܝܐ	k iː m ɑː l eː ʔ ɑː j ɑː
ܛܪܨ	tˤ ɑː r e sˤː
ܡܠܦܐ	m a l l ɑː p ɑː
ܒܟܬܐ	b a x t ɑː
ܐܘܬܝ	uː t iː
ܒܟܬܬܐ	b a x t ɑː t eː
ܚܘܘܬܐ	x u wː w ɑː θ eː
ܒܠܚܘܕ	b a l x o d
ܩܠܘܠܐ	q a l l uː l ɑː
ܥܕܝ	ʕ ɑː d iː
ܢܝܢܘܪܬܐ	n iː n ʊ rː t ɑː
ܩܒܘܪܐ	q v u r ɑ
ܡܫܟܢܬܐ	m a ʃ k a n t ɑː
ܓܫܪܐ	d͡ʒ ɪ ʃ r ɑː
ܚܠܐ	x aː l aː
ܐܫܒܛ	i ʃː v a tˤ
ܩܝܕܡܬܐ	q a d a m t a
ܫܡܐ	ʃ ɪ m m aː
ܩܝܘܡܐ	q aː j oː m aː
ܡܬܡܛܝܢܐ	m ɪ θ m a tˤ j ɑː n ɑː
ܦܘܟܪܐ	p u k r ɑː
ܡܪܣܝܠܝܐ	m ɑ rː s iː l iː j ɑː
ܓܫܩ	d͡ʒ a ʃ i q
ܚܡܪܐ	x a m m ɑː r ɑː
ܠܝܡܘܢܐ	l iː m oː n ɑː
ܚܝܐ	x a h eː
ܡܚܪܬܝܢ	m x ɑ rː θ e nː
ܡܟܫܟܫ	m k a ʃ k ɪ ʃ
ܡܡܛܝܢܐ	m a m tˤ j ɑː n ɑː
ܡܪܒܐ	m a r b eː
ܒܝܫܐ	b iː ʃ ɑː
ܡܚܘܝܢܝܬܐ	m ə x oː j ɑː n iː t ɑː
ܛܥܝܡܐ	tˤ a ʕ iː m ɑː
ܙܩܦ	z ɑː q ə p
ܢܝܫܐ	n iː ʃ ɑː
ܣܡܐ	s a m m aː
ܒܚܪܬܐ	b ə x a r t ɑː
ܣܡܝܬܐ	s m iː t ɑː
ܕܝܪ	d eː r
ܡܠܠ	m a l l ɪ l
ܡܓܘ	m ə ɡ oː
ܣܦܝܩܐ	s p iː q ɑː
ܡܫܡܥ	m a ʃ m e
ܥܬܩܐ	ʕ ɪ t q ɑː
ܬܙܘܬܐ	t aː z ʊː t a
ܡܐܕܢ	m a ʔ d ɪ n
ܚܒܘܫܐ	x a b uː ʃ ɑː
ܟܪܡܟ	k a r m ɪ x
ܫܥܝ	ʃ ɑː ʕ a j
ܚܫܘܒܬܐ	x ɑː ʃ o wː t ɑː
ܡܫܥܬ	m a ʃ ʕ ɪ θ
ܐܢܕܘܪܐ	ʔ a n d oː r ɑː
ܐܠܡܢܝܐ	ʔ a l m ɑː n i j ɑː
ܣܦܪܝܘܡܐ	s p a r ‿ j a w m ɑː
ܒܐܣ	b ɑː j ɪ sː
ܟܒܘܫܐ	k ɑː w oː ʃ ɑː
ܣܓܕ	s aː x ɪ ð
ܪܒܝ	r a b b iː
ܪܚܘܦܬܐ	r ɑː x o pː t ɑː
ܚܡܫ	x a m m ɪ ʃ
ܥܡܪ	ʔ ɑː m ɪ rː
ܠܘܒܐ	l e wː w eː
ܒܪܩ	b a r r ɪ q
ܬܓܠܝܬܐ	t a ɣ l iː t ɑː
ܝܘܪܟܐ	j u r x ɑː
ܙܘܠܐ	z uː l ɑː
ܡܣܩ	m a s s ɪ q
ܒܒܘܬܐ	b ɑː b uː t ɑː
ܓܙܪ	d ʒ ɑː z ɪ r
ܐܛܪܘܓܐ	tˤ r oː ɣ aː
ܫܬܩܕܝ	ʃ ɪ t q a j
ܐܘܛܘܒܘܣ	ʔ oː tˤ oː b u s
ܐܨܛܚܢ	ʔ ɪ sˤ tˤ a x ɪ n
ܟܘܬܩܐ	t͡ʃˤ o t q ɑː
ܡܦܩܬܐ	m a p p a q t ɑː
ܫܬܘܩ	ʃ t o q
ܣܘܕܝܐ	s w ɑː d ɑː j ɑː
ܐܠܝܩܛܪܘܢ	ʔ ɪ l i qː tˤ r o n
ܚܫܒ	x ɑː ʃ uː
ܟܠܐ	k ɑː l eː
ܥܬܝܕܐ	ʕ a t t iː d ɑː
ܡܘܢܟܘ	m oː n a k o
ܬܪܝܨܐ	t ə r iː sˤ ɑː
ܫܬܐܣܬܐ	ʃ a t ʔ t ɪ s t ɑː
ܥܝܕܐܝܬ	ʕ ə j ɑː d ɑː ʔ i θː
ܢܒܘ	n ɑː v oː
ܒܫܝܢܐ	b ʃ a j n ɑː
ܗܝܪܬܐ	h a y y a r t aː
ܝܠܕܬܐ	j ɑ l t ɑː
ܨܪܦܐ	sˤ a r r ɑː p ɑː
ܪܝܫܬܚܬܝܐ	r eː ʃ ɑː x t ɑː j ɑː
ܕܦܐ	d a p p ɑː
ܣܓܝ	s a ɡ ɡ iː
ܗܕܐ	h ɑː d eː
ܦܠܚܘܢܐ	p ɪ l x oː n a
ܡܠܒܫ	m a l b ɪ ʃ
ܣܪܐ	s a r r ɑ
ܩܨܒܐ	q a sˤ aː w a
ܒܪܐ	b r aː
ܕܕܒܐ	d ɪ d v aː
ܡܥܝܕ	m a ʕ j ɪ dː
ܡܣܓܕܐ	m a s ɡ d ɑː
ܐܕ	ʔ ɪ d
ܚܠܡ	x ɑː l e mː
ܪܩܕ	r aː q ɪ ð
ܦܐܪܐ	p a rˤ a
ܗܕܝܐܐ	h a d d iː ʔ ɑː
ܡܫܚ	m aː ʃ ə x
ܕܘܢܝܐ	d u n j eː
ܡܟܡܥܢܐ	m a t͡ʃ m i ʔ ɑː n ɑː
ܨܝܦܪܝܐ	sˤ iː p r ɑː j ɑː
ܡܢܫܐ	m a n ʃ eː
ܦܬܘܐ	p ɪ t w ɑː
ܦܘܚܐ	p a w x ɑː
ܦܩܕ	p a q q ɪ d
ܡܚܒܪܬܐ	m a x b a r t ɑː
ܕܪܓ	d a r r ɪ ɣ
ܓܘܝܐ	d͡ʒ ɑː w ɑː j ɑː
ܢܚܬ	n ɑː x e tː
ܐܚܪܐ	ʔ ɪ xː r eː
ܣܢܣܪܐ	s ɪ n s aː r a
ܛܘܢܕܪܐ	tˤ u n d r ɑː
ܪܕܝܬܐ	r a d d eː t ɑː
ܬܠܓܐ	t a l d͡ʒ ɑː
ܦܐܬܐ	p a ʔ θ ɑː
ܚܠܡܐ	x ɪ l m a
ܓܘܪܐ	d͡ʒ uː r ɑː
ܫܡܝܪܡ	ʃ a m m iː r ɑː m
ܟܦܦܬܐ	k ə p a p t ɑː
ܦܨܠ	p a sˤ sˤ ɪ l
ܒܝܪܐ	b iː r ɑː
ܟܟܐ	k a k k aː
ܗܠܡܘܢ	h a l m oː n
ܐܬܝܪ	ʔ ɑː t i rː
ܚܡܚܡ	x ɑː m e mː
ܛܐܦ	tˤ ɑː ʔ e pː
ܫܐܡ	ʃ ɑ mː
ܦܪܣܢܘܠܐ	p r ɑ sː n oː l ɑː
ܐܟܐ	ɑː x ɑː
ܚܪܒܐ	x a r b ɑː
ܚܡܢܐ	x ɪ m m aː n aː
ܟܘܣܐ	k oː s ɑː
ܛܫܐ	tˤ aː ʃ eː
ܛܒܠܝܬܐ	tˤ a v l iː t ɑː
ܗܘܦܟܐ	h u p p ɑː x ɑː
ܝܡܢ	j a m a n
ܝܢ	j a n
ܓܘܪܒܐ	d͡ʒ u r v aː
ܦܪܥ	p ɑ r eː
ܙܘܠܩܠܐ	z u l x ɪ z w ɑː
ܚܝܘܬܐ	x a j j uː t ɑː
ܠܟܣ	ə l k ɪ s
ܗܝܓܗ	h iː ɡ ɑ hː
ܐܢܢܩܝܐ	ɑː n a n q ɑː j ɑː
ܬܒܥ	t ɑː v eː
ܝܥܢܐ	j a n eː
ܡܨܪܝܢ	m i sˤ r e nː
ܡܢܘ	m eː n uː
ܫܒܬܐ	ʃ a b t ɑː
ܡܥܙܬܐ	m ɪ z z eː t aː
ܒܘܪܡܐ	b u r m aː
ܩܐܚ	q aː j ɪ ħ
ܚܘܡܫܐ	x u m ʃ ɑː
ܬܡܣܝܚܐ	t a m s iː x ɑː
ܒܘܩܠܪܝܐ	b u q l ɑː r iː j ɑː
ܩܘܢܕܝܢܘܣܝܐ	q eː w a n d eː n o s ɑː j ɑː
ܦܫܝܩܐ	p ə ʃ iː q ɑː
ܣܦܢ	s ɑː p e nː
ܡܬܡܨܝܢܐ	m ɪ t m a sˤ j ɑː n ɑː
ܦܠܡ	p aː l eː m
ܪܝܚܐ	r eː x a
ܣܢܛܝܡܝܛܪܐ	s e nː tˤ iː m iː tˤ r ɑː
ܙܡܒܝܐ	z a m b ə j ɑː
ܠܡܐ	l e m ɑː
ܦܘܠܘܢܝܐ	p oː l oː n i j ɑː
ܡܦܫܪ	m a p ʃ ɪ r
ܫܘܩܐ	ʃ uː q ɑː
ܐܢܩܪܐ	a n q ɑː r ɑː
ܛܒ	tˤ oː
ܓܝܓ	d͡ʒ aː j e ɡ
ܕܠܠ	d a l l ɪ l
ܡܗܝܪ	m ə h ɑ j ɪ r
ܚܠܒܐ	x a l w ɑː
ܡܓܒܐ	d͡ʒ a b b eː
ܡܫܠܝܐ	m a ʃ ʃ l j ɑː
ܘܠܝܙܝܐ	w ɑː l i z ɑː j ɑː
ܐܪܫܟܝܬܐ	ʔ ɑː r ɪ ʃ x ɑ jː t ɑː
ܬܠܬܥܣܪ	t ɪ l t a ʕ s a r
ܠܚܝܦܐ	l ɪ x ɑ jː p ɑː
ܣܠܛܐ	s a l l ɑː tˤ ɑː
ܡܘܠܕܘܒܐ	m o l d oː v aː
ܣܢܝܩܘܬܐ	s ə n iː q uː θ ɑː
ܣܝܡ	s ɑː j e mː
ܡܫܬܬܝܢܐ	m ɪ ʃ t a t j ɑː n ɑː
ܩܘܪܒܐ	q u r b ɑː
ܪܡܩܠܐ	r a m q ɑː l ɑ
ܪܐܡ	j aː rˤ ɪ m
ܬܝܡ	t ɑː j e mː
ܬܠܬܝܢ	t l ɑː θ i nː
ܙܪܕܘܫܬܝܐ	z a r d u ʃ t ɑː j ɑː
ܣܡܠܬܐ	s ɪ m m a l t aː
ܐܝܣܚܩ	i s x ɑ q
ܬܠܒܫܬܐ	t a l w ɪ ʃ t ɑː
ܒܘܬ	b u t
ܣܚܝܢܐ	s ɑː x j ɑː n ɑː
ܦܪܫ	p ɑː r e ʃː
ܦܠܘܛܘܢ	p l ʊː tˤ o n
ܡܠܝܪܕ	m i l j ɑː r
ܒܒܐ	b ɑː b ɑː
ܟܘܬܐ	k oː t ɑː
ܚܙܩܝܐܝܠ	ħ a z q iː ʔ eː l
ܡܚܠܦܐ	m a x l ə p ɑː
ܨܟܐ	sˤ a k k ɑː
ܟܬܒ	k ɑː θ e vː
ܐܪܟܝܐ	a r k ɑː j ɑː
ܩܪܬܐ	q a r t ɑː
ܒܓܪ	b ɑː d͡ʒ ɪ rː
ܡܒܩܠܐ	m a w q ə l ɑː
ܫܝܫܠܬܐ	ʃ ɪ ʃ ɪ l t ɑː
ܝܪܕܐ	j a r d ɑː
ܚܡܫܡܐܐ	x a m ʃ a m ə ʔ ɑː
ܚܕ	x a
ܢܘܩܙܐ	n u q z ɑː
ܡܫܘܬܒ	m ə ʃ ɑ w t ɪ w
ܗܘܢܢ	h a w n ɪ n
ܦܪܨܘܦܐܝܬ	p a r sˤ oː p ɑː ʔ iː t
ܐܡܦܪܛܘܪܘܬܐ	ʔ ɪ m p r ɑː tˤ oː r uː t ɑː
ܥܠܡ	ʔ ɑː l a m
ܫܚܝܢܐ	ʃ a x iː n a
ܦܟܐ	p aː x aː
ܬܪܘܨܐ	t r uː sˤ ɑː
ܪܘܦܫܐ	r o f ʃ aː
ܡܛܒܥܬܐ	m a tˤ w a ʕ t ɑː
ܚܨܕ	ħ aː sˤ eː ð
ܐܨܠܐ	ʔ a sˤ l ɑː
ܒܪܕܐ	b a r ə d ɑː
ܡܦܩܐ	m a p q ɑː
ܠܘܩܐ	l uː q a
ܬܡܪܐ	t a m r ɑː
ܐܬܘܬܐ	ʔ aː t uː t aː
ܡܩܪ	m a q q ɪ r
ܡܙܕܒܢܢܐ	m ɪ z d a b n ɑː n ɑː
ܬܫܕ	t͡ʃ ɑ ðː
ܨܐܕ	sˤ ɑː j e ðː
ܡܦܪܡܐ	m ə p a r m eː
ܡܩܕܘܢܝܐ	m ɑː q eː d o n iː j ɑː
ܚܙܝܢܐ	x a z y ɑː n ɑː
ܣܘܡܣܡܐ	s u m s ɑː m ɑː
ܙܡܝܢܐ	z ə m iː n ɑː
ܙܩܪ	z ɑː q e rː
ܚܘܪ	x w ɑ rː
ܙܘܠܒܢܐ	z u l b ɑː n ɑː
ܣܡܩ	s ɑː m e qː
ܨܝܕܠܝܐ	sˤ a j d a l l iː j ɑː
ܥܡܡܝܐ	ʕ a m ə m ɑː j ɑː
ܫܠܝܡܐ	ʃ ə l iː m ɑː
ܡܪܟܘܝܐ	m ɑː r a k uː j ɑː
ܠܢ	l e n
ܐܢܬܝ	ʔ a t
ܦܝܫܐ	p a j j aː ʃ aː
ܕܘܝܕ	d ɑ w i d
ܚܡܛܐ	x m ɑː tˤ ɑː
ܡܚܘܪܢܐ	m a x oː r aː n a
ܥܠܠ	ʕ ɑː l e lː
ܓܪܓܫ	d͡ʒ a r d͡ʒ ɪ ʃ
ܐܟܘܡܝܐ	k oː m ɑː j ɑː
ܡܬܡܛܝܢܘܬܐ	m ɪ θ m a tˤ j ɑː n uː θ ɑː
ܟܕܒܐ	k a d d ɑː w ɑː
ܫܥܬܐ	ʃ eː θ ɑː
ܩܘܦܪܝܐ	q ɪ w p r ɑː j ɑː
ܕܐܢܝ	d ə ʔ ɑː n iː
ܒܠܪܘܣܝܐ	b eː l ɑː r uː s i j ɑː
ܫܘܝܐ	ʃ a w j ɑː
ܢܡܛܐ	n a m tˤ ɑː
ܩܪܘܪܐ	q ɑː r uː r ɑː
ܠܒܬܪܐ	l a b ɑː r ɑː
ܬܠܬܥܣܪܐ	t ə l aː θ a ʕ ɪ s r eː
ܥܣܪܝܢ	ʔ ɪ s r iː
ܡܥܒܕ	m a ʕ w ɪ d
ܫܘܥܝܬܐ	ʃ oː ʕ iː θ ɑː
ܡܐܣܐ	m ə ʔ a s s eː
ܬܡܠ	t ɪ m m aː l
ܦܦܐ	p a p p a
ܥܙܝܙܐ	ʔ a z iː z ɑː
ܡܣܚܒܪ	s a x b ɪ r
ܡܪܘܚ	m a r w ɪ x
ܐܚܬܘܢ	ʔ a x t o nː
ܝܘܬܝ	ʔ iː w ɑ tː
ܫܡܘܥܬܐ	ʃ ɑː m o ʕː t ɑː
ܩܛܠ	q aː tˤ ə l
ܦܢܓܢܐ	f i n d͡ʒ ɑː n ɑː
ܠܩܘܪܒܐ	l ə q u r b ɑː
ܐܢܕܘܢܣܝܐ	ʔ ɪ n d oː n eː s i j ɑː
ܡܚܪܘܬܐ	m a x x ɑː r ɑː
ܐܝܬ	ʔ i θː
ܟܘܬܪܐ	k u t t ɑː r ɑː
ܗܓܐ	h ɑː d͡ʒ eː
ܡܟܣܝܩܘ	m e k s i k oː
ܡܣܬܥܪܢܘܬܐ	m ɪ s t a ʕ r ɑː n uː θ ɑː
ܦܠܚ	p aː l e xː
ܚܘܪܬܐ	x w a r t ɑː
ܓܒܐ	d͡ʒ a b b ɑː
ܝܘܦܩܐ	j u p q ɑː
ܡܛܪܐ	m ɪ tˤ r ɑː
ܐܝܠܢܐ	ʔ iː l ɑː n ɑː
ܐܕܠܝܠܐ	i d l a y l eː
ܡܫܝܚܝܐ	m ʃ iː ħ aː y aː
ܡܫܠܡܢܐ	m a ʃ l ə m ɑː n ɑː
ܢܛܪ	n ɑː tˤ eː r
ܚܠܝܘܬܐ	x ɪ l j uː t ɑː
ܣܝܫܠܝܣ	s eː ʃ e l l iː s
ܡܨܢܥܐ	m ə sˤ a n ʕ ɑː
ܒܝܬܐ	b a j t aː
ܡܗܘܐ	m a h w eː
ܐܘܪܫܠܡܝܐ	oː r ɪ ʃ l m ɑː j ɑː
ܒܠܝ	b ə l a j
ܬܫܥܬ	t ɪ ʃ ʕ ɑ θː
ܩܘܕܡܐ	q u d m eː
ܥܒܝܐ	ʕ a w j ɑː
ܥܠܝܐ	ʕ l aː j a
ܥܠܡܠܬܐ	ʕ a l m ɪ l t ɑː
ܓܪܡܦܝܠܐ	ɡ r ɪ m p iː l ɑː
ܟܘܙܐ	k uː z ɑː
ܢܩܘܠܬܐ	n ɑː q o lː t ɑː
ܛܗܪܐ	tˤ a h r ɑː
ܚܒܪ	x ə w a r
ܓܪܘܪܐ	d͡ʒ a r uː r ɑː
ܬܪܓܡܢܬܐ	t a r d͡ʒ m ɑ n t ɑː
ܣܘܝܕ	s w a j ð
ܬܠܝܬܝ	t l iː t ɑ jː
ܩܘܪܨܐ	q u r sˤ ɑː
ܢܣܘܟܬܐ	n ɑː s o xː t ɑː
ܛܠܩ	tˤ ɑ l l ɪ qː
ܥܝܪܩ	ʔ i r ɑː q
ܡܬܢܬܢ	m ə t a n t ɪ n
ܥܣܪܝܢܝܐ	ʕ ɪ s r iː n ɑː j ɑː
ܡܓܚܟ	m a d͡ʒ x ɪ t͡ʃ
ܥܒܪ	ʔ ɑː v ɑ rː
ܝܗܝܒܬܐ	h iː w ɑː t eː
ܨܝܢܐ	sˤ iː n ɑː
ܒܗܦܟܐ	b ə h ɪ p k ɑː
ܙܓܝܪܐ	z ə ɣ iː r ɑː
ܩܒܪ	q ɑː v ə r
ܦܪܒܠܐ	f r ɑ wː l ɑː
ܚܕܢܝܐ	x ə ð ɑː n ɑː j ɑː
ܢܪܓܝܠܐ	n a r d͡ʒ iː l ɑː
ܡܝܠܛܐ	m iː l eː tˤ eː
ܐܠܦܝܐ	ʔ a l p a j j eː
ܣܒܪܐ	s a v r ɑː
ܩܒܘܬܐ	q eː w oː t ɑː
ܘܪܕܐ	v a r d ɑː
ܬܝܡܢܝܐ	t a j m ə n ɑː j ɑː
ܡܢܕܝ	m i n d iː
ܦܝܠܐ	p iː j ɑː l ɑː
ܚܡܝܢܐ	x ɪ m j ɑː n ɑː
ܟܟܚܐ	k ə t͡ʃ ɑː x ɑː
ܐܢ	i n
ܟܝܣܬܐ	k i sː t ɑː
ܝܩܕ	j ɑː q e dː
ܐܫܛܪܐ	ʔ ɪ ʃ tˤ ɑː r ɑː
ܡܥܝܪ	m a ʕ j ɪ r
ܬܡܢ	t a m m ɑ nː
ܗܕܟܐ	h a d x ɑː
ܐܠܝܫܒܥ	eː l i ʃː w a ʕ
ܐܪܝܐ	ʔ a r j ɑː
ܡܠܟܐ	m a l k ɑː
ܡܕܥܪ	m a d ɪ r
ܡܬܪܓܡܢܐ	m ə t a r ɡ ə m ɑː n ɑː
ܐܣܐ	ʔ ɑː s eː
ܐܘܢܓܕܐ	ʔ uː ɡ a n d aː
ܚܘܪܕܐ	x u r d ɑː
ܚܠܨ	x a l a sˤ
ܨܠܝܒܐ	sˤ l iː v ɑː
ܟܟܪܐ	k a k k ə r ɑː
ܫܘܚܬܐ	ʃ u x t a
ܥܓܒ	ʔ ɑ d͡ʒ i b
ܥܒܕ	ʔ aː v ɪ d
ܐܕܫܢܬ	ʔ a ʃ ʃ a t
ܢܟܦ	n ɑː x e p
ܣܚܐ	s ɑː x eː
ܛܪܦܐ	tˤ a r p aː
ܥܣܪܬ	ʕ a s r a t
ܠܓܐ	l i d͡ʒ d͡ʒ ɑː
ܡܟܡܥ	m a t s m e
ܡܬܬܒܪܢܐ	m ɪ t t a w r ɑː n ɑː
ܛܒܘܥܬܐ	tˤ ɑː v o ʔː t ɑː
ܨܪܘܐ	sˤ a r w ɑː
ܝܐܒ	j ɑː ʔ e wː
ܓܪܒܝܝܐ	ɡ a r b ə j ɑː j ɑː
ܫܠܝܨܐ	ʃ l iː sˤ aː
ܡܝܩܪܬܐ	m j a q q a r t aː
ܒܪܟܟܐ	b ɪ r k ɑː k eː
ܕܟܐ	d ɑː x eː
ܐܡܙܝܓܝܐ	ʔ a m ɑː z iː ɣ ɑː j ɑː
ܠܓܘܐ	l ə ɡ ɑː w ɑː
ܡܛܘܐ	m tˤ a w w eː
ܪܚܘܩܐ	r a ħ uː q a
ܕܪܬܐ	d a r t a
ܕܟܢܐ	d i k k ɑː n ɑː
ܗܠܝܘܢ	h i l j o nː
ܬܪܝܢܝܬܐ	t r a j j ɑː n iː θ ɑː
ܢܓܪܐ	n a ɡ ɡ aː r aː
ܦܪܝܣ	p ɑː r i sː
ܡܙܡܙܡ	m ə z a m z ɪ m
ܝܘܪܕܢܝܐ	j o r ə d n ɑː j ɑː
ܟܘܫ	k u ʃː
ܦܟܣܛܢ	p ɑː k ə s tˤ ɑː n
ܙܝܥܐ	z a y ʕ aː
ܦܘܪܬܘܓܠ	p o r t u ɡ aː l
ܬܢܘܪܐ	t a n n uː r aː
ܝܐ	j aː
ܘܠܝܝܐ	w ɑː l ə j ɑː j ɑː
ܐܘܙܒܟܣܛܢ	ʔ u z b a k k ɪ s tˤ ɑː n
ܣܗܕܐ	s ɑː h ə d ɑː
ܡܕܢܚܐ	m a d ə n x ɑː
ܬܐܝ	t ɑː
ܩܪܝܒܬܐ	q a r i vː t ɑː
ܫܪܫܝܐ	ʃ ɪ r ʃ ɑː j ɑː
ܡܥܒܪܢܝܬܐ	m a b eː r a n iː θ a
ܡܦܬܚܐ	m a p t ɑː x ɑː
ܕܡܐ	d aː m eː
ܢܘܛܦܬܐ	n u tˤ tˤ a p t aː
ܨܨܪܐ	sˤ ɪ sˤ r aː
ܒܝܬ	b e θː
ܡܝܟܐܝܠ	m iː x ɑː j e lː
ܣܓܠ	s a d͡ʒ d͡ʒ ɪ l
ܬܘܕܝܬܢܐܝܬ	t a w d iː t ɑː n ɑː ʔ iː t
ܣܘܣܝܬܐ	s u s y ɑː t e
ܡܬܒ	m a t t e
ܐܫܘܪܐܝܬ	ʔ ɑː ʃ oː r ɑː ʔ iː θ
ܬܠܓ	t ɑː l e ɣː
ܡܩܪܢܐ	m a q q ə r ɑː n ɑː
ܡܫܥܡܪ	m ə ʃ a ʕ m ɪ r
ܐܘܪܫܠܡ	oː r ɪ ʃ l ə m
ܩܪܡ	q ɑː r e mː
ܠܘܣܬܐ	l u s t ɑː
ܨܡܕ	s a m m ɪ d
ܒܒܠ	b ɑː v i l
ܝܬܝܪܐ	j a t t iː r ɑː
ܢܦܚ	n ɑː p e xː
ܓܪܘܪܬܐ	d͡ʒ ɑː r o rː t ɑː
ܨܒܥ	sˤ a b b ɑ ʕː
ܟܫܡܐ	t͡ʃ a t͡ʃ m ɑː
ܡܘܬܢܐ	m a w t aː n aː
ܫܟܢ	ʃ ɑː x e nː
ܗܘܬ	w ɑ θː
ܪܡܐ	r ɑː m eː
ܚܙܩ	x ɑː z e qː
ܒܘܠܓܪܝܐ	b u l ɡ ɑː r iː j ɑː
ܥܐ	ʔ eː
ܡܩܫܐ	m a q ʃ eː
ܓܕܠ	ɡ aː ð ɪ l
ܬܪܢܓܠܐ	t a r n uː l ɑː
ܬܪܝܡܐܐ	t r a j m ə ʔ ɑː
ܡܢܦܠ	m a n p ɪ l
ܩܛܘ	q ɑː tˤ oː
ܡܡܣܝܢܝܬܐ	m ə m a s j ɑː n iː t ɑː
ܫܚܘܡܐ	ʃ ə x oː m ɑː
ܡܚܬܐ	m a x t eː
ܡܠܗܒ	m a l h eː
ܢܫܩ	n ɑː ʃ ə q
ܚܬܡ	x aː t e mː
ܚܡܫܥܣܪܐ	x a m ʃ a ʕ ɪ s r eː
ܬܚܪܙܬܐ	t a x r ɪ z t ɑː
ܠ	l
ܐܣܪܐ	ʔ a s ɑː r ɑː
ܐܢܓܠܝܣܝܐ	ʔ ɪ ŋ ɡ l iː s ɑː j ɑː
ܚܫܝܫܐ	x a ʃ ʃ iː ʃ ɑː
ܦܬܩܐ	p ɪ θ q ɑː
ܝܪܩܢܐ	j a r q ɑː n ɑː
ܡܢܝܐ	m a n n ɑː j ɑː
ܫܟܠܐ	ʃ ɪ k l ɑː
ܥܠܝܡܐ	ʔ a l eː m ɑː
ܒܬܪ	b a r
ܬܚܫܒܬܐ	t a x ʃ a w t ɑː
ܣܘܝܕܝܐ	s w a j ð ɑː j ɑː
ܩܕܡܝܬܐ	q a m eː θ a
ܢܣܘܟܐ	n ɑː s oː x ɑː
ܐܫ	ʔ ɪ ʃ
ܡܚܬܬ	m a x t ɪ θː
ܡܘܛܝܐ	m u tˤ tˤ ɑː j ɑː
ܫܐܕܢܐ	ʃ eː ʔ ð ɑː n ɑː
ܙܪܝܒܬܐ	z ɑː r i vː t ɑː
ܒܪܟ	b a r r ɪ x
ܡܚܘܪ	m a x w ɪ r
ܗܝܟܠܐ	h a j k ə l aː
ܗܡܙܡܢ	h eː m ɪ z m ɑ nː
ܫܟܝܪܐ	ʃ k iː r ɑː
ܘܙܘܙ	w a z w ɪ z
ܕܩܝܩܐ	d a q q iː q ɑː
ܟܐܠ	k ɑː ʔ e lː
ܡܪܝܥܐ	m r i ʔ ɑː
ܣܚܪܐ	s a ħ ħ ɑː r ɑː
ܡܦܬܐ	m a p t eː
ܫܒܒܘܬܐ	ʃ ə w ɑː w uː t ɑː
ܐܫܬ	ɪ ʃ ɪ t
ܣܘܕܢ	s uː d ɑ nː
ܓܝܓܠܐ	ɡ i ɣː l ɑː
ܓܘܕܐ	d͡ʒ uː d a
ܗܝܟܕܗܝܝܐ	h iː x a d h iː j ɑː j ɑː
ܝܪܝܟܐ	j a r r iː x ɑː
ܐܡܝܢܐ	ʔ a m m iː n ɑː
ܒܪܚܡܐ	b ə r a x m eː
ܡܪܝ	m a r
ܒܘܣܐ	b oː s ɑː
ܟܒܫ	k ɑː w e ʃː
ܚܘܠܦܐ	x u l l ɑː p ɑː
ܦܪܫܝܬܐ	p r ɑ ʃː j ɑː t e
ܥܡܥܡ	ʕ a m ʕ a m
ܡܚܢܐ	m a x n eː
ܦܪܩ	p a r r i q
ܡܣܙܓܪ	m ə s a z ɡ ɪ r
ܡܗܡܐ	m a h m eː
ܨܘܪܬܐ	sˤ a r t a
ܡܪܓܫ	m a r ɣ ɪ ʃ
ܟܘܪ	t͡ʃˤ aː w ɪ r
ܡܝܠܐ	m iː l aː
ܠܙܡ	l ɑː z ɪ m
ܬܫܝܥܝܐ	t͡ʃ iː ʕ ɑː j ɑː
ܦܠܢܛܐ	p l a n n eː tˤ ɑː
ܐܣܝܪܐ	s iː r ɑː
ܢܬܐ	n ä tʰ e
ܙܕܥ	z ɑ dː d e ʔː
ܫܡܗ	ʃ a m m ɪ h
ܫܘܕ	ʃ u d
ܣܝܡܐ	s iː m ɑː
ܐܝܪܠܢܕܝܐ	ʔ a j r l a n d ɑː j ɑː
ܐܘܪܕܥܐ	ʔ u r d ə ʕ ɑː
ܒܪܛܠܐ	b a r tˤ ɪ l l aː
ܩܕܝܠܐ	q ə d iː l ɑː
ܪܬܚ	r aː t ɪ x
ܪܓܫ	r ɑː ɣ e ʃː
ܡܗܠܟ	h a l l ɪ x
ܨܪܚ	sˤ aː r e xː
ܒܪܝܐ	b a r r iː j ɑː
ܢܨܪܬ	n ɑ sˤː r a t
ܐܡܪܐ	ʔ a m rˤ ɑː
ܥܝܕܐ	ʕ ə j ɑː d ɑː
ܚܙܐ	x aː z eː
ܨܘܐ	sˤ ɑː w eː
ܛܡܐܐ	tˤ a m ʔ ɑː
ܡܝܐ	m a j j ɑː
ܛܠܥ	tˤ aː l ɪ ʕ
ܐܫܬܥܣܪܐ	i ʃ t a ʕ ɪ s r eː
ܣܘܪܝܐ	s uː r iː j ɑː
ܩܒܠ	q a b b ɪ l
ܢܩܘܪܬܐ	n i q u r t ɑː
ܣܘܣܬܐ	s u s t ɑː
ܩܢܝܐ	q a n j ɑː
ܐܕܝܐ	h a d d iː j ɑː
ܩܛܝܢܐ	q a tˤ tˤ iː n ɑː
ܒܠܥ	b ɑː l e ʕː
ܥܝܢܐ	ʔ a j n ɑː
ܬܥܣ	t aˤ i s
ܬܪܐ	t ɑː r eː
ܝܬܒ	j a t i v
ܦܠܓܝܐ	p a l ɡ aː j aː
ܢܥܝܡܐ	n a ʕ iː m ɑː
ܪܚܡ	r ɑː x e mː
ܦܚܠܬܐ	p a x a l t ɑː
ܕܫܡܢ	d ɪ ʒ m ɪ n
ܡܬܚܙܝܢܐ	m i t x a z y ɑː n ɑː
ܥܬܩ	ʔ ɑː t ə q
ܣܡܠܝܐ	s i m m ɑː l ɑː j ɑː
ܡܨܢܨܠ	m sˤ a n sˤ ɪ l
ܬܐ	t ɑː
ܚܐܪܬܐ	x i rː t ɑː
ܦܪܝܕ	f a r i dː
ܕܘܫ	d u ʃː
ܡܠܬܐ	m ɪ l t ɑː
ܟܟܚ	k ɑː t͡ʃ e xː
ܐܪܒܥܬ	ʔ a r b ə ʕ a θː
ܬܐܓܘܪܬܢܝܐ	t e ʔ ɣ u r t ɑː n ɑː j ɑː
ܛܐܠܢܬܐ	tˤ a l ɑː n θ ɑː
ܦܠܦܠܐ	p ɪ l p ə l ɑː
ܢܥܡܐ	n a ʕ m eː
ܚܘܫܒܢܐ	x u ʃ b ɑː n ɑː
ܩܪܝܒܐ	q a r iː v ɑː
ܢܣܟ	n ɑː s e xː
ܢܫܝܢܐ	n ɪ ʃ j ɑː n ɑː
ܓܘܠܦܐ	d͡ʒ u l p ɑː
ܪܚܛ	r ɑː x ə tˤ
ܝܐܝܒܐ	j a ʔ iː w ɑː
ܡܐܐ	m ə ʔ ɑː
ܡܟܬܒܐ	m a x t w ɑː
ܬܝܡܘܢ	t eː m u nː
ܫܥܘܬܐ	ʃ a ʔ uː θ aː
ܗܪܟܐ	h ɑ rː k ɑː
ܬܪܝܨ	t r iː sˤ
ܡܚܪܛܐ	m ə x a r tˤ ɑː
ܫܩܩܐ	ʃ q ɑː q ɑː
ܡܫܒܠܢܐ	m ə ʃ a b l ɑː n ɑː
ܕܘܣܬ	d o s tː
ܡܪܚܡ	m rˤ aː x ɪ m
ܡܪܟܫ	m a r r ɑː k ɪ ʃ
ܥܪܒܐܝܬ	ʔ a r a b ɪ tː
ܡܚܘܣܝܐ	m ħ u s s y aː
ܒܟܝܪܐܝܬ	b ə x iː r ɑː ʔ iː t
ܟܢܫ	k a n n ɪ ʃ
ܩܘܦܐ	q oː p ɑː
ܣܢܛ	s eː n tˤ ə
ܪܐܚ	r aː ʔ e xː
ܒܚܘܒܘܟ	b ə x u b b u xː
ܡܟܠܟܠ	m ə k a l k ɪ l
ܓܘܢܐܝܬ	ɡ ɑː w ɑː n ɑː ʔ i θː
ܢܪܒܝܓ	n a r w e ɡː
ܣܓܝܐܢܝܐ	s a ɡ ɡ iː ʔ ɑː n ɑː j ɑː
ܢܘܗܕܪܐ	n uː h a d r ɑː
ܠܬܒܝܐ	l a t v iː j ɑː
ܦܘܨܐ	p uː sˤ ɑː
ܒܠܐ	b aː l aː
ܣܟܪ	s ɑː x e rː
ܫܬܐ	ʃ oː t eː
ܒܝܥܬܐ	b eː t ɑː
ܐܪܒܥܣܪ	a r b a ʕ s a r
ܚܕܪܘܢ	ħ aː ð ɪ r w aː n
ܡܬܚܡܐܝܬ	m ə t a x m ɑː ʔ i θː
ܦܠܓ	p ɑː l e ɣː
ܩܢܝܢܬܐ	q a n i nː t ɑː
ܓܠܝܕܐ	d͡ʒ l iː d ɑː
ܐܪܡܘܢܬܐ	a r m oː n t ɑː
ܗܟ	h i t͡ʃ
ܬܫܥܝܬܐ	t a ʃ ʕ iː t ɑː
ܒܒܥܘ	b ə w ɑː ʕ uː
ܡܫܘܬܦܐ	m ə ʃ ɑ w t ə p ɑː
ܡܒܠܒܠܐ	m ə b a l b ə l ɑː
ܐܢܝ	ʔ a n n e
ܢܐܦܘܠܝܣ	n e ʔ ɑː p oː l i sː
ܪܨܦ	r ɑː sˤ e pː
ܦܪܣܡܠܠܐ	p r ɑ sː m a l l ɑː l ɑ
ܣܬܪܐ	s ɪ t r ɑː
ܟܘܫܝܐ	k u ʃ ɑː j ɑː
ܚܡܪ	x ɑː m ə r
ܐܡܗܪܐܝܬ	ʔ a m h ɑː r ɑ ʔ iː θ
ܓܢܗܐ	d͡ʒ ə n a j ɑː
ܝܢܐ	ʔ iː n ɑ
ܢܘܓܗܐ	n u ɣ h ɑː
ܙܘܝܬܐ	z ɑː w iː t ɑː
ܡܒܗܘܬܐ	m a b h uː t ɑ
ܡܕܝܢܐ	m ə ð iː n aː
ܡܢܕܪܝܫ	m i d r e ʃː
ܙܪܕܐ	z a r d e
ܥܒܕܐ	v ɑː d ɑː
ܢܒܘܟܕܢܨܪ	n ɑː w u x a d n ɑː sˤ a r
ܫܪܝܪܐ	ʃ a r iː r ɑː
ܨܠܡܐ	sˤ a l m aː
ܕܥܪ	d a ʔ ɪ r
ܓܡܠܐ	ɡ a m l ɑː
ܫܠܡܢܥܣܪ	ʃ a l m ɑː n ɪ s s a r
ܗܢܕܘܝܐ	h ɪ n d u wː ɑː j ɑː
ܡܪܓܙ	m a r ɡ ɪ z
ܝܘܢܝܐ	j oː n iː j ɑː
ܬܪܓܡܢܝܬܐ	t a r d͡ʒ m a n j ɑː t e
ܚܪܫܐ	x a r r ɑː ʃ ɑː
ܚܬܢܐ	x i t n ɑː
ܚܝܙܐ	x iː z ɑː
ܐܢܫܝܐ	n ɑː ʃ ɑː j ɑː
ܕܝܗ	d iː j e hː
ܓܢܨ	ɡ aː n ɪ sˤ
ܟܠܒܐ	k a l b ɑː
ܐܝܡܡܐ	iː m ɑː m ɑː
ܡܥܘܕܠܐ	m uː d ɑː l eː
ܡܟܘܝܢܝܬܐ	m ə x oː j ɑː n iː t ɑː
ܦܣܘܥܬܐ	p a s oː t a
ܗܝ	a j aː
ܦܩܘܚܐ	p a q q uː x ɑː
ܡܕܝܢܝܐ	m ə d iː n ɑː j ɑː
ܠܝܬܘܢܝܐ	l i θː w ɑː n iː j ɑː
ܝܕܥܐ	j a d d ɑː
ܬܘܕܝܬܐ	t a w d iː θ ɑː
ܣܒܝܗܐ	s w iː h ɑː
ܙܪܓܬܐ	z ɑː r i d͡ʒ t ɑː
ܥܪܐ	ʕ a r r ɑː
ܡܕܝܢ	m a d j ɪ n
ܕܪܡܣܘܩܝܐ	d a r ə m s oː q ɑː j ɑː
ܚܘܘܐ	x u wː w eː
ܟܝܒܘ	t͡ʃ eː b uː
ܝܗܒܐܠܗܐ	j a v a l aː h aː
ܦܫܩ	p a ʃ ʃ ɪ q
ܡܣܩܕ	m ɑ s q ə d
ܡܚܕܐ	m a x d eː
ܡܩܛܠ	m a q tˤ ɪ l
ܒܪܒܪܐ	b a r b aː r aː
ܝܘܐܒܐ	j u ʔ ɑː w ɑː
ܡܫܟܝܚܐ	m t͡ʃ iː x ɑː
ܐܝܣܪܐܝܠ	i sː r ɑː j e lː
ܡܢܓܘ	m a n ɡ o
ܡܬܦܢܟܢܐ	m ə t a p n ə x ɑː n ɑː
ܐܢܬܬܐ	ʔ a t t ɑː
ܥܘܡܢ	ʕ u m ɑ nː
ܩܛܪܐ	q tˤ ɑː ɾ ɑː
ܝܗܒܠ	j aː v e lː
ܚܠܩ	x ɑː l e qː
ܢܒܓܬܐ	n o ɡː t ɑː
ܟܬܒܐ	k a t t ɑː w ɑː
ܦܚܡܐ	p a x m ɑː
ܣܒܣ	s a b b ɪ s
ܡܙܥܪܐ	m ə z a ʕ r ɑː
ܒܠܓܝܩܝܐ	b e l d͡ʒ iː q ɑː j ɑː
ܡܥܒܪܢܐ	m a b eː r aː n a
ܒܘܩܬܐ	b u q t ɑː
ܫܥܠ	ʃ a ʔ ɪ l
ܫܚܢ	ʃ ɑː x e nː
ܚܙܝܪܢ	x z iː r aː n
ܣܡܠܐܝܬ	s i m m ɑː l ɑː ʔ i θː
ܗܕܪܘܓܝܢ	h eː d r oː j i nː
ܒܝܪܘܬ	b eː r ʊ t
ܗܢܕܘ	h ɪ n d uː
ܦܝܫ	p iː ʃ
ܙܘܓܐ	z oː d͡ʒ ɑː
ܡܨܐ	m aː sˤ eː
ܩܪܢܐ	q a n a
ܡܘܥܕܐ	m ɑ w ʕ d aː
ܠܩܢܐ	l a q n ɑː
ܫܠܚ	ʃ a l l ɪ x
ܓܒܪܝܠ	ɡ o r iː y e lː
ܥܪܒܝܐ	ʔ a r a b ɑː j ɑː
ܐܪܥܐ	ʔ a r a
ܥܡܐܢ	ʕ a m m ɑ nː
ܡܪܘܚܬܐ	m a r w a x t ɑː
ܟܘܢܓܘ	k o ŋː ɡ oː
ܒܘܬܨܘܢܐ	b oː t sˤ w ɑː n ɑː
ܐܟܡ	ʔ ɑː k e mː
ܡܘܕܟܐ	m u d d ɑː x ɑː
ܪܛܝܒܐ	r a tˤ tˤ iː w ɑː
ܙܠܓܐ	z ɪ l ɣ ɑː
ܥܩܪܒܐ	ʕ a q q ɪ r w aː
ܡܒܙܒܙ	m ə b a z b ɪ z
ܩܪܡܟ	m q a r m ɪ tˤ
ܛܐܠ	tˤ ɑː w e lː
ܟܐܝ	t͡ʃ aː j
ܨܘܕܪܐ	sˤ u d r ɑː
ܐܘܪ	o r
ܬܦܬܦ	t a p t ɪ p
ܦܪܕܐ	p a r d ɑː
ܡܪܡ	m a r r ɪ m
ܓܘ	d͡ʒ uː
ܬܫܠܝܬܐ	t a ʃ l iː θ ɑː
ܥܘܩ	ʕ a w w ɪ q
ܩܘܦ	q a w w ɪ p
ܚܫܐ	x a ʃ ʃ ɑː
ܦܪܠܡܢ	p a r l ɑː m ɑ nː
ܐܟܘܡܐ	k oː m aː
ܡܛܥܡܬܐ	m a tˤ ɪ m t aː
ܐܝܟܐ	ʔ a j k aː
ܨܕܪܐ	sˤ a d r ɑː
ܛܥܘܢܬܐ	tˤ u n t ɑː
ܫܬܐܣ	ʃ a t ʔ ɪ s
ܪܩܡܐ	r a q m ɑː
ܡܛܣ	m a tˤ tˤ ɪ s
ܦܪܢܣܐ	p ə r a n s ɑː
ܡܛܪ	m ɑː tˤ e rː
ܡܣܦܝܠܐ	m a ʃ p iː l ɑː
ܕܘܠܪ	d o l ɑ rː
ܡܪܟܫܝܐ	m a r r ɑː k ə ʃ ɑː j ɑː
ܬܢܐ	t ɑː n eː
ܦܪܡܒܘܙ	f r ɑː m b w ɑ zː
ܕܒܪ	d ɑː v ɪ rː
ܦܝܠܣܐ	p iː l ɑː s ɑː
ܕܪܫܐ	d a r ʃ ɑː
