consensuar	k o n s e n ˈs w a ɾ
desbarrancadas	d e s b a r a n ˈk a d a s
autonomista	a u t o n o ˈm i s t a
salvaguardamos	s a l b a ɡ w a ɾ ˈd a m o s
procrastinar	p ɾ o k ɾ a s t i ˈn a ɾ
coexista	k o e ɡ ˈs i s t a
llamaremos	ʝ a m a ˈɾ e m o s
victimado	b i ɡ t i ˈm a d o
Chile	ˈt͡ʃ i l e
abaldonases	a b a l d o ˈn a s e s
acobardares	a k o b a ɾ ˈd a ɾ e s
escavar	e s k a ˈb a ɾ
ondina	o n ˈd i n a
absuelto	a b ˈs w e l t o
desencabestrado	d e s e n k a b e s ˈt ɾ a d o
Pireo	p i ˈɾ e o
primate	p ɾ i ˈm a t e
tristura	t ɾ i s ˈt u ɾ a
litigares	l i t i ˈɡ a ɾ e s
conservadorismo	k o n s e ɾ b a d o ˈɾ i s m o
enroca	e n ˈr o k a
extrusiva	e ɡ s t ɾ u ˈs i b a
Pegaso	p e ˈɡ a s o
deforestar	d e f o ɾ e s ˈt a ɾ
hipocomplementemia	i p o k o m p l e m e n ˈt e m j a
debelaste	d e b e ˈl a s t e
pélvica	ˈp e l b i k a
patovica	p a t o ˈb i k a
acústicas	a ˈk u s t i k a s
despeñados	d e s p e ˈɲ a d o s
tírenla	ˈt i ɾ e n l a
Canuto	k a ˈn u t o
paletón	p a l e ˈt o n
esponjoso	e s p o n ˈx o s o
opulento	o p u ˈl e n t o
colectivista	k o l e ɡ t i ˈb i s t a
errarás	e r a ˈɾ a s
aplicable	a p l i ˈk a b l e
funicular	f u n i k u ˈl a ɾ
villalbés	b i ʝ a l ˈb e s
Guáimaro	ˈɡ w a i m a ɾ o
solad	s o ˈl a d
dijeren	d i ˈx e ɾ e n
castellanista	k a s t e ʝ a ˈn i s t a
Góngora	ˈɡ o n ɡ o ɾ a
abstuvieren	a b s t u ˈb j e ɾ e n
fotografiado	f o t o ɡ ɾ a ˈf j a d o
habitadora	a b i t a ˈd o ɾ a
paralelada	p a ɾ a l e ˈl a d a
escurrir	e s k u ˈr i ɾ
aerocubierta	a e ɾ o k u ˈb j e ɾ t a
gamarrista	ɡ a m a ˈr i s t a
juglaresco	x u ɡ l a ˈɾ e s k o
porrito	p o ˈr i t o
honores	o ˈn o ɾ e s
vial	ˈb j a l
hipsómetros	i b ˈs o m e t ɾ o s
tenebrosas	t e n e ˈb ɾ o s a s
pluvioso	p l u ˈb j o s o
deleitar	d e l e i ˈt a ɾ
amartillado	a m a ɾ t i ˈʝ a d o
enredados	e n r e ˈd a d o s
catecúmena	k a t e ˈk u m e n a
titulaste	t i t u ˈl a s t e
proveídos	p ɾ o b e ˈi d o s
radiografiados	r a d j o ɡ ɾ a ˈf j a d o s
débil	ˈd e b i l
polbero	p o l ˈb e ɾ o
dalia	ˈd a l j a
juguetonamente	x u ɡ e ˌt o n a ˈm e n t e
jamelga	x a ˈm e l ɡ a
palatino	p a l a ˈt i n o
postobligatorios	p o s t o b l i ɡ a ˈt o ɾ j o s
chulunca	t͡ʃ u ˈl u n k a
empatada	e m p a ˈt a d a
superares	s u p e ˈɾ a ɾ e s
animada	a n i ˈm a d a
estaré	e s t a ˈɾ e
odre	ˈo d ɾ e
cochambre	k o ˈt͡ʃ a m b ɾ e
sarga	ˈs a ɾ ɡ a
rescatadas	r e s k a ˈt a d a s
locutivo	l o k u ˈt i b o
cabás	k a ˈb a s
repostear	r e p o s t e ˈa ɾ
poliamoroso	p o l i a m o ˈɾ o s o
Antón	a n ˈt o n
andaban	a n ˈd a b a n
rédito	ˈr e d i t o
premiaríamos	p ɾ e m j a ˈɾ i a m o s
redil	r e ˈd i l
esgrimidor	e s ɡ ɾ i m i ˈd o ɾ
pasota	p a ˈs o t a
llamarlos	ʝ a ˈm a ɾ l o s
devotas	d e ˈb o t a s
paneleros	p a n e ˈl e ɾ o s
guijarro	ɡ i ˈx a r o
abrevadero	a b ɾ e b a ˈd e ɾ o
estaquillas	e s t a ˈk i ʝ a s
expansionar	e ɡ s p a n s j o ˈn a ɾ
atresia	a ˈt ɾ e s j a
decanato	d e k a ˈn a t o
puntilloso	p u n t i ˈʝ o s o
alongadas	a l o n ˈɡ a d a s
disentidos	d i s e n ˈt i d o s
güiña	ˈɡ w i ɲ a
culminado	k u l m i ˈn a d o
abeldar	a b e l ˈd a ɾ
abacoraremos	a b a k o ɾ a ˈɾ e m o s
periquitos	p e ɾ i ˈk i t o s
absolveríais	a b s o l b e ˈɾ i a i s
intrigados	i n t ɾ i ˈɡ a d o s
periclitado	p e ɾ i k l i ˈt a d o
reportar	r e p o ɾ ˈt a ɾ
subarrendar	s u b a r e n ˈd a ɾ
asesora	a s e ˈs o ɾ a
banfileños	b a n f i ˈl e ɲ o s
recostabas	r e k o s ˈt a b a s
Choy	ˈt͡ʃ o i
rematricular	r e m a t ɾ i k u ˈl a ɾ
tomografía	t o m o ɡ ɾ a ˈf i a
chorrillana	t͡ʃ o r i ˈʝ a n a
oliente	o ˈl j e n t e
enganchadas	e n ɡ a n ˈt͡ʃ a d a s
bonificadas	b o n i f i ˈk a d a s
madrigal	m a d ɾ i ˈɡ a l
otaku	o ˈt a k u
prevaricadora	p ɾ e b a ɾ i k a ˈd o ɾ a
multáramos	m u l ˈt a ɾ a m o s
incautadas	i n k a u ˈt a d a s
veneraremos	b e n e ɾ a ˈɾ e m o s
vagueado	b a ɡ e ˈa d o
antiindustrial	a n t i i n d u s ˈt ɾ j a l
desnudamiento	d e s n u d a ˈm j e n t o
penúltima	p e ˈn u l t i m a
aborregabais	a b o r e ˈɡ a b a i s
ornitorrinco	o ɾ n i t o ˈr i n k o
yukpa	ˈʝ u ɡ p a
odontológicas	o d o n t o ˈl o x i k a s
atrofiará	a t ɾ o f j a ˈɾ a
vertida	b e ɾ ˈt i d a
padrear	p a d ɾ e ˈa ɾ
turco	ˈt u ɾ k o
retiráramos	r e t i ˈɾ a ɾ a m o s
ser	ˈs e ɾ
colapso	k o ˈl a b s o
conmutados	k o m m u ˈt a d o s
imprudentes	i m p ɾ u ˈd e n t e s
enastado	e n a s ˈt a d o
colocado	k o l o ˈk a d o
esponjaren	e s p o n ˈx a ɾ e n
corte	ˈk o ɾ t e
pielero	p j e ˈl e ɾ o
nefarias	n e ˈf a ɾ j a s
aguará	a ɡ w a ˈɾ a
focal	f o ˈk a l
martinelli	m a ɾ t i ˈn e l i
reverberaréis	r e b e ɾ b e ɾ a ˈɾ e i s
ternero	t e ɾ ˈn e ɾ o
alojara	a l o ˈx a ɾ a
talego	t a ˈl e ɡ o
tacleado	t a k l e ˈa d o
piquillín	p i k i ˈʝ i n
sopetón	s o p e ˈt o n
asamblea	a s a m ˈb l e a
granjeada	ɡ ɾ a n x e ˈa d a
caballera	k a b a ˈʝ e ɾ a
Noguera	n o ˈɡ e ɾ a
Vladimir	b l a d i ˈm i ɾ
aditividad	a d i t i b i ˈd a d
botil	b o ˈt i l
sondeados	s o n d e ˈa d o s
agüevada	a ɡ w e ˈb a d a
ánsara	ˈa n s a ɾ a
épicorreligioso	ˈe p i k o r e l i x j o s o
cutrona	k u ˈt ɾ o n a
fregotear	f ɾ e ɡ o t e ˈa ɾ
abjurando	a b x u ˈɾ a n d o
aguador	a ɡ w a ˈd o ɾ
copada	k o ˈp a d a
resplandor	r e s p l a n ˈd o ɾ
desvividas	d e s b i ˈb i d a s
lascada	l a s ˈk a d a
temeos	t e ˈm e o s
asuán	a ˈs w a n
estriada	e s ˈt ɾ j a d a
intimidados	i n t i m i ˈd a d o s
partamos	p a ɾ ˈt a m o s
rodas	ˈr o d a s
recabdo	r e ˈk a b d o
comprensivo	k o m p ɾ e n ˈs i b o
afirmemos	a f i ɾ ˈm e m o s
desamparar	d e s a m p a ˈɾ a ɾ
insólitos	i n ˈs o l i t o s
higüero	i ˈɡ w e ɾ o
pendíamos	p e n ˈd i a m o s
honda	ˈo n d a
lihueñe	l i ˈw e ɲ e
modelando	m o d e ˈl a n d o
forjador	f o ɾ x a ˈd o ɾ
deprisa	d e ˈp ɾ i s a
alérgeno	a ˈl e ɾ x e n o
penco	ˈp e n k o
guadaña	ɡ w a ˈd a ɲ a
poderío	p o d e ˈɾ i o
fructífero	f ɾ u ɡ ˈt i f e ɾ o
inquietada	i n k j e ˈt a d a
desbandá	d e s b a n ˈd a
metonimia	m e t o ˈn i m j a
paremos	p a ˈɾ e m o s
aleteadas	a l e t e ˈa d a s
moraríamos	m o ɾ a ˈɾ i a m o s
oleados	o l e ˈa d o s
respiras	r e s ˈp i ɾ a s
hepatotropos	e p a t o ˈt ɾ o p o s
evitar	e b i ˈt a ɾ
colofón	k o l o ˈf o n
autotrófico	a u t o ˈt ɾ o f i k o
escuincle	e s ˈk w i n k l e
nacatamal	n a k a t a ˈm a l
autónomos	a u ˈt o n o m o s
minicomponente	m i n i k o m p o ˈn e n t e
cagado	k a ˈɡ a d o
hubiese	u ˈb j e s e
diablita	d j a ˈb l i t a
mal	ˈm a l
perennifolio	p e ɾ e n n i ˈf o l j o
dríade	ˈd ɾ i a d e
comprará	k o m p ɾ a ˈɾ a
sunroof	ˈs a n r u f
afectaras	a f e ɡ ˈt a ɾ a s
desglose	d e s ˈɡ l o s e
abullonaras	a b u ʝ o ˈn a ɾ a s
lacaya	l a ˈk a ʝ a
sexar	s e ɡ ˈs a ɾ
cardíaco	k a ɾ ˈd i a k o
utrera	u ˈt ɾ e ɾ a
pegón	p e ˈɡ o n
intervalo	i n t e ɾ ˈb a l o
atas	ˈa t a s
tos	ˈt o s
arbusto	a ɾ ˈb u s t o
guitarra	ɡ i ˈt a r a
malpuesto	m a l ˈp w e s t o
retreparse	r e t ɾ e ˈp a ɾ s e
prendidos	p ɾ e n ˈd i d o s
orlará	o ɾ l a ˈɾ a
jaca	ˈx a k a
guajiro	ɡ w a ˈx i ɾ o
Abraham	a ˈb ɾ a m
litronas	l i ˈt ɾ o n a s
robre	ˈr o b ɾ e
tajante	t a ˈx a n t e
lechoso	l e ˈt͡ʃ o s o
ayuno	a ˈʝ u n o
fosforosa	f o s f o ˈɾ o s a
plantares	p l a n ˈt a ɾ e s
espachurrada	e s p a t͡ʃ u ˈr a d a
amplificado	a m p l i f i ˈk a d o
abastos	a ˈb a s t o s
lagartón	l a ɡ a ɾ ˈt o n
reductores	r e d u ɡ ˈt o ɾ e s
desolladora	d e s o ʝ a ˈd o ɾ a
atestar	a t e s ˈt a ɾ
botáramos	b o ˈt a ɾ a m o s
cantémoslos	k a n ˈt e m o s l o s
recua	ˈr e k w a
vosotras	b o ˈs o t ɾ a s
hexafluorofosfato	e ɡ s a f l w o ɾ o f o s ˈf a t o
despercudir	d e s p e ɾ k u ˈd i ɾ
gramatical	ɡ ɾ a m a t i ˈk a l
diptongada	d i b t o n ˈɡ a d a
yoduro	ʝ o ˈd u ɾ o
forramos	f o ˈr a m o s
coescriptas	k o e s ˈk ɾ i b t a s
suma	ˈs u m a
traído	t ɾ a ˈi d o
dominiquesa	d o m i n i ˈk e s a
asolada	a s o ˈl a d a
sobrerrepresentaría	s o b ɾ e r e p ɾ e s e n t a ˈɾ i a
bufónico	b u ˈf o n i k o
temblequeado	t e m b l e k e ˈa d o
deleitadas	d e l e i ˈt a d a s
anidados	a n i ˈd a d o s
admire	a d ˈm i ɾ e
desfogados	d e s f o ˈɡ a d o s
incolora	i n k o ˈl o ɾ a
byte	ˈb a i t
infundir	i n f u n ˈd i ɾ
mansega	m a n ˈs e ɡ a
vapeadas	b a p e ˈa d a s
ensamblaje	e n s a m ˈb l a x e
Escobar	e s k o ˈb a ɾ
acuminadas	a k u m i ˈn a d a s
derecho	d e ˈɾ e t͡ʃ o
aniquilar	a n i k i ˈl a ɾ
reestructurados	r e e s t ɾ u ɡ t u ˈɾ a d o s
rebobinar	r e b o b i ˈn a ɾ
pulsado	p u l ˈs a d o
moraste	m o ˈɾ a s t e
ruido	ˈr w i d o
garantía	ɡ a ɾ a n ˈt i a
atemos	a ˈt e m o s
llamare	ʝ a ˈm a ɾ e
rehén	r e ˈe n
enripiadas	e n r i ˈp j a d a s
sudanés	s u d a ˈn e s
deformante	d e f o ɾ ˈm a n t e
caligrafiados	k a l i ɡ ɾ a ˈf j a d o s
susurrar	s u s u ˈr a ɾ
santaneco	s a n t a ˈn e k o
hemorragia	e m o ˈr a x j a
destacados	d e s t a ˈk a d o s
patchwork	ˈp a t͡ʃ w o ɾ k
saudade	s a u ˈd a d e
ñera	ˈɲ e ɾ a
genitales	x e n i ˈt a l e s
achicopalaos	a t͡ʃ i k o p a ˈl a o s
amarrete	a m a ˈr e t e
mamoneá	m a m o n e ˈa
vigesimosexto	b i ˌx e s i m o ˈs e ɡ s t o
degenerativa	d e x e n e ɾ a ˈt i b a
dictaminadora	d i ɡ t a m i n a ˈd o ɾ a
abastarda	a b a s ˈt a ɾ d a
fontanería	f o n t a n e ˈɾ i a
usurero	u s u ˈɾ e ɾ o
afectaste	a f e ɡ ˈt a s t e
planeada	p l a n e ˈa d a
morfea	m o ɾ ˈf e a
Nebraska	n e ˈb ɾ a s k a
sorpresivamente	s o ɾ p ɾ e ˌs i b a ˈm e n t e
follable	f o ˈʝ a b l e
sorpresivo	s o ɾ p ɾ e ˈs i b o
punalúa	p u n a ˈl u a
irritadas	i r i ˈt a d a s
corcho	ˈk o ɾ t͡ʃ o
semimeridiano	s e m i m e ɾ i ˈd j a n o
soma	ˈs o m a
homenaje	o m e ˈn a x e
replanteados	r e p l a n t e ˈa d o s
logísticas	l o ˈx i s t i k a s
presupuestario	p ɾ e s u p w e s ˈt a ɾ j o
ubiquinona	u b i k i ˈn o n a
skopiote	e s k o ˈp j o t e
godo	ˈɡ o d o
aduláramos	a d u ˈl a ɾ a m o s
nativos	n a ˈt i b o s
confortamos	k o n f o ɾ ˈt a m o s
autosaboteados	a u t o s a b o t e ˈa d o s
vístanlo	ˈb i s t a n l o
perdigón	p e ɾ d i ˈɡ o n
resultadas	r e s u l ˈt a d a s
propensión	p ɾ o p e n ˈs j o n
embebidos	e m b e ˈb i d o s
engallar	e n ɡ a ˈʝ a ɾ
endeudado	e n d e u ˈd a d o
fibrinosos	f i b ɾ i ˈn o s o s
cojinúa	k o x i ˈn u a
tachada	t a ˈt͡ʃ a d a
Irenea	i ɾ e ˈn e a
trastabillear	t ɾ a s t a b i ʝ e ˈa ɾ
flojo	ˈf l o x o
comierais	k o ˈm j e ɾ a i s
lamentaste	l a m e n ˈt a s t e
complicaditos	k o m p l i k a ˈd i t o s
quinurénico	k i n u ˈɾ e n i k o
calumniosa	k a l u m ˈn j o s a
hipersexualidad	i p e ɾ s e ɡ s w a l i ˈd a d
triangula	t ɾ j a n ˈɡ u l a
nigroestriados	n i ɡ ɾ o e s ˈt ɾ j a d o s
escarbador	e s k a ɾ b a ˈd o ɾ
normoevolutivo	n o ɾ m o e b o l u ˈt i b o
trianguladas	t ɾ j a n ɡ u ˈl a d a s
rácano	ˈr a k a n o
cualquier	k w a l ˈk j e ɾ
afirmo	a ˈf i ɾ m o
singular	s i n ɡ u ˈl a ɾ
acopiada	a k o ˈp j a d a
pausadas	p a u ˈs a d a s
clorosis	k l o ˈɾ o s i s
rematado	r e m a ˈt a d o
semiconductor	s e m i k o n d u ɡ ˈt o ɾ
sobrellevadas	s o b ɾ e ʝ e ˈb a d a s
mantequilludas	m a n t e k i ˈʝ u d a s
panafricanos	p a n a f ɾ i ˈk a n o s
desenchufadas	d e s e n t͡ʃ u ˈf a d a s
fincado	f i n ˈk a d o
ignorado	i ɡ n o ˈɾ a d o
licopodio	l i k o ˈp o d j o
traficante	t ɾ a f i ˈk a n t e
Lavapiés	ˌl a b a ˈp j e s
acotolados	a k o t o ˈl a d o s
habladla	a ˈb l a d l a
caricatures	k a ɾ i k a ˈt u ɾ e s
tiroxina	t i ɾ o ɡ ˈs i n a
forestar	f o ɾ e s ˈt a ɾ
ininteligibilidad	i n i n t e l i x i b i l i ˈd a d
reintensificada	r e i n t e n s i f i ˈk a d a
supervalorada	s u p e ɾ b a l o ˈɾ a d a
neologismo	n e o l o ˈx i s m o
bestseller	b e s t ˈs e l e ɾ
churruscar	t͡ʃ u r u s ˈk a ɾ
amohinadas	a m o i ˈn a d a s
digitaríamos	d i x i t a ˈɾ i a m o s
jimia	ˈx i m j a
dimisionar	d i m i s j o ˈn a ɾ
discordada	d i s k o ɾ ˈd a d a
baeneras	b a e ˈn e ɾ a s
endovascular	e n d o b a s k u ˈl a ɾ
hidrólisis	i ˈd ɾ o l i s i s
regodeado	r e ɡ o d e ˈa d o
adoptando	a d o b ˈt a n d o
próximo	ˈp ɾ o ɡ s i m o
aseverado	a s e b e ˈɾ a d o
rehusados	r e u ˈs a d o s
Araujo	a ˈɾ a u x o
estrechas	e s ˈt ɾ e t͡ʃ a s
estratigrafía	e s t ɾ a t i ɡ ɾ a ˈf i a
subdividir	s u b d i b i ˈd i ɾ
abordadas	a b o ɾ ˈd a d a s
caxcana	k a ɡ s ˈk a n a
mohínos	m o ˈi n o s
oligotrófico	o l i ɡ o ˈt ɾ o f i k o
sobrellevado	s o b ɾ e ʝ e ˈb a d o
endocrinológica	e n d o k ɾ i n o ˈl o x i k a
involutivos	i m b o l u ˈt i b o s
raigrás	r a i ˈɡ ɾ a s
despeinado	d e s p e i ˈn a d o
antigua	a n ˈt i ɡ w a
nanorrobot	n a n o r o ˈb o t
aventures	a b e n ˈt u ɾ e s
Salaverria	s a l a ˈb e r j a
acholados	a t͡ʃ o ˈl a d o s
empreñador	e m p ɾ e ɲ a ˈd o ɾ
laso	ˈl a s o
coliderar	k o l i d e ˈɾ a ɾ
divulgado	d i b u l ˈɡ a d o
valorativa	b a l o ɾ a ˈt i b a
paseíllo	p a s e ˈi ʝ o
numerable	n u m e ˈɾ a b l e
pastito	p a s ˈt i t o
anaplásico	a n a ˈp l a s i k o
aspectada	a s p e ɡ ˈt a d a
guitarristas	ɡ i t a ˈr i s t a s
desclasificado	d e s k l a s i f i ˈk a d o
antenal	a n t e ˈn a l
fisgoneados	f i s ɡ o n e ˈa d o s
portera	p o ɾ ˈt e ɾ a
mostraste	m o s ˈt ɾ a s t e
polaridad	p o l a ɾ i ˈd a d
desbancada	d e s b a n ˈk a d a
agroclimática	a ɡ ɾ o k l i ˈm a t i k a
motito	m o ˈt i t o
abañadas	a b a ˈɲ a d a s
transplantada	t ɾ a n s p l a n ˈt a d a
estada	e s ˈt a d a
cantarlas	k a n ˈt a ɾ l a s
cartesianos	k a ɾ t e ˈs j a n o s
baldado	b a l ˈd a d o
epigástrico	e p i ˈɡ a s t ɾ i k o
autenticadas	a u t e n t i ˈk a d a s
mesentérico	m e s e n ˈt e ɾ i k o
escolar	e s k o ˈl a ɾ
bebito	b e ˈb i t o
idolatrados	i d o l a ˈt ɾ a d o s
alejada	a l e ˈx a d a
histoquímicas	i s t o ˈk i m i k a s
rapsoda	r a b ˈs o d a
enseñado	e n s e ˈɲ a d o
jamaicanos	x a m a i ˈk a n o s
mate	ˈm a t e
taponear	t a p o n e ˈa ɾ
miositis	m j o ˈs i t i s
pacará	p a k a ˈɾ a
jugadas	x u ˈɡ a d a s
quíntuplos	ˈk i n t u p l o s
esofagogastroduodenoscopia	e s o f a ɡ o ɡ a s t ɾ o d w o d e n o s ˈk o p j a
abreviadas	a b ɾ e ˈb j a d a s
ruines	ˈr w i n e s
hierosolimitano	ʝ e ɾ o s o l i m i ˈt a n o
bongosero	b o n ɡ o ˈs e ɾ o
reverberar	r e b e ɾ b e ˈɾ a ɾ
égloga	ˈe ɡ l o ɡ a
bloguear	b l o ɡ e ˈa ɾ
borrega	b o ˈr e ɡ a
distensible	d i s t e n ˈs i b l e
retromandibular	r e t ɾ o m a n d i b u ˈl a ɾ
regalada	r e ɡ a ˈl a d a
ontofántico	o n t o ˈf a n t i k o
seudoconsulta	s e u d o k o n ˈs u l t a
desembolsadas	d e s e m b o l ˈs a d a s
pornificar	p o ɾ n i f i ˈk a ɾ
oncológica	o n k o ˈl o x i k a
contraatacados	k o n t ɾ a a t a ˈk a d o s
lloriqueados	ʝ o ɾ i k e ˈa d o s
emulsionada	e m u l s j o ˈn a d a
desintegrar	d e s i n t e ˈɡ ɾ a ɾ
hackearás	x a k e a ˈɾ a s
acuclillado	a k u k l i ˈʝ a d o
abogades	a b o ˈɡ a d e s
amacollado	a m a k o ˈʝ a d o
afanosas	a f a ˈn o s a s
angostados	a n ɡ o s ˈt a d o s
erre	ˈe r e
hidrométricas	i d ɾ o ˈm e t ɾ i k a s
bisemanal	b i s e m a ˈn a l
banderita	b a n d e ˈɾ i t a
rumbeados	r u m b e ˈa d o s
coartados	k o a ɾ ˈt a d o s
extrasistólicos	e ɡ s t ɾ a s i s ˈt o l i k o s
trebolito	t ɾ e b o ˈl i t o
machadiana	m a t͡ʃ a ˈd j a n a
miras	ˈm i ɾ a s
degradada	d e ɡ ɾ a ˈd a d a
carpetana	k a ɾ p e ˈt a n a
desprotegida	d e s p ɾ o t e ˈx i d a
subveguería	s u b b e ɡ e ˈɾ i a
hasta	ˈa s t a
jamelgo	x a ˈm e l ɡ o
apenaréis	a p e n a ˈɾ e i s
contactes	k o n ˈt a ɡ t e s
gayado	ɡ a ˈʝ a d o
matula	m a ˈt u l a
chinicuil	t͡ʃ i n i ˈk w i l
liberta	l i ˈb e ɾ t a
valentona	b a l e n ˈt o n a
propano	p ɾ o ˈp a n o
acordándose	a k o ɾ ˈd a n d o s e
aduana	a ˈd w a n a
distinto	d i s ˈt i n t o
elequeme	e l e ˈk e m e
reputados	r e p u ˈt a d o s
eludes	e ˈl u d e s
hablándoles	a ˈb l a n d o l e s
sudista	s u ˈd i s t a
warfarina	w a ɾ f a ˈɾ i n a
Donaire	d o ˈn a i ɾ e
despellejados	d e s p e ʝ e ˈx a d o s
supracondíleo	s u p ɾ a k o n ˈd i l e o
sicológicas	s i k o ˈl o x i k a s
benigna	b e ˈn i ɡ n a
surfeados	s u ɾ f e ˈa d o s
abstendríamos	a b s t e n ˈd ɾ i a m o s
balleneras	b a ʝ e ˈn e ɾ a s
Némesis	ˈn e m e s i s
nesga	ˈn e s ɡ a
pentavalente	p e n t a b a ˈl e n t e
vetaros	b e ˈt a ɾ o s
Merino	m e ˈɾ i n o
encontraras	e n k o n ˈt ɾ a ɾ a s
meloso	m e ˈl o s o
protesto	p ɾ o ˈt e s t o
antepuesto	a n t e ˈp w e s t o
subida	s u ˈb i d a
gorrón	ɡ o ˈr o n
oídos	o ˈi d o s
fijar	f i ˈx a ɾ
filmar	f i l ˈm a ɾ
burdeos	b u ɾ ˈd e o s
jarana	x a ˈɾ a n a
emolientero	e m o l j e n ˈt e ɾ o
amentoflavona	a m e n t o f l a ˈb o n a
Argentina	a ɾ x e n ˈt i n a
petrológico	p e t ɾ o ˈl o x i k o
vienés	b j e ˈn e s
confeso	k o n ˈf e s o
lentillo	l e n ˈt i ʝ o
anatomía	a n a t o ˈm i a
extraditar	e ɡ s t ɾ a d i ˈt a ɾ
pedroso	p e ˈd ɾ o s o
desembrujada	d e s e m b ɾ u ˈx a d a
indisimulada	i n d i s i m u ˈl a d a
cartografiados	k a ɾ t o ɡ ɾ a ˈf j a d o s
pelasga	p e ˈl a s ɡ a
septiembre	s e b ˈt j e m b ɾ e
mariposilla	m a ɾ i p o ˈs i ʝ a
baraja	b a ˈɾ a x a
paico	ˈp a i k o
amurallada	a m u ɾ a ˈʝ a d a
peloteado	p e l o t e ˈa d o
disuadida	d i s w a ˈd i d a
carroñero	k a r o ˈɲ e ɾ o
conuco	k o ˈn u k o
tiritada	t i ɾ i ˈt a d a
lacra	ˈl a k ɾ a
ronda	ˈr o n d a
bilis	ˈb i l i s
lisosómico	l i s o ˈs o m i k o
Fani	ˈf a n i
acompañante	a k o m p a ˈɲ a n t e
parasailing	p a ɾ a ˈs e i l i n
faremos	f a ˈɾ e m o s
improvisar	i m p ɾ o b i ˈs a ɾ
abadernásemos	a b a d e ɾ ˈn a s e m o s
carintia	k a ˈɾ i n t j a
tatuada	t a ˈt w a d a
obsequiada	o b s e ˈk j a d a
roca	ˈr o k a
añadir	a ɲ a ˈd i ɾ
destapador	d e s t a p a ˈd o ɾ
algometría	a l ɡ o m e ˈt ɾ i a
tricotaren	t ɾ i k o ˈt a ɾ e n
hipovolémicas	i p o b o ˈl e m i k a s
astragalinos	a s t ɾ a ɡ a ˈl i n o s
desintegrativos	d e s i n t e ɡ ɾ a ˈt i b o s
beguina	b e ˈɡ i n a
estuvieses	e s t u ˈb j e s e s
tansé	t a n ˈs e
mironeo	m i ɾ o ˈn e o
estructurado	e s t ɾ u ɡ t u ˈɾ a d o
acábalos	a ˈk a b a l o s
Gamba	ˈɡ a m b a
Marroquín	m a r o ˈk i n
intelectualismo	i n t e l e ɡ t w a ˈl i s m o
disputable	d i s p u ˈt a b l e
fogón	f o ˈɡ o n
Angulo	a n ˈɡ u l o
devasto	d e ˈb a s t o
pesqueras	p e s ˈk e ɾ a s
alcaldada	a l k a l ˈd a d a
substituidos	s u b s t i ˈt w i d o s
polenta	p o ˈl e n t a
tañedora	t a ɲ e ˈd o ɾ a
palladiano	p a ʝ a ˈd j a n o
intoxicadas	i n t o ɡ s i ˈk a d a s
intentada	i n t e n ˈt a d a
abatatada	a b a t a ˈt a d a
sobresaltadas	s o b ɾ e s a l ˈt a d a s
antinomia	a n t i ˈn o m j a
transladada	t ɾ a n s l a ˈd a d a
vestido	b e s ˈt i d o
protamina	p ɾ o t a ˈm i n a
elegible	e l e ˈx i b l e
becarias	b e ˈk a ɾ j a s
vertedor	b e ɾ t e ˈd o ɾ
arrecostar	a r e k o s ˈt a ɾ
panal	p a ˈn a l
taquito	t a ˈk i t o
Remigio	r e ˈm i x j o
adquirida	a d k i ˈɾ i d a
comámosles	k o ˈm a m o s l e s
váyanla	ˈb a ʝ a n l a
artrósico	a ɾ ˈt ɾ o s i k o
piemontés	p j e m o n ˈt e s
vincristina	b i n k ɾ i s ˈt i n a
doblegarse	d o b l e ˈɡ a ɾ s e
fanfarrones	f a n f a ˈr o n e s
africada	a f ɾ i ˈk a d a
sigiladas	s i x i ˈl a d a s
andándoles	a n ˈd a n d o l e s
apellidada	a p e ʝ i ˈd a d a
esteparia	e s t e ˈp a ɾ j a
workshop	ˈw o ɾ ɡ ʃ o p
vetéis	b e ˈt e i s
oviraptorosaurio	o b i ɾ a b t o ɾ o ˈs a u ɾ j o
ñoñear	ɲ o ɲ e ˈa ɾ
envalentonadas	e m b a l e n t o ˈn a d a s
reparemos	r e p a ˈɾ e m o s
soros	ˈs o ɾ o s
abaldóneles	a b a l ˈd o n e l e s
contrariado	k o n t ɾ a ˈɾ j a d o
impactada	i m p a ɡ ˈt a d a
amarteladas	a m a ɾ t e ˈl a d a s
espinodal	e s p i n o ˈd a l
hipogastrio	i p o ˈɡ a s t ɾ j o
tiliche	t i ˈl i t͡ʃ e
deliradas	d e l i ˈɾ a d a s
terral	t e ˈr a l
cleriguito	k l e ɾ i ˈɡ i t o
trasegador	t ɾ a s e ɡ a ˈd o ɾ
varsoviano	b a ɾ s o ˈb j a n o
alquitranados	a l k i t ɾ a ˈn a d o s
babélica	b a ˈb e l i k a
empalagada	e m p a l a ˈɡ a d a
subependimomas	s u b e p e n d i ˈm o m a s
opaca	o ˈp a k a
cánones	ˈk a n o n e s
ganduleadas	ɡ a n d u l e ˈa d a s
chapoteados	t͡ʃ a p o t e ˈa d o s
volcadas	b o l ˈk a d a s
leninistas	l e n i ˈn i s t a s
ey	ˈe i
coexistidos	k o e ɡ s i s ˈt i d o s
esponjosos	e s p o n ˈx o s o s
hayámoos	a ˈʝ a m o o s
pun	ˈp u n
rodando	r o ˈd a n d o
Cardona	k a ɾ ˈd o n a
rafagueados	r a f a ɡ e ˈa d o s
desgranada	d e s ɡ ɾ a ˈn a d a
alumbre	a ˈl u m b ɾ e
cunques	ˈk u n k e s
interétnicos	i n t e ˈɾ e d n i k o s
redargüidas	r e d a ɾ ˈɡ w i d a s
extraversión	e ɡ s t ɾ a b e ɾ ˈs j o n
cacahuete	k a k a ˈw e t e
diseñar	d i s e ˈɲ a ɾ
avenarán	a b e n a ˈɾ a n
perdedora	p e ɾ d e ˈd o ɾ a
Nursultán	n u ɾ s u l ˈt a n
Vichada	b i ˈt͡ʃ a d a
precavidas	p ɾ e k a ˈb i d a s
pajarera	p a x a ˈɾ e ɾ a
resondrar	r e s o n ˈd ɾ a ɾ
estruja	e s ˈt ɾ u x a
Goliat	ɡ o ˈl j a t
arropado	a r o ˈp a d o
deslavar	d e s l a ˈb a ɾ
semiarco	s e ˈm j a ɾ k o
vendimiados	b e n d i ˈm j a d o s
extrasistólica	e ɡ s t ɾ a s i s ˈt o l i k a
membranoproliferativo	m e m b ɾ a n o p ɾ o l i f e ɾ a ˈt i b o
vetándoos	b e ˈt a n d o o s
respeto	r e s ˈp e t o
Jaca	ˈx a k a
lídar	ˈl i d a ɾ
debería	d e b e ˈɾ i a
tabicadas	t a b i ˈk a d a s
defectuoso	d e f e ɡ ˈt w o s o
desafecta	d e s a ˈf e ɡ t a
huanuqueño	w̝ a n u ˈk e ɲ o
oraremos	o ɾ a ˈɾ e m o s
investigadoras	i m b e s t i ɡ a ˈd o ɾ a s
cascajo	k a s ˈk a x o
yuracaré	ʝ u ɾ a k a ˈɾ e
piragua	p i ˈɾ a ɡ w a
meningitis	m e n i n ˈx i t i s
lúbrico	ˈl u b ɾ i k o
aerografiado	a e ɾ o ɡ ɾ a ˈf j a d o
seísmo	s e ˈi s m o
Jovellanos	x o b e ˈʝ a n o s
extracto	e ɡ s ˈt ɾ a ɡ t o
confluir	k o n ˈf l w i ɾ
gotita	ɡ o ˈt i t a
lechuguero	l e t͡ʃ u ˈɡ e ɾ o
hormigonado	o ɾ m i ɡ o ˈn a d o
husmeada	u s m e ˈa d a
disgustado	d i s ɡ u s ˈt a d o
hipoclorador	i p o k l o ɾ a ˈd o ɾ
hilandera	i l a n ˈd e ɾ a
tascó	t a s ˈk o
exhalar	e ɡ s a ˈl a ɾ
amblados	a m ˈb l a d o s
alijaste	a l i ˈx a s t e
indicamos	i n d i ˈk a m o s
malherida	m a l e ˈɾ i d a
cantanos	k a n ˈt a n o s
empapelar	e m p a p e ˈl a ɾ
oncología	o n k o l o ˈx i a
pifie	ˈp i f j e
debías	d e ˈb i a s
butiá	b u ˈt j a
superpremiado	s u p e ɾ p ɾ e ˈm j a d o
asperjados	a s p e ɾ ˈx a d o s
verdusco	b e ɾ ˈd u s k o
comentados	k o m e n ˈt a d o s
playeras	p l a ˈʝ e ɾ a s
portuenses	p o ɾ ˈt w e n s e s
gobernados	ɡ o b e ɾ ˈn a d o s
cachiporrearse	k a t͡ʃ i p o r e ˈa ɾ s e
Rojas	ˈr o x a s
trasquilado	t ɾ a s k i ˈl a d o
extraacadémica	e ɡ s t ɾ a a k a ˈd e m i k a
impulsivas	i m p u l ˈs i b a s
acaramelados	a k a ɾ a m e ˈl a d o s
desmesurada	d e s m e s u ˈɾ a d a
estar	e s ˈt a ɾ
lampasados	l a m p a ˈs a d o s
Hipnos	ˈi b n o s
saquete	s a ˈk e t e
jadeados	x a d e ˈa d o s
arda	ˈa ɾ d a
blanquillo	b l a n ˈk i ʝ o
horado	o ˈɾ a d o
opinas	o ˈp i n a s
alcapurria	a l k a ˈp u r j a
anticarro	a n t i ˈk a r o
jalapeño	x a l a ˈp e ɲ o
tratar	t ɾ a ˈt a ɾ
veámoslos	b e ˈa m o s l o s
conejito	k o n e ˈx i t o
abajar	a b a ˈx a ɾ
hubimos	u ˈb i m o s
testificar	t e s t i f i ˈk a ɾ
caben	ˈk a b e n
inconcreto	i n k o n ˈk ɾ e t o
portadas	p o ɾ ˈt a d a s
patriótico	p a ˈt ɾ j o t i k o
andaos	a n ˈd a o s
grande	ˈɡ ɾ a n d e
norteños	n o ɾ ˈt e ɲ o s
ensalada	e n s a ˈl a d a
comprometíamos	k o m p ɾ o m e ˈt i a m o s
desabejar	d e s a b e ˈx a ɾ
levitado	l e b i ˈt a d o
murmurador	m u ɾ m u ɾ a ˈd o ɾ
alojativo	a l o x a ˈt i b o
enfriadas	e n ˈf ɾ j a d a s
mechicano	m e t͡ʃ i ˈk a n o
tamboril	t a m b o ˈɾ i l
alcachofera	a l k a t͡ʃ o ˈf e ɾ a
infanta	i n ˈf a n t a
belencanda	b e l e n ˈk a n d a
sobrevolada	s o b ɾ e b o ˈl a d a
usuaria	u ˈs w a ɾ j a
fenaquistoscopio	f e n a k i s t o s ˈk o p j o
encasquetado	e n k a s k e ˈt a d o
derretida	d e r e ˈt i d a
intoxicada	i n t o ɡ s i ˈk a d a
leído	l e ˈi d o
voltaicos	b o l ˈt a i k o s
michoacanos	m i t͡ʃ o a ˈk a n o s
igualadas	i ɡ w a ˈl a d a s
alegal	a l e ˈɡ a l
suinos	ˈs w i n o s
sobretensión	s o b ɾ e t e n ˈs j o n
concluís	k o n ˈk l w i s
comilón	k o m i ˈl o n
incorpóreos	i n k o ɾ ˈp o ɾ e o s
oiréis	o i ˈɾ e i s
argüimos	a ɾ ˈɡ w i m o s
apocopa	a p o ˈk o p a
tirémoslo	t i ˈɾ e m o s l o
trasladado	t ɾ a s l a ˈd a d o
desternilladas	d e s t e ɾ n i ˈʝ a d a s
atravesar	a t ɾ a b e ˈs a ɾ
canalón	k a n a ˈl o n
impracticabilidad	i m p ɾ a ɡ t i k a b i l i ˈd a d
astrosas	a s ˈt ɾ o s a s
tímalo	ˈt i m a l o
tipológicos	t i p o ˈl o x i k o s
olimpiada	o l i m ˈp j a d a
caed	k a ˈe d
prospectora	p ɾ o s p e ɡ ˈt o ɾ a
adorarás	a d o ɾ a ˈɾ a s
caseificante	k a s e i f i ˈk a n t e
palpitar	p a l p i ˈt a ɾ
mapeo	m a ˈp e o
cagona	k a ˈɡ o n a
pernoctar	p e ɾ n o ɡ ˈt a ɾ
radal	r a ˈd a l
emplatado	e m p l a ˈt a d o
clínex	ˈk l i n e ɡ s
tituláramos	t i t u ˈl a ɾ a m o s
ministrado	m i n i s ˈt ɾ a d o
nihilismo	n i i ˈl i s m o
yokut	ʝ o ˈk u t
ladrido	l a ˈd ɾ i d o
guapo	ˈɡ w a p o
tirará	t i ɾ a ˈɾ a
destituidos	d e s t i ˈt w i d o s
retirado	r e t i ˈɾ a d o
notadas	n o ˈt a d a s
Lisandro	l i ˈs a n d ɾ o
habiéndoos	a ˈb j e n d o o s
espingarda	e s p i n ˈɡ a ɾ d a
claveteadas	k l a b e t e ˈa d a s
almarrá	a l m a ˈr a
afirmaras	a f i ɾ ˈm a ɾ a s
hoyoso	o ˈʝ o s o
menoscabadas	m e n o s k a ˈb a d a s
cavador	k a b a ˈd o ɾ
prevaricadoras	p ɾ e b a ɾ i k a ˈd o ɾ a s
domado	d o ˈm a d o
empleador	e m p l e a ˈd o ɾ
suntuosidad	s u n t w o s i ˈd a d
rastrojo	r a s ˈt ɾ o x o
mandatoria	m a n d a ˈt o ɾ j a
jocosamente	x o ˌk o s a ˈm e n t e
sombrerón	s o m b ɾ e ˈɾ o n
velaste	b e ˈl a s t e
desgarradas	d e s ɡ a ˈr a d a s
carteada	k a ɾ t e ˈa d a
abortar	a b o ɾ ˈt a ɾ
comandados	k o m a n ˈd a d o s
pájaros	ˈp a x a ɾ o s
henchida	e n ˈt͡ʃ i d a
sangría	s a n ˈɡ ɾ i a
fermentaras	f e ɾ m e n ˈt a ɾ a s
gravísimas	ɡ ɾ a ˈb i s i m a s
enlutar	e n l u ˈt a ɾ
Saturno	s a ˈt u ɾ n o
hervida	e ɾ ˈb i d a
yaracuyano	ʝ a ɾ a k u ˈʝ a n o
reverendo	r e b e ˈɾ e n d o
guiñadas	ɡ i ˈɲ a d a s
cromatográficos	k ɾ o m a t o ˈɡ ɾ a f i k o s
gradados	ɡ ɾ a ˈd a d o s
predestinada	p ɾ e d e s t i ˈn a d a
campar	k a m ˈp a ɾ
xenófobo	s e ˈn o f o b o
disputador	d i s p u t a ˈd o ɾ
insumir	i n s u ˈm i ɾ
universalidad	u n i b e ɾ s a l i ˈd a d
resanar	r e s a ˈn a ɾ
sobrepujaremos	s o b ɾ e p u x a ˈɾ e m o s
lisar	l i ˈs a ɾ
yiras	ˈʝ i ɾ a s
Ledesma	l e ˈd e s m a
americano	a m e ɾ i ˈk a n o
Vito	ˈb i t o
abandonista	a b a n d o ˈn i s t a
sí	ˈs i
quillado	k i ˈʝ a d o
fitomorfa	f i t o ˈm o ɾ f a
guasón	ɡ w a ˈs o n
antineutrino	a n t i n e u ˈt ɾ i n o
sofisticares	s o f i s t i ˈk a ɾ e s
acabás	a k a ˈb a s
simpaticomiméticas	s i m p a t i k o m i ˈm e t i k a s
aligerados	a l i x e ˈɾ a d o s
depuremos	d e p u ˈɾ e m o s
trastabilleadas	t ɾ a s t a b i ʝ e ˈa d a s
Aruba	a ˈɾ u b a
vedarte	b e ˈd a ɾ t e
biotecnóloga	b j o t e ɡ ˈn o l o ɡ a
emprendedorismo	e m p ɾ e n d e d o ˈɾ i s m o
sorpresita	s o ɾ p ɾ e ˈs i t a
peneanos	p e n e ˈa n o s
sombrerillo	s o m b ɾ e ˈɾ i ʝ o
chompa	ˈt͡ʃ o m p a
calesa	k a ˈl e s a
traedora	t ɾ a e ˈd o ɾ a
cacheteada	k a t͡ʃ e t e ˈa d a
allí	a ˈʝ i
hemínico	e ˈm i n i k o
continuando	k o n t i ˈn w a n d o
anguladas	a n ɡ u ˈl a d a s
frentista	f ɾ e n ˈt i s t a
ola	ˈo l a
caros	ˈk a ɾ o s
periostraco	p e ɾ j o s ˈt ɾ a k o
bilabial	b i l a ˈb j a l
escanea	e s k a ˈn e a
Malí	m a ˈl i
mirla	ˈm i ɾ l a
consellera	k o n s e ˈʝ e ɾ a
bifurcado	b i f u ɾ ˈk a d o
hiladora	i l a ˈd o ɾ a
inmunocomprometidos	i m m u n o k o m p ɾ o m e ˈt i d o s
sobrevalorados	s o b ɾ e b a l o ˈɾ a d o s
almohadilla	a l m o a ˈd i ʝ a
eufemísticas	e u f e ˈm i s t i k a s
alcantarillar	a l k a n t a ɾ i ˈʝ a ɾ
infiltrante	i n f i l ˈt ɾ a n t e
medianera	m e d j a ˈn e ɾ a
proclamados	p ɾ o k l a ˈm a d o s
seguradas	s e ɡ u ˈɾ a d a s
humilladero	u m i ʝ a ˈd e ɾ o
regrabados	r e ɡ ɾ a ˈb a d o s
arraigar	a r a i ˈɡ a ɾ
pagina	p a ˈx i n a
desasosegado	d e s a s o s e ˈɡ a d o
deslustrar	d e s l u s ˈt ɾ a ɾ
puro	ˈp u ɾ o
romboide	r o m ˈb o i d e
garrapiñado	ɡ a r a p i ˈɲ a d o
torturadas	t o ɾ t u ˈɾ a d a s
instantánea	i n s t a n ˈt a n e a
abadernabais	a b a d e ɾ ˈn a b a i s
junte	ˈx u n t e
demoremos	d e m o ˈɾ e m o s
desvirtuados	d e s b i ɾ ˈt w a d o s
agremiados	a ɡ ɾ e ˈm j a d o s
desordenar	d e s o ɾ d e ˈn a ɾ
complicadas	k o m p l i ˈk a d a s
extracomunitarios	e ɡ s t ɾ a k o m u n i ˈt a ɾ j o s
Septuaginta	s e b t w a ˈx i n t a
gaseoso	ɡ a s e ˈo s o
diminutos	d i m i ˈn u t o s
mangrullo	m a n ˈɡ ɾ u ʝ o
matas	ˈm a t a s
rugidas	r u ˈx i d a s
supracondílea	s u p ɾ a k o n ˈd i l e a
honrilla	o n ˈr i ʝ a
usaremos	u s a ˈɾ e m o s
desesperados	d e s e s p e ˈɾ a d o s
cautelados	k a u t e ˈl a d o s
sacramento	s a k ɾ a ˈm e n t o
Tagle	ˈt a ɡ l e
achacoso	a t͡ʃ a ˈk o s o
venilla	b e ˈn i ʝ a
jauría	x a u ˈɾ i a
vallada	b a ˈʝ a d a
listillo	l i s ˈt i ʝ o
terrier	t e ˈr j e ɾ
taburete	t a b u ˈɾ e t e
victoreada	b i ɡ t o ɾ e ˈa d a
tirémoslas	t i ˈɾ e m o s l a s
escalonar	e s k a l o ˈn a ɾ
laboriosa	l a b o ˈɾ j o s a
ordeno	o ɾ ˈd e n o
tautología	t a u t o l o ˈx i a
derrochadoras	d e r o t͡ʃ a ˈd o ɾ a s
difractada	d i f ɾ a ɡ ˈt a d a
festejados	f e s t e ˈx a d o s
okapi	o ˈk a p i
inaudible	i n a u ˈd i b l e
sacristía	s a k ɾ i s ˈt i a
enrocas	e n ˈr o k a s
anacarado	a n a k a ˈɾ a d o
expresados	e ɡ s p ɾ e ˈs a d o s
Fábregas	ˈf a b ɾ e ɡ a s
depurando	d e p u ˈɾ a n d o
estambulita	e s t a m b u ˈl i t a
inquisidora	i n k i s i ˈd o ɾ a
legalidad	l e ɡ a l i ˈd a d
ayoyote	a ʝ o ˈʝ o t e
alteo	a l ˈt e o
guanajo	ɡ w a ˈn a x o
gratinaste	ɡ ɾ a t i ˈn a s t e
sobrevoladas	s o b ɾ e b o ˈl a d a s
amputado	a m p u ˈt a d o
va	ˈb a
animaras	a n i ˈm a ɾ a s
contestar	k o n t e s ˈt a ɾ
sobresalir	s o b ɾ e s a ˈl i ɾ
parangones	p a ɾ a n ˈɡ o n e s
triptongo	t ɾ i b ˈt o n ɡ o
lama	ˈl a m a
abocar	a b o ˈk a ɾ
pavo	ˈp a b o
regladas	r e ˈɡ l a d a s
desempatados	d e s e m p a ˈt a d o s
desaprobado	d e s a p ɾ o ˈb a d o
exageres	e ɡ s a ˈx e ɾ e s
techados	t e ˈt͡ʃ a d o s
sapeada	s a p e ˈa d a
galvánico	ɡ a l ˈb a n i k o
Tato	ˈt a t o
imperará	i m p e ɾ a ˈɾ a
semblar	s e m ˈb l a ɾ
ateísmo	a t e ˈi s m o
pantalones	p a n t a ˈl o n e s
demolidos	d e m o ˈl i d o s
apelas	a ˈp e l a s
corneadas	k o ɾ n e ˈa d a s
magistratura	m a x i s t ɾ a ˈt u ɾ a
suplicamos	s u p l i ˈk a m o s
cabe	ˈk a b e
hemispingo	e m i s ˈp i n ɡ o
persistidas	p e ɾ s i s ˈt i d a s
santeros	s a n ˈt e ɾ o s
listado	l i s ˈt a d o
smoking	e s ˈm o k i n
discordado	d i s k o ɾ ˈd a d o
anglocatólica	a n ɡ l o k a ˈt o l i k a
restados	r e s ˈt a d o s
erógenos	e ˈɾ o x e n o s
torpedeados	t o ɾ p e d e ˈa d o s
chotis	ˈt͡ʃ o t i s
austral	a u s ˈt ɾ a l
actividades	a ɡ t i b i ˈd a d e s
abstuviste	a b s t u ˈb i s t e
anticucho	a n t i ˈk u t͡ʃ o
vermiculadas	b e ɾ m i k u ˈl a d a s
guardoso	ɡ w a ɾ ˈd o s o
depilar	d e p i ˈl a ɾ
tumor	t u ˈm o ɾ
hanguear	a n ɡ e ˈa ɾ
pedrisco	p e ˈd ɾ i s k o
cuico	ˈk w i k o
postulas	p o s ˈt u l a s
mandril	m a n ˈd ɾ i l
afectáramos	a f e ɡ ˈt a ɾ a m o s
competidor	k o m p e t i ˈd o ɾ
estrelladas	e s t ɾ e ˈʝ a d a s
chutaríamos	t͡ʃ u t a ˈɾ i a m o s
quitadas	k i ˈt a d a s
heparina	e p a ˈɾ i n a
detergidas	d e t e ɾ ˈx i d a s
Cartago	k a ɾ ˈt a ɡ o
tuvimos	t u ˈb i m o s
laudar	l a u ˈd a ɾ
otosclerosis	o t o s k l e ˈɾ o s i s
amodorrados	a m o d o ˈr a d o s
enfangados	e n f a n ˈɡ a d o s
abisagrado	a b i s a ˈɡ ɾ a d o
predestinado	p ɾ e d e s t i ˈn a d o
autogestionado	a u t o x e s t j o ˈn a d o
cámping	ˈk a m p i n
envestir	e m b e s ˈt i ɾ
posdoctoral	p o s d o ɡ t o ˈɾ a l
quisiste	k i ˈs i s t e
dentaria	d e n ˈt a ɾ j a
calares	k a ˈl a ɾ e s
frivolidad	f ɾ i b o l i ˈd a d
aumentadas	a u m e n ˈt a d a s
prestatario	p ɾ e s t a ˈt a ɾ j o
apanar	a p a ˈn a ɾ
tedioso	t e ˈd j o s o
matacandelas	m a t a k a n ˈd e l a s
glosásemos	ɡ l o ˈs a s e m o s
hipertensión	i p e ɾ t e n ˈs j o n
mandacaru	m a n d a ˈk a ɾ u
supuesto	s u ˈp w e s t o
tardadas	t a ɾ ˈd a d a s
condene	k o n ˈd e n e
superpotente	s u p e ɾ p o ˈt e n t e
búlgara	ˈb u l ɡ a ɾ a
Alexandrescu	a l e ɡ s a n ˈd ɾ e s k u
costoso	k o s ˈt o s o
bagatela	b a ɡ a ˈt e l a
panegírico	p a n e ˈx i ɾ i k o
Mercurio	m e ɾ ˈk u ɾ j o
chele	ˈt͡ʃ e l e
posibles	p o ˈs i b l e s
alardeados	a l a ɾ d e ˈa d o s
hablémoslos	a ˈb l e m o s l o s
absolutistas	a b s o l u ˈt i s t a s
trancares	t ɾ a n ˈk a ɾ e s
prosternar	p ɾ o s t e ɾ ˈn a ɾ
florales	f l o ˈɾ a l e s
Manolo	m a ˈn o l o
desproveyera	d e s p ɾ o b e ˈʝ e ɾ a
arponeadas	a ɾ p o n e ˈa d a s
kinasa	k i ˈn a s a
maquinistas	m a k i ˈn i s t a s
dañados	d a ˈɲ a d o s
tópico	ˈt o p i k o
libadas	l i ˈb a d a s
estadísticamente	e s t a ˌd i s t i k a ˈm e n t e
fabrica	f a ˈb ɾ i k a
audible	a u ˈd i b l e
tarsometatarsianos	t a ɾ s o m e t a t a ɾ ˈs j a n o s
mangoneada	m a n ɡ o n e ˈa d a
grato	ˈɡ ɾ a t o
pajarón	p a x a ˈɾ o n
jacau	ˈx a k a u
tándems	ˈt a n d e m s
sobrescribir	s o b ɾ e s k ɾ i ˈb i ɾ
tricoto	t ɾ i ˈk o t o
filetear	f i l e t e ˈa ɾ
abajadlo	a b a ˈx a d l o
nada	ˈn a d a
alumnado	a l u m ˈn a d o
solarás	s o l a ˈɾ a s
violentada	b j o l e n ˈt a d a
decolorados	d e k o l o ˈɾ a d o s
metros	ˈm e t ɾ o s
alimaña	a l i ˈm a ɲ a
compulsivas	k o m p u l ˈs i b a s
bebienda	b e ˈb j e n d a
derrochador	d e r o t͡ʃ a ˈd o ɾ
ambientadores	a m b j e n t a ˈd o ɾ e s
ruralidad	r u ɾ a l i ˈd a d
bruñido	b ɾ u ˈɲ i d o
Aragua	a ˈɾ a ɡ w a
rogará	r o ɡ a ˈɾ a
saquear	s a k e ˈa ɾ
sedes	ˈs e d e s
vocabulario	b o k a b u ˈl a ɾ j o
disparado	d i s p a ˈɾ a d o
maldad	m a l ˈd a d
disculpa	d i s ˈk u l p a
veneranda	b e n e ˈɾ a n d a
faso	ˈf a s o
acudí	a k u ˈd i
ósculo	ˈo s k u l o
playas	ˈp l a ʝ a s
alogénico	a l o ˈx e n i k o
monda	ˈm o n d a
vituperar	b i t u p e ˈɾ a ɾ
autoantónimo	a u t o a n ˈt o n i m o
arlequinado	a ɾ l e k i ˈn a d o
intermitente	i n t e ɾ m i ˈt e n t e
usulutecas	u s u l u ˈt e k a s
edentado	e d e n ˈt a d o
reposados	r e p o ˈs a d o s
sufragada	s u f ɾ a ˈɡ a d a
Majagua	m a ˈx a ɡ w a
Aija	ˈa i x a
tolteca	t o l ˈt e k a
bahaísmo	b a a ˈi s m o
adúltera	a ˈd u l t e ɾ a
fonda	ˈf o n d a
andáis	a n ˈd a i s
impetrado	i m p e ˈt ɾ a d o
inopia	i ˈn o p j a
soleada	s o l e ˈa d a
compensaras	k o m p e n ˈs a ɾ a s
dictablanda	d i ɡ t a ˈb l a n d a
lentificado	l e n t i f i ˈk a d o
secuestrador	s e k w e s t ɾ a ˈd o ɾ
fotografiados	f o t o ɡ ɾ a ˈf j a d o s
escuadronados	e s k w a d ɾ o ˈn a d o s
deputaste	d e p u ˈt a s t e
ecléctico	e ˈk l e ɡ t i k o
sinostosis	s i n o s ˈt o s i s
convocados	k o m b o ˈk a d o s
distintiva	d i s t i n ˈt i b a
jacobita	x a k o ˈb i t a
gilipollas	x i l i ˈp o ʝ a s
crie	ˈk ɾ j e
tijereteo	t i x e ɾ e ˈt e o
latín	l a ˈt i n
sobrevalorada	s o b ɾ e b a l o ˈɾ a d a
codescubierto	k o d e s k u ˈb j e ɾ t o
gravitada	ɡ ɾ a b i ˈt a d a
sobrecoger	s o b ɾ e k o ˈx e ɾ
reforjar	r e f o ɾ ˈx a ɾ
reputar	r e p u ˈt a ɾ
glosara	ɡ l o ˈs a ɾ a
rabiada	r a ˈb j a d a
forro	ˈf o r o
runa	ˈr u n a
vieran	ˈb j e ɾ a n
Yoro	ˈʝ o ɾ o
comprensible	k o m p ɾ e n ˈs i b l e
arbitramento	a ɾ b i t ɾ a ˈm e n t o
reintentar	r e i n t e n ˈt a ɾ
coqueteado	k o k e t e ˈa d o
seriada	s e ˈɾ j a d a
revoleada	r e b o l e ˈa d a
destocadas	d e s t o ˈk a d a s
ovejera	o b e ˈx e ɾ a
minamos	m i ˈn a m o s
gin	ˈʝ i n
lobulillar	l o b u l i ˈʝ a ɾ
enterrares	e n t e ˈr a ɾ e s
obsoleta	o b s o ˈl e t a
chisporroteado	t͡ʃ i s p o r o t e ˈa d o
rehogar	r e o ˈɡ a ɾ
burkinesa	b u ɾ k i ˈn e s a
triángulos	ˈt ɾ j a n ɡ u l o s
don	ˈd o n
llegue	ˈʝ e ɡ e
catadióptrico	k a t a ˈd j o b t ɾ i k o
legitimando	l e x i t i ˈm a n d o
testadas	t e s ˈt a d a s
yaresaní	ʝ a ɾ e s a ˈn i
jurídico	x u ˈɾ i d i k o
huno	ˈu n o
palmita	p a l ˈm i t a
ubérrimos	u ˈb e r i m o s
movemos	m o ˈb e m o s
rufa	ˈr u f a
socarronería	s o k a r o n e ˈɾ i a
cultivo	k u l ˈt i b o
desmontados	d e s m o n ˈt a d o s
voleada	b o l e ˈa d a
premonitoria	p ɾ e m o n i ˈt o ɾ j a
rasgueado	r a s ɡ e ˈa d o
semisedentario	s e m i s e d e n ˈt a ɾ j o
afecta	a ˈf e ɡ t a
titiriteadlo	t i t i ɾ i t e ˈa d l o
Tarso	ˈt a ɾ s o
escolta	e s ˈk o l t a
mandamiento	m a n d a ˈm j e n t o
santimonia	s a n t i ˈm o n j a
ojeado	o x e ˈa d o
has	ˈa s
oaxaqueño	w̝ a x a ˈk e ɲ o
Hawái	x a ˈw a i
adiposa	a d i ˈp o s a
humanas	u ˈm a n a s
tético	ˈt e t i k o
bastitanas	b a s t i ˈt a n a s
cofre	ˈk o f ɾ e
morigerador	m o ɾ i x e ɾ a ˈd o ɾ
lustrados	l u s ˈt ɾ a d o s
cremallera	k ɾ e m a ˈʝ e ɾ a
virará	b i ɾ a ˈɾ a
ejemplo	e ˈx e m p l o
metra	ˈm e t ɾ a
jactá	x a ɡ ˈt a
desescombrado	d e s e s k o m ˈb ɾ a d o
vetándoles	b e ˈt a n d o l e s
bodegonista	b o d e ɡ o ˈn i s t a
ups	ˈu b s
catalogadora	k a t a l o ɡ a ˈd o ɾ a
daríamos	d a ˈɾ i a m o s
amenguados	a m e n ˈɡ w a d o s
manométricas	m a n o ˈm e t ɾ i k a s
urbano	u ɾ ˈb a n o
pastes	ˈp a s t e s
garabateada	ɡ a ɾ a b a t e ˈa d a
limpiador	l i m p j a ˈd o ɾ
novelístico	n o b e ˈl i s t i k o
desplegar	d e s p l e ˈɡ a ɾ
heredar	e ɾ e ˈd a ɾ
cabreada	k a b ɾ e ˈa d a
ufanados	u f a ˈn a d o s
snorkel	e s ˈn o ɾ k e l
haríamos	a ˈɾ i a m o s
hidroterápico	i d ɾ o t e ˈɾ a p i k o
mara	ˈm a ɾ a
catinona	k a t i ˈn o n a
ilinoisiano	i l i n o i ˈs j a n o
tuberosidad	t u b e ɾ o s i ˈd a d
escoltada	e s k o l ˈt a d a
lisonjero	l i s o n ˈx e ɾ o
nitrificara	n i t ɾ i f i ˈk a ɾ a
guindar	ɡ i n ˈd a ɾ
juntillo	x u n ˈt i ʝ o
trapito	t ɾ a ˈp i t o
afiebrada	a f j e ˈb ɾ a d a
Blas	ˈb l a s
embalemos	e m b a ˈl e m o s
oncogénesis	o n k o ˈx e n e s i s
conversando	k o m b e ɾ ˈs a n d o
brutalidad	b ɾ u t a l i ˈd a d
colombina	k o l o m ˈb i n a
verija	b e ˈɾ i x a
comidilla	k o m i ˈd i ʝ a
chinchilla	t͡ʃ i n ˈt͡ʃ i ʝ a
muerteabas	m w e ɾ t e ˈa b a s
tascas	ˈt a s k a s
desatendidas	d e s a t e n ˈd i d a s
embargadas	e m b a ɾ ˈɡ a d a s
imam	i ˈm a m
xerografiados	s e ɾ o ɡ ɾ a ˈf j a d o s
parametrar	p a ɾ a m e ˈt ɾ a ɾ
psicoterapias	s i k o t e ˈɾ a p j a s
columbrado	k o l u m ˈb ɾ a d o
embragadas	e m b ɾ a ˈɡ a d a s
monárquica	m o ˈn a ɾ k i k a
radiculopatías	r a d i k u l o p a ˈt i a s
designado	d e s i ɡ ˈn a d o
angloamericanas	a n ɡ l o a m e ɾ i ˈk a n a s
acometerás	a k o m e t e ˈɾ a s
forradito	f o r a ˈd i t o
epigastralgia	e p i ɡ a s ˈt ɾ a l x j a
alcoyanas	a l k o ˈʝ a n a s
permutarás	p e ɾ m u t a ˈɾ a s
homofóbicas	o m o ˈf o b i k a s
monocromo	m o n o ˈk ɾ o m o
tache	ˈt a t͡ʃ e
mielodisplasia	m j e l o d i s ˈp l a s j a
comparabilidad	k o m p a ɾ a b i l i ˈd a d
enes	ˈe n e s
formaldehido	f o ɾ m a l ˈd e i d o
pekinesas	p e k i ˈn e s a s
espíritu	e s ˈp i ɾ i t u
Marsella	m a ɾ ˈs e ʝ a
aserrados	a s e ˈr a d o s
envolver	e m b o l ˈb e ɾ
tests	ˈt e s t s
connatural	k o n n a t u ˈɾ a l
ricos	ˈr i k o s
desentender	d e s e n t e n ˈd e ɾ
hidrográfico	i d ɾ o ˈɡ ɾ a f i k o
desosada	d e s o ˈs a d a
vasca	ˈb a s k a
remara	r e ˈm a ɾ a
sustentar	s u s t e n ˈt a ɾ
glaseado	ɡ l a s e ˈa d o
genuino	x e ˈn w i n o
eclipsará	e k l i b s a ˈɾ a
caudillo	k a u ˈd i ʝ o
depósitos	d e ˈp o s i t o s
desbotonar	d e s b o t o ˈn a ɾ
Laurel	l a u ˈɾ e l
labial	l a ˈb j a l
emisión	e m i ˈs j o n
Emanuel	e m a ˈn w e l
suélela	ˈs w e l e l a
glamouroso	ɡ l a m u ˈɾ o s o
ligoteo	l i ɡ o ˈt e o
espectrómetros	e s p e ɡ ˈt ɾ o m e t ɾ o s
mordidas	m o ɾ ˈd i d a s
deltana	d e l ˈt a n a
monitorear	m o n i t o ɾ e ˈa ɾ
disyuntor	d i s ʝ u n ˈt o ɾ
aminopeptidasa	a m i n o p e b t i ˈd a s a
horripilados	o r i p i ˈl a d o s
italófonos	i t a ˈl o f o n o s
crac	ˈk ɾ a k
definiríamos	d e f i n i ˈɾ i a m o s
acabareis	a k a ˈb a ɾ e i s
cuidando	k w i ˈd a n d o
trigarante	t ɾ i ɡ a ˈɾ a n t e
paleáramos	p a l e ˈa ɾ a m o s
rutina	r u ˈt i n a
catuaba	k a ˈt w a b a
compensadas	k o m p e n ˈs a d a s
enfriadero	e n f ɾ j a ˈd e ɾ o
cablegrafiadas	k a b l e ɡ ɾ a ˈf j a d a s
recalculamos	r e k a l k u ˈl a m o s
turistificados	t u ɾ i s t i f i ˈk a d o s
autoaislarse	a u t o a i s ˈl a ɾ s e
siamesas	s j a ˈm e s a s
decano	d e ˈk a n o
regeneras	r e x e ˈn e ɾ a s
hables	ˈa b l e s
bala	ˈb a l a
nectáreas	n e ɡ ˈt a ɾ e a s
englobadas	e n ɡ l o ˈb a d a s
sublimado	s u b l i ˈm a d o
adehesar	a d e e ˈs a ɾ
andén	a n ˈd e n
estarles	e s ˈt a ɾ l e s
desbaratadas	d e s b a ɾ a ˈt a d a s
mercurio	m e ɾ ˈk u ɾ j o
amargosa	a m a ɾ ˈɡ o s a
tenías	t e ˈn i a s
cautiva	k a u ˈt i b a
Carbajal	k a ɾ b a ˈx a l
taheño	t a ˈe ɲ o
acondroplasia	a k o n d ɾ o ˈp l a s j a
vedarme	b e ˈd a ɾ m e
calabriadas	k a l a ˈb ɾ j a d a s
contraatacar	k o n t ɾ a a t a ˈk a ɾ
irradiante	i r a ˈd j a n t e
trasliteradas	t ɾ a s l i t e ˈɾ a d a s
equilibrador	e k i l i b ɾ a ˈd o ɾ
lenón	l e ˈn o n
latué	l a ˈt w e
calda	ˈk a l d a
reagrupamiento	r e a ɡ ɾ u p a ˈm j e n t o
periné	p e ɾ i ˈn e
nalidíxico	n a l i ˈd i ɡ s i k o
Ramona	r a ˈm o n a
lamelar	l a m e ˈl a ɾ
apararás	a p a ɾ a ˈɾ a s
haríais	a ˈɾ i a i s
yago	ˈʝ a ɡ o
indómitas	i n ˈd o m i t a s
sobrevaluado	s o b ɾ e b a ˈl w a d o
tomatico	t o m a ˈt i k o
seriaremos	s e ɾ j a ˈɾ e m o s
germanio	x e ɾ ˈm a n j o
variables	b a ˈɾ j a b l e s
perfume	p e ɾ ˈf u m e
carteadas	k a ɾ t e ˈa d a s
soláis	s o ˈl a i s
perturbados	p e ɾ t u ɾ ˈb a d o s
chapó	t͡ʃ a ˈp o
resoluto	r e s o ˈl u t o
autótrofo	a u ˈt o t ɾ o f o
márfega	ˈm a ɾ f e ɡ a
desprendida	d e s p ɾ e n ˈd i d a
titiladas	t i t i ˈl a d a s
discrepadas	d i s k ɾ e ˈp a d a s
balasto	b a ˈl a s t o
saladería	s a l a d e ˈɾ i a
golpismo	ɡ o l ˈp i s m o
metilé	m e t i ˈl e
arquear	a ɾ k e ˈa ɾ
Ximena	x i ˈm e n a
endotérmicos	e n d o ˈt e ɾ m i k o s
ladrones	l a ˈd ɾ o n e s
nefríticos	n e ˈf ɾ i t i k o s
dentudo	d e n ˈt u d o
libreta	l i ˈb ɾ e t a
sacralidad	s a k ɾ a l i ˈd a d
retrotraer	r e t ɾ o t ɾ a ˈe ɾ
enjugador	e n x u ɡ a ˈd o ɾ
abaluartar	a b a l w a ɾ ˈt a ɾ
abajáremos	a b a ˈx a ɾ e m o s
parsec	p a ɾ ˈs e k
Turín	t u ˈɾ i n
musicología	m u s i k o l o ˈx i a
nasosinusales	n a s o s i n u ˈs a l e s
aojada	a o ˈx a d a
compurgamos	k o m p u ɾ ˈɡ a m o s
vimos	ˈb i m o s
anfipáticos	a n f i ˈp a t i k o s
polígloto	p o ˈl i ɡ l o t o
aclimata	a k l i ˈm a t a
sanguinolentos	s a n ɡ i n o ˈl e n t o s
significamos	s i ɡ n i f i ˈk a m o s
mericarpio	m e ɾ i ˈk a ɾ p j o
sufragados	s u f ɾ a ˈɡ a d o s
inculta	i n ˈk u l t a
abate	a ˈb a t e
soleros	s o ˈl e ɾ o s
lerdo	ˈl e ɾ d o
enemistar	e n e m i s ˈt a ɾ
distributario	d i s t ɾ i b u ˈt a ɾ j o
cómanme	ˈk o m a m m e
leudo	ˈl e u d o
pitas	ˈp i t a s
difónicas	d i ˈf o n i k a s
bucólico	b u ˈk o l i k o
pocotón	p o k o ˈt o n
habláramos	a ˈb l a ɾ a m o s
ándelas	ˈa n d e l a s
provicario	p ɾ o b i ˈk a ɾ j o
inmunoalérgicos	i m m u n o a ˈl e ɾ x i k o s
suyos	ˈs u ʝ o s
salón	s a ˈl o n
soler	s o ˈl e ɾ
estereotípicos	e s t e ɾ e o ˈt i p i k o s
adietado	a d j e ˈt a d o
Batlle	ˈb a ʝ e
boyero	b o ˈʝ e ɾ o
entesitis	e n t e ˈs i t i s
enumeradas	e n u m e ˈɾ a d a s
inequívoca	i n e ˈk i b o k a
poli	ˈp o l i
ubérrimo	u ˈb e r i m o
Enka	ˈe n k a
Piamonte	p j a ˈm o n t e
venerables	b e n e ˈɾ a b l e s
árbol	ˈa ɾ b o l
agusánese	a ɡ u ˈs a n e s e
dieron	ˈd j e ɾ o n
Gibraltar	x i b ɾ a l ˈt a ɾ
herpético	e ɾ ˈp e t i k o
trascrita	t ɾ a s ˈk ɾ i t a
sicofanta	s i k o ˈf a n t a
hedidas	e ˈd i d a s
regule	r e ˈɡ u l e
twittero	t w i ˈt e ɾ o
percute	p e ɾ ˈk u t e
audión	a u ˈd j o n
sistemáticas	s i s t e ˈm a t i k a s
núcleo	ˈn u k l e o
piridoxina	p i ɾ i d o ɡ ˈs i n a
chingongo	t͡ʃ i n ˈɡ o n ɡ o
escaparate	e s k a p a ˈɾ a t e
proamericanas	p ɾ o a m e ɾ i ˈk a n a s
fenghuang	f e n ˈx w a n
mefistofélico	m e f i s t o ˈf e l i k o
anómalo	a ˈn o m a l o
reme	ˈr e m e
preaviso	p ɾ e a ˈb i s o
chaquetita	t͡ʃ a k e ˈt i t a
desencadenador	d e s e n k a d e n a ˈd o ɾ
consenso	k o n ˈs e n s o
cracoviano	k ɾ a k o ˈb j a n o
apenaremos	a p e n a ˈɾ e m o s
Ardenas	a ɾ ˈd e n a s
reproductivas	r e p ɾ o d u ɡ ˈt i b a s
delineares	d e l i n e ˈa ɾ e s
bregue	ˈb ɾ e ɡ e
frecuentadora	f ɾ e k w e n t a ˈd o ɾ a
congelar	k o n x e ˈl a ɾ
abrasaremos	a b ɾ a s a ˈɾ e m o s
coexistir	k o e ɡ s i s ˈt i ɾ
vetaríamos	b e t a ˈɾ i a m o s
axiológico	a ɡ s j o ˈl o x i k o
acompañamiento	a k o m p a ɲ a ˈm j e n t o
mongolito	m o n ɡ o ˈl i t o
tribanda	t ɾ i ˈb a n d a
estenos	e s ˈt e n o s
ahusados	a u ˈs a d o s
hábito	ˈa b i t o
influjo	i n ˈf l u x o
sustantiva	s u s t a n ˈt i b a
sutilidad	s u t i l i ˈd a d
invernante	i m b e ɾ ˈn a n t e
diabólicos	d j a ˈb o l i k o s
védate	ˈb e d a t e
fileteada	f i l e t e ˈa d a
piquigualdo	p i k i ˈɡ w a l d o
cosmópolis	k o s ˈm o p o l i s
segurados	s e ɡ u ˈɾ a d o s
actuales	a ɡ ˈt w a l e s
giras	ˈx i ɾ a s
desprestigiado	d e s p ɾ e s t i ˈx j a d o
escabiador	e s k a b j a ˈd o ɾ
queísmo	k e ˈi s m o
prearmar	p ɾ e a ɾ ˈm a ɾ
asonasteis	a s o ˈn a s t e i s
refulgidas	r e f u l ˈx i d a s
endocrinológicas	e n d o k ɾ i n o ˈl o x i k a s
ultrarreligiosa	u l t ɾ a r e l i ˈx j o s a
marchadas	m a ɾ ˈt͡ʃ a d a s
crónica	ˈk ɾ o n i k a
escaladas	e s k a ˈl a d a s
ampolla	a m ˈp o ʝ a
estampa	e s ˈt a m p a
resguardo	r e s ˈɡ w a ɾ d o
hollejo	o ˈʝ e x o
joderla	x o ˈd e ɾ l a
Crono	ˈk ɾ o n o
anden	ˈa n d e n
auto	ˈa u t o
Shanghái	ʃ a n ˈɡ a i
declamado	d e k l a ˈm a d o
encharcado	e n t͡ʃ a ɾ ˈk a d o
neoyorquino	n e o ʝ o ɾ ˈk i n o
quincuagésimo	k i n k w a ˈx e s i m o
fufada	f u ˈf a d a
Valdemar	b a l d e ˈm a ɾ
laudados	l a u ˈd a d o s
modifico	m o d i ˈf i k o
esquivares	e s k i ˈb a ɾ e s
autocorregido	a u t o k o r e ˈx i d o
dinerario	d i n e ˈɾ a ɾ j o
elamita	e l a ˈm i t a
demente	d e ˈm e n t e
expletiva	e ɡ s p l e ˈt i b a
pésimo	ˈp e s i m o
habrás	a ˈb ɾ a s
Alexópulos	a l e ɡ ˈs o p u l o s
maleada	m a l e ˈa d a
sucursalista	s u k u ɾ s a ˈl i s t a
argentado	a ɾ x e n ˈt a d o
escapado	e s k a ˈp a d o
desportillar	d e s p o ɾ t i ˈʝ a ɾ
microendémico	m i k ɾ o e n ˈd e m i k o
trapera	t ɾ a ˈp e ɾ a
solerlo	s o ˈl e ɾ l o
góndola	ˈɡ o n d o l a
inesperado	i n e s p e ˈɾ a d o
invernaderos	i m b e ɾ n a ˈd e ɾ o s
vesicante	b e s i ˈk a n t e
deteriorante	d e t e ɾ j o ˈɾ a n t e
trabar	t ɾ a ˈb a ɾ
sauna	ˈs a u n a
empoderadas	e m p o d e ˈɾ a d a s
trilineal	t ɾ i l i n e ˈa l
tequilería	t e k i l e ˈɾ i a
petipuá	p e t i ˈp w a
viudita	b j u ˈd i t a
panadería	p a n a d e ˈɾ i a
abaldónense	a b a l ˈd o n e n s e
entallador	e n t a ʝ a ˈd o ɾ
Manáoag	m a ˈn a w a ɡ
cuadril	k w a ˈd ɾ i l
rayo	ˈr a ʝ o
enramada	e n r a ˈm a d a
nacas	ˈn a k a s
sólito	ˈs o l i t o
sopladas	s o ˈp l a d a s
espesas	e s ˈp e s a s
agrillo	a ˈɡ ɾ i ʝ o
banqueteada	b a n k e t e ˈa d a
autarquía	a u t a ɾ ˈk i a
reparas	r e ˈp a ɾ a s
buscando	b u s ˈk a n d o
cómale	ˈk o m a l e
bolómetros	b o ˈl o m e t ɾ o s
mentada	m e n ˈt a d a
ecología	e k o l o ˈx i a
fornicamos	f o ɾ n i ˈk a m o s
batistianas	b a t i s ˈt j a n a s
moribunda	m o ɾ i ˈb u n d a
empoderante	e m p o d e ˈɾ a n t e
soltamos	s o l ˈt a m o s
papaíto	p a p a ˈi t o
cuatribanda	k w a t ɾ i ˈb a n d a
aguijados	a ɡ i ˈx a d o s
sindical	s i n d i ˈk a l
reflectadas	r e f l e ɡ ˈt a d a s
aviando	a ˈb j a n d o
sujetar	s u x e ˈt a ɾ
desfigurada	d e s f i ɡ u ˈɾ a d a
cal	ˈk a l
díganla	ˈd i ɡ a n l a
triunfo	ˈt ɾ j u n f o
bateadora	b a t e a ˈd o ɾ a
psicofisiología	s i k o f i s j o l o ˈx i a
ludido	l u ˈd i d o
alusivas	a l u ˈs i b a s
escamocha	e s k a ˈm o t͡ʃ a
enturbiar	e n t u ɾ ˈb j a ɾ
enfocados	e n f o ˈk a d o s
herbolarias	e ɾ b o ˈl a ɾ j a s
oportunísimo	o p o ɾ t u ˈn i s i m o
golpe	ˈɡ o l p e
comprador	k o m p ɾ a ˈd o ɾ
sobrerrepresentando	s o b ɾ e r e p ɾ e s e n ˈt a n d o
fabuladora	f a b u l a ˈd o ɾ a
percutirá	p e ɾ k u t i ˈɾ a
suegra	ˈs w e ɡ ɾ a
golpeteasen	ɡ o l p e t e ˈa s e n
escrutados	e s k ɾ u ˈt a d o s
cromosoma	k ɾ o m o ˈs o m a
engelamiento	e n x e l a ˈm j e n t o
vagar	b a ˈɡ a ɾ
pedorreadas	p e d o r e ˈa d a s
huaco	ˈw̝ a k o
hidroeléctrico	i d ɾ o e ˈl e ɡ t ɾ i k o
cuatrimestral	k w a t ɾ i m e s ˈt ɾ a l
conjurar	k o n x u ˈɾ a ɾ
multicolinealidad	m u l t i k o l i n e a l i ˈd a d
actitudinal	a ɡ t i t u d i ˈn a l
desdoblado	d e s d o ˈb l a d o
trombón	t ɾ o m ˈb o n
dentudos	d e n ˈt u d o s
etnologías	e d n o l o ˈx i a s
plastificaríamos	p l a s t i f i k a ˈɾ i a m o s
pesquise	p e s ˈk i s e
cadaverosa	k a d a b e ˈɾ o s a
agüé	a ˈɡ w e
chapurreados	t͡ʃ a p u r e ˈa d o s
mentirosa	m e n t i ˈɾ o s a
codificado	k o d i f i ˈk a d o
fornicada	f o ɾ n i ˈk a d a
diosa	ˈd j o s a
refrendadas	r e f ɾ e n ˈd a d a s
cocotes	k o ˈk o t e s
desagradadas	d e s a ɡ ɾ a ˈd a d a s
profusos	p ɾ o ˈf u s o s
morgue	ˈm o ɾ ɡ e
parlas	ˈp a ɾ l a s
contemplada	k o n t e m ˈp l a d a
Montellano	m o n t e ˈʝ a n o
propulsoras	p ɾ o p u l ˈs o ɾ a s
recontadas	r e k o n ˈt a d a s
mensurar	m e n s u ˈɾ a ɾ
escandio	e s ˈk a n d j o
desensillar	d e s e n s i ˈʝ a ɾ
puros	ˈp u ɾ o s
fauna	ˈf a u n a
ninguno	n i n ˈɡ u n o
idilio	i ˈd i l j o
disputáramos	d i s p u ˈt a ɾ a m o s
Mauro	ˈm a u ɾ o
baratadas	b a ɾ a ˈt a d a s
tornados	t o ɾ ˈn a d o s
grieta	ˈɡ ɾ j e t a
alojar	a l o ˈx a ɾ
angulados	a n ɡ u ˈl a d o s
pintadas	p i n ˈt a d a s
gentilhombre	x e n t i ˈl o m b ɾ e
penetrado	p e n e ˈt ɾ a d o
acojonadas	a k o x o ˈn a d a s
conejillo	k o n e ˈx i ʝ o
avasallados	a b a s a ˈʝ a d o s
remojadas	r e m o ˈx a d a s
cantarilla	k a n t a ˈɾ i ʝ a
trincadas	t ɾ i n ˈk a d a s
acabémosla	a k a ˈb e m o s l a
sobresaltar	s o b ɾ e s a l ˈt a ɾ
arrollados	a r o ˈʝ a d o s
rompidos	r o m ˈp i d o s
Himalaya	i m a ˈl a ʝ a
absteniéndome	a b s t e ˈn j e n d o m e
imantadas	i m a n ˈt a d a s
ova	ˈo b a
acatados	a k a ˈt a d o s
Cordillera	k o ɾ d i ˈʝ e ɾ a
precapitalista	p ɾ e k a p i t a ˈl i s t a
rafaelino	r a f a e ˈl i n o
flaubertianas	f l o b e ɾ ˈt j a n a s
caucásico	k a u ˈk a s i k o
abejorro	a b e ˈx o r o
falsedad	f a l s e ˈd a d
melada	m e ˈl a d a
deludir	d e l u ˈd i ɾ
programada	p ɾ o ɡ ɾ a ˈm a d a
estaño	e s ˈt a ɲ o
magenta	m a ˈx e n t a
ionosfera	ʝ o n o s ˈf e ɾ a
amén	a ˈm e n
respiré	r e s p i ˈɾ e
guijuelenses	ɡ i x w e ˈl e n s e s
atenidos	a t e ˈn i d o s
terraplenados	t e r a p l e ˈn a d o s
candelabro	k a n d e ˈl a b ɾ o
deputáis	d e p u ˈt a i s
ves	ˈb e s
entrevenidas	e n t ɾ e b e ˈn i d a s
empadronamiento	e m p a d ɾ o n a ˈm j e n t o
dinamita	d i n a ˈm i t a
lastimar	l a s t i ˈm a ɾ
emigrados	e m i ˈɡ ɾ a d o s
desgarrante	d e s ɡ a ˈr a n t e
muertitas	m w e ɾ ˈt i t a s
completamos	k o m p l e ˈt a m o s
guerrilla	ɡ e ˈr i ʝ a
remoloneada	r e m o l o n e ˈa d a
abnegamos	a b n e ˈɡ a m o s
convergidos	k o m b e ɾ ˈx i d o s
incumbidas	i n k u m ˈb i d a s
gerontóloga	x e ɾ o n ˈt o l o ɡ a
Yerena	ʝ e ˈɾ e n a
relampaguee	r e l a m p a ˈɡ e e
maltratar	m a l t ɾ a ˈt a ɾ
estudio	e s ˈt u d j o
cohetón	k o e ˈt o n
plebeyo	p l e ˈb e ʝ o
desgarres	d e s ˈɡ a r e s
trol	ˈt ɾ o l
cantalupo	k a n t a ˈl u p o
limada	l i ˈm a d a
protesta	p ɾ o ˈt e s t a
vieres	ˈb j e ɾ e s
corsé	k o ɾ ˈs e
chequeados	t͡ʃ e k e ˈa d o s
súcubo	ˈs u k u b o
aldónico	a l ˈd o n i k o
espongiforme	e s p o n x i ˈf o ɾ m e
torpedeamos	t o ɾ p e d e ˈa m o s
atenido	a t e ˈn i d o
califato	k a l i ˈf a t o
desarbolar	d e s a ɾ b o ˈl a ɾ
chistorra	t͡ʃ i s ˈt o r a
guineocuatoriano	ɡ i n e o k w a t o ˈɾ j a n o
aprendida	a p ɾ e n ˈd i d a
Honiara	x o ˈn j a ɾ a
espantoso	e s p a n ˈt o s o
cagarse	k a ˈɡ a ɾ s e
espejado	e s p e ˈx a d o
cumplimentados	k u m p l i m e n ˈt a d o s
foto	ˈf o t o
abaldonaros	a b a l d o ˈn a ɾ o s
panhelénico	p a n e ˈl e n i k o
Espinal	e s p i ˈn a l
calibrada	k a l i ˈb ɾ a d a
dominicas	d o m i ˈn i k a s
altivo	a l ˈt i b o
gastrina	ɡ a s ˈt ɾ i n a
parlamentarios	p a ɾ l a m e n ˈt a ɾ j o s
endrogado	e n d ɾ o ˈɡ a d o
inhabitable	i n a b i ˈt a b l e
alavesista	a l a b e ˈs i s t a
Putumayo	p u t u ˈm a ʝ o
mostraríamos	m o s t ɾ a ˈɾ i a m o s
fardadas	f a ɾ ˈd a d a s
psicodélicas	s i k o ˈd e l i k a s
fundidas	f u n ˈd i d a s
gangueo	ɡ a n ˈɡ e o
retornado	r e t o ɾ ˈn a d o
dividimos	d i b i ˈd i m o s
seríamos	s e ˈɾ i a m o s
polirritmia	p o l i ˈr i d m j a
seamos	s e ˈa m o s
purgado	p u ɾ ˈɡ a d o
futuro	f u ˈt u ɾ o
organismo	o ɾ ɡ a ˈn i s m o
rotular	r o t u ˈl a ɾ
bioéticas	b i o ˈe t i k a s
intransigentes	i n t ɾ a n s i ˈx e n t e s
ningunos	n i n ˈɡ u n o s
equidades	e k i ˈd a d e s
acompañada	a k o m p a ˈɲ a d a
rubéola	r u ˈb e o l a
erótica	e ˈɾ o t i k a
calor	k a ˈl o ɾ
puritanas	p u ɾ i ˈt a n a s
microbiológicos	m i k ɾ o b j o ˈl o x i k o s
empatados	e m p a ˈt a d o s
degradados	d e ɡ ɾ a ˈd a d o s
amnésica	a m ˈn e s i k a
digestible	d i x e s ˈt i b l e
columnela	k o l u m ˈn e l a
alboreada	a l b o ɾ e ˈa d a
pastillita	p a s t i ˈʝ i t a
anteanoche	a n t e a ˈn o t͡ʃ e
Higüey	i ˈɡ w e i
latino	l a ˈt i n o
tajantemente	t a ˌx a n t e ˈm e n t e
Boluarte	b o ˈl w a ɾ t e
espeso	e s ˈp e s o
róbalo	ˈr o b a l o
abastáramos	a b a s ˈt a ɾ a m o s
gavetero	ɡ a b e ˈt e ɾ o
comuniques	k o m u ˈn i k e s
entrevistadores	e n t ɾ e b i s t a ˈd o ɾ e s
explayados	e ɡ s p l a ˈʝ a d o s
autobombeados	a u t o b o m b e ˈa d o s
lubrificá	l u b ɾ i f i ˈk a
destupir	d e s t u ˈp i ɾ
posromántico	p o s r o ˈm a n t i k o
acobardara	a k o b a ɾ ˈd a ɾ a
alienarás	a l j e n a ˈɾ a s
perjuro	p e ɾ ˈx u ɾ o
parador	p a ɾ a ˈd o ɾ
grillar	ɡ ɾ i ˈʝ a ɾ
pavonearse	p a b o n e ˈa ɾ s e
abacoras	a b a ˈk o ɾ a s
sintomáticas	s i n t o ˈm a t i k a s
peraltadas	p e ɾ a l ˈt a d a s
cantante	k a n ˈt a n t e
belfo	ˈb e l f o
aspecto	a s ˈp e ɡ t o
cosido	k o ˈs i d o
gasas	ˈɡ a s a s
tentativa	t e n t a ˈt i b a
recostados	r e k o s ˈt a d o s
algodonadas	a l ɡ o d o ˈn a d a s
vestidura	b e s t i ˈd u ɾ a
gasánida	ɡ a ˈs a n i d a
nosología	n o s o l o ˈx i a
vidriero	b i ˈd ɾ j e ɾ o
catadas	k a ˈt a d a s
debámosla	d e ˈb a m o s l a
xaminí	s a m i ˈn i
trofoblasto	t ɾ o f o ˈb l a s t o
agostino	a ɡ o s ˈt i n o
siembra	ˈs j e m b ɾ a
rebuscado	r e b u s ˈk a d o
rascador	r a s k a ˈd o ɾ
hollado	o ˈʝ a d o
criaturita	k ɾ j a t u ˈɾ i t a
llamémosla	ʝ a ˈm e m o s l a
argentina	a ɾ x e n ˈt i n a
verberada	b e ɾ b e ˈɾ a d a
unir	u ˈn i ɾ
envión	e m ˈb j o n
mixturamos	m i ɡ s t u ˈɾ a m o s
lapo	ˈl a p o
yodurar	ʝ o d u ˈɾ a ɾ
fechemos	f e ˈt͡ʃ e m o s
rockismo	r o ˈk i s m o
vinculantes	b i n k u ˈl a n t e s
expiado	e ɡ s ˈp j a d o
enjertal	e n x e ɾ ˈt a l
velaríais	b e l a ˈɾ i a i s
rabel	r a ˈb e l
grapo	ˈɡ ɾ a p o
implementadas	i m p l e m e n ˈt a d a s
morir	m o ˈɾ i ɾ
enviar	e m ˈb j a ɾ
paulino	p a u ˈl i n o
coventículo	k o b e n ˈt i k u l o
divisadas	d i b i ˈs a d a s
invisible	i m b i ˈs i b l e
deletreada	d e l e t ɾ e ˈa d a
ruinado	r w i ˈn a d o
tortures	t o ɾ ˈt u ɾ e s
frustrando	f ɾ u s ˈt ɾ a n d o
barda	ˈb a ɾ d a
ponchadora	p o n t͡ʃ a ˈd o ɾ a
trilema	t ɾ i ˈl e m a
finco	ˈf i n k o
chucho	ˈt͡ʃ u t͡ʃ o
desajustada	d e s a x u s ˈt a d a
gusto	ˈɡ u s t o
predictibilidad	p ɾ e d i ɡ t i b i l i ˈd a d
distorsionado	d i s t o ɾ s j o ˈn a d o
charquito	t͡ʃ a ɾ ˈk i t o
alargamiento	a l a ɾ ɡ a ˈm j e n t o
toltecas	t o l ˈt e k a s
perpetua	p e ɾ ˈp e t w a
Helios	ˈe l j o s
deltoidal	d e l t o i ˈd a l
resaltar	r e s a l ˈt a ɾ
vivaqueada	b i b a k e ˈa d a
iqueñas	i ˈk e ɲ a s
marcares	m a ɾ ˈk a ɾ e s
habiéndole	a ˈb j e n d o l e
codifiques	k o d i ˈf i k e s
autodestruidas	a u t o d e s ˈt ɾ w i d a s
limitadora	l i m i t a ˈd o ɾ a
posesivos	p o s e ˈs i b o s
cloroalquino	k l o ɾ o a l ˈk i n o
leías	l e ˈi a s
necrólisis	n e ˈk ɾ o l i s i s
triangulará	t ɾ j a n ɡ u l a ˈɾ a
desafortunado	d e s a f o ɾ t u ˈn a d o
recolectadas	r e k o l e ɡ ˈt a d a s
angelino	a n x e ˈl i n o
abacoraseis	a b a k o ˈɾ a s e i s
avenasen	a b e ˈn a s e n
Chañaral	t͡ʃ a ɲ a ˈɾ a l
alienante	a l j e ˈn a n t e
trombina	t ɾ o m ˈb i n a
descocarse	d e s k o ˈk a ɾ s e
contenidos	k o n t e ˈn i d o s
canoero	k a n o ˈe ɾ o
autodelatando	a u t o d e l a ˈt a n d o
abejón	a b e ˈx o n
ahechados	a e ˈt͡ʃ a d o s
lavando	l a ˈb a n d o
íncola	ˈi n k o l a
abandonamiento	a b a n d o n a ˈm j e n t o
arrullo	a ˈr u ʝ o
concatenar	k o n k a t e ˈn a ɾ
acuanautas	a k w a ˈn a u t a s
psíquico	ˈs i k i k o
mineróloga	m i n e ˈɾ o l o ɡ a
alcano	a l ˈk a n o
surreal	s u r e ˈa l
ruteo	r u ˈt e o
solaré	s o l a ˈɾ e
deberéis	d e b e ˈɾ e i s
falisco	f a ˈl i s k o
contornaríamos	k o n t o ɾ n a ˈɾ i a m o s
taco	ˈt a k o
elaborados	e l a b o ˈɾ a d o s
exportaste	e ɡ s p o ɾ ˈt a s t e
peligro	p e ˈl i ɡ ɾ o
fútil	ˈf u t i l
augurada	a u ɡ u ˈɾ a d a
abarrotado	a b a r o ˈt a d o
conversara	k o m b e ɾ ˈs a ɾ a
aventada	a b e n ˈt a d a
personificar	p e ɾ s o n i f i ˈk a ɾ
raídas	r a ˈi d a s
narval	n a ɾ ˈb a l
austera	a u s ˈt e ɾ a
baremados	b a ɾ e ˈm a d o s
mosquear	m o s k e ˈa ɾ
amurar	a m u ˈɾ a ɾ
polonesas	p o l o ˈn e s a s
embarulladas	e m b a ɾ u ˈʝ a d a s
estrígiles	e s ˈt ɾ i x i l e s
descuajar	d e s k w a ˈx a ɾ
camarín	k a m a ˈɾ i n
matasano	m a t a ˈs a n o
reológico	r e o ˈl o x i k o
acometíamos	a k o m e ˈt i a m o s
conectaste	k o n e ɡ ˈt a s t e
piquito	p i ˈk i t o
voleo	b o ˈl e o
et	ˈe t
bicroma	b i ˈk ɾ o m a
arará	a ɾ a ˈɾ a
serigrafiado	s e ɾ i ɡ ɾ a ˈf j a d o
ondulado	o n d u ˈl a d o
liminares	l i m i ˈn a ɾ e s
curvare	k u ɾ ˈb a ɾ e
extensas	e ɡ s ˈt e n s a s
ameba	a ˈm e b a
constatable	k o n s t a ˈt a b l e
alfaque	a l ˈf a k e
oh	ˈo
otolito	o t o ˈl i t o
pelillo	p e ˈl i ʝ o
neumoconiosis	n e u m o k o ˈn j o s i s
extermino	e ɡ s t e ɾ ˈm i n o
indignidad	i n d i ɡ n i ˈd a d
adherir	a d e ˈɾ i ɾ
procurares	p ɾ o k u ˈɾ a ɾ e s
endocraneano	e n d o k ɾ a n e ˈa n o
horneadas	o ɾ n e ˈa d a s
Torralba	t o ˈr a l b a
pseudohistoria	s e u d o i s ˈt o ɾ j a
chontaduro	t͡ʃ o n t a ˈd u ɾ o
Inesita	i n e ˈs i t a
Cantórbery	k a n ˈt o ɾ b e ɾ i
logradas	l o ˈɡ ɾ a d a s
lubrifico	l u b ɾ i ˈf i k o
cuasidelito	k w a s i d e ˈl i t o
mártaga	ˈm a ɾ t a ɡ a
fantasmagóricos	f a n t a s m a ˈɡ o ɾ i k o s
colegida	k o l e ˈx i d a
aquilón	a k i ˈl o n
proverbialmente	p ɾ o ˌb e ɾ b j a l ˈm e n t e
putadita	p u t a ˈd i t a
reintensificado	r e i n t e n s i f i ˈk a d o
viable	ˈb j a b l e
tirón	t i ˈɾ o n
forjadura	f o ɾ x a ˈd u ɾ a
clamadas	k l a ˈm a d a s
Marbella	m a ɾ ˈb e ʝ a
erosionable	e ɾ o s j o ˈn a b l e
amaestrados	a m a e s ˈt ɾ a d o s
melotrón	m e l o ˈt ɾ o n
oxidaras	o ɡ s i ˈd a ɾ a s
monocromáticas	m o n o k ɾ o ˈm a t i k a s
temerá	t e m e ˈɾ a
cantándoles	k a n ˈt a n d o l e s
abastada	a b a s ˈt a d a
remunerativo	r e m u n e ɾ a ˈt i b o
hiperpotasemias	i p e ɾ p o t a ˈs e m j a s
malévolo	m a ˈl e b o l o
psicoactivo	s i k o a ɡ ˈt i b o
personalmente	p e ɾ ˌs o n a l ˈm e n t e
gantés	ɡ a n ˈt e s
popote	p o ˈp o t e
inexplicables	i n e ɡ s p l i ˈk a b l e s
apelada	a p e ˈl a d a
pellín	p e ˈʝ i n
alcana	a l ˈk a n a
afirmativo	a f i ɾ m a ˈt i b o
peña	ˈp e ɲ a
camerístico	k a m e ˈɾ i s t i k o
concordemos	k o n k o ɾ ˈd e m o s
granada	ɡ ɾ a ˈn a d a
regido	r e ˈx i d o
impersonal	i m p e ɾ s o ˈn a l
colorada	k o l o ˈɾ a d a
gráfico	ˈɡ ɾ a f i k o
gobiernito	ɡ o b j e ɾ ˈn i t o
escaneo	e s k a ˈn e o
pluralidades	p l u ɾ a l i ˈd a d e s
embalsado	e m b a l ˈs a d o
retrucaste	r e t ɾ u ˈk a s t e
confesora	k o n f e ˈs o ɾ a
subscriptos	s u b s ˈk ɾ i b t o s
torrada	t o ˈr a d a
cadaverina	k a d a b e ˈɾ i n a
desacoplar	d e s a k o ˈp l a ɾ
riñón	r i ˈɲ o n
alante	a ˈl a n t e
blando	ˈb l a n d o
operativo	o p e ɾ a ˈt i b o
autoconvocarse	a u t o k o m b o ˈk a ɾ s e
concuñada	k o n k u ˈɲ a d a
adores	a ˈd o ɾ e s
recurvadas	r e k u ɾ ˈb a d a s
simulado	s i m u ˈl a d o
optrónico	o b ˈt ɾ o n i k o
bayuca	b a ˈʝ u k a
quimioterápico	k i m j o t e ˈɾ a p i k o
potasemia	p o t a ˈs e m j a
quinario	k i ˈn a ɾ j o
cansada	k a n ˈs a d a
frustrar	f ɾ u s ˈt ɾ a ɾ
reptado	r e b ˈt a d o
agotado	a ɡ o ˈt a d o
crocodiliforme	k ɾ o k o d i l i ˈf o ɾ m e
islandeses	i s l a n ˈd e s e s
administráramos	a d m i n i s ˈt ɾ a ɾ a m o s
bastoneadas	b a s t o n e ˈa d a s
deputemos	d e p u ˈt e m o s
ventilada	b e n t i ˈl a d a
minúscula	m i ˈn u s k u l a
baremado	b a ɾ e ˈm a d o
declarares	d e k l a ˈɾ a ɾ e s
develado	d e b e ˈl a d o
según	s e ˈɡ u n
dihueñe	d i ˈw e ɲ e
carpinteril	k a ɾ p i n t e ˈɾ i l
apetitosa	a p e t i ˈt o s a
leoninos	l e o ˈn i n o s
piscucha	p i s ˈk u t͡ʃ a
compara	k o m ˈp a ɾ a
Luis	ˈl w i s
pelador	p e l a ˈd o ɾ
toloache	t o l o ˈa t͡ʃ e
sed	ˈs e d
abluidas	a ˈb l w i d a s
fincares	f i n ˈk a ɾ e s
beldar	b e l ˈd a ɾ
fiteogeográfico	f i t e o x e o ˈɡ ɾ a f i k o
frenéticamente	f ɾ e ˌn e t i k a ˈm e n t e
koala	k o ˈa l a
escamotear	e s k a m o t e ˈa ɾ
recalibradas	r e k a l i ˈb ɾ a d a s
contristado	k o n t ɾ i s ˈt a d o
rictus	ˈr i ɡ t u s
hinchar	i n ˈt͡ʃ a ɾ
termine	t e ɾ ˈm i n e
cómanle	ˈk o m a n l e
respaldados	r e s p a l ˈd a d o s
diamantino	d j a m a n ˈt i n o
ilegitimidad	i l e x i t i m i ˈd a d
bandejita	b a n d e ˈx i t a
hebrero	e ˈb ɾ e ɾ o
ostión	o s ˈt j o n
titiritéele	t i t i ɾ i ˈt e e l e
euromonedero	e u ɾ o m o n e ˈd e ɾ o
marinado	m a ɾ i ˈn a d o
sonados	s o ˈn a d o s
vetaste	b e ˈt a s t e
eón	e ˈo n
ectópica	e ɡ ˈt o p i k a
fariano	f a ˈɾ j a n o
fosforilaremos	f o s f o ɾ i l a ˈɾ e m o s
sofocamiento	s o f o k a ˈm j e n t o
arramblados	a r a m ˈb l a d o s
onagro	o ˈn a ɡ ɾ o
temiera	t e ˈm j e ɾ a
embrujada	e m b ɾ u ˈx a d a
consultar	k o n s u l ˈt a ɾ
lacón	l a ˈk o n
transfeminismo	t ɾ a n s f e m i ˈn i s m o
bonarda	b o ˈn a ɾ d a
acontentar	a k o n t e n ˈt a ɾ
contrahechura	k o n t ɾ a e ˈt͡ʃ u ɾ a
bastir	b a s ˈt i ɾ
argüíais	a ɾ ˈɡ w i a i s
enología	e n o l o ˈx i a
usuluteca	u s u l u ˈt e k a
onicomicosis	o n i k o m i ˈk o s i s
donada	d o ˈn a d a
salteado	s a l t e ˈa d o
programa	p ɾ o ˈɡ ɾ a m a
banqueteadas	b a n k e t e ˈa d a s
definimos	d e f i ˈn i m o s
multitudinaria	m u l t i t u d i ˈn a ɾ j a
laudo	ˈl a u d o
postnatal	p o s d n a ˈt a l
incrementada	i n k ɾ e m e n ˈt a d a
apabullados	a p a b u ˈʝ a d o s
talladores	t a ʝ a ˈd o ɾ e s
motilón	m o t i ˈl o n
transparentada	t ɾ a n s p a ɾ e n ˈt a d a
tener	t e ˈn e ɾ
lijadas	l i ˈx a d a s
globalismos	ɡ l o b a ˈl i s m o s
sinoestadounidense	s i n o e s t a d o u n i ˈd e n s e
tejita	t e ˈx i t a
sidonia	s i ˈd o n j a
albugínea	a l b u ˈx i n e a
butronero	b u t ɾ o ˈn e ɾ o
retractados	r e t ɾ a ɡ ˈt a d o s
frustres	ˈf ɾ u s t ɾ e s
biflagelado	b i f l a x e ˈl a d o
anfíbol	a n ˈf i b o l
artesano	a ɾ t e ˈs a n o
Almaguer	a l m a ˈɡ e ɾ
resquebrar	r e s k e ˈb ɾ a ɾ
anestesiaremos	a n e s t e s j a ˈɾ e m o s
morfar	m o ɾ ˈf a ɾ
malentendida	m a l e n t e n ˈd i d a
pendejeadas	p e n d e x e ˈa d a s
teratogénica	t e ɾ a t o ˈx e n i k a
patotero	p a t o ˈt e ɾ o
arromo	a ˈr o m o
densificadas	d e n s i f i ˈk a d a s
ahondada	a o n ˈd a d a
domareis	d o ˈm a ɾ e i s
airado	a i ˈɾ a d o
extendidas	e ɡ s t e n ˈd i d a s
acunados	a k u ˈn a d o s
pluripartidaria	p l u ɾ i p a ɾ t i ˈd a ɾ j a
propendida	p ɾ o p e n ˈd i d a
sincopar	s i n k o ˈp a ɾ
trasmutados	t ɾ a s m u ˈt a d o s
estrafalario	e s t ɾ a f a ˈl a ɾ j o
impala	i m ˈp a l a
bailotear	b a i l o t e ˈa ɾ
chasqueado	t͡ʃ a s k e ˈa d o
criopreservadas	k ɾ j o p ɾ e s e ɾ ˈb a d a s
reseñada	r e s e ˈɲ a d a
varicosos	b a ɾ i ˈk o s o s
incluso	i n ˈk l u s o
data	ˈd a t a
pituco	p i ˈt u k o
skúa	e s ˈk u a
flaco	ˈf l a k o
presentes	p ɾ e ˈs e n t e s
pyme	ˈp i m e
negras	ˈn e ɡ ɾ a s
pegar	p e ˈɡ a ɾ
farmear	f a ɾ m e ˈa ɾ
meditareis	m e d i ˈt a ɾ e i s
combinare	k o m b i ˈn a ɾ e
poso	ˈp o s o
apuntillado	a p u n t i ˈʝ a d o
esculpida	e s k u l ˈp i d a
amoldable	a m o l ˈd a b l e
caos	ˈk a o s
humita	u ˈm i t a
enumerado	e n u m e ˈɾ a d o
transfectar	t ɾ a n s f e ɡ ˈt a ɾ
régimen	ˈr e x i m e n
oíble	o ˈi b l e
piados	ˈp j a d o s
hamdaní	a m d a ˈn i
guíes	ˈɡ i e s
ratificamos	r a t i f i ˈk a m o s
coreografiar	k o ɾ e o ɡ ɾ a ˈf j a ɾ
respuesta	r e s ˈp w e s t a
jachapuri	x a t͡ʃ a ˈp u ɾ i
epodo	e ˈp o d o
grandes	ˈɡ ɾ a n d e s
escudriñadores	e s k u d ɾ i ɲ a ˈd o ɾ e s
psicosomático	s i k o s o ˈm a t i k o
gastárselas	ɡ a s ˈt a ɾ s e l a s
exagera	e ɡ s a ˈx e ɾ a
trovero	t ɾ o ˈb e ɾ o
liberar	l i b e ˈɾ a ɾ
eslabonamiento	e s l a b o n a ˈm j e n t o
yudoca	ʝ u ˈd o k a
quebrantahuesos	k e ˌb ɾ a n t a ˈw e s o s
toreada	t o ɾ e ˈa d a
deambuladas	d e a m b u ˈl a d a s
aparado	a p a ˈɾ a d o
linkbuilding	l i n ɡ ˈb i l d i n
guineoecuatorial	ɡ i n e o e k w a t o ˈɾ j a l
festín	f e s ˈt i n
furtivo	f u ɾ ˈt i b o
codesarrollado	k o d e s a r o ˈʝ a d o
laminaras	l a m i ˈn a ɾ a s
anfipática	a n f i ˈp a t i k a
nerviosamente	n e ɾ ˌb j o s a ˈm e n t e
blocadas	b l o ˈk a d a s
prístinas	ˈp ɾ i s t i n a s
babor	b a ˈb o ɾ
transcurrido	t ɾ a n s k u ˈr i d o
gráfila	ˈɡ ɾ a f i l a
carcanapire	k a ɾ k a n a ˈp i ɾ e
animosas	a n i ˈm o s a s
discreteadas	d i s k ɾ e t e ˈa d a s
suscrito	s u s ˈk ɾ i t o
estaban	e s ˈt a b a n
caravanero	k a ɾ a b a ˈn e ɾ o
homofóbico	o m o ˈf o b i k o
enherbolar	e n e ɾ b o ˈl a ɾ
florido	f l o ˈɾ i d o
transportes	t ɾ a n s ˈp o ɾ t e s
dibujadas	d i b u ˈx a d a s
desaprovechada	d e s a p ɾ o b e ˈt͡ʃ a d a
pterodactiloide	t e ɾ o d a ɡ t i ˈl o i d e
enfurruñados	e n f u r u ˈɲ a d o s
IFE	ˈi f e
dietilo	d j e ˈt i l o
costearíamos	k o s t e a ˈɾ i a m o s
deputaréis	d e p u t a ˈɾ e i s
instigaríamos	i n s t i ɡ a ˈɾ i a m o s
glicosídico	ɡ l i k o ˈs i d i k o
trópicas	ˈt ɾ o p i k a s
avarienta	a b a ˈɾ j e n t a
prometida	p ɾ o m e ˈt i d a
donas	ˈd o n a s
emigrantes	e m i ˈɡ ɾ a n t e s
senador	s e n a ˈd o ɾ
mitin	ˈm i t i n
achaparrada	a t͡ʃ a p a ˈr a d a
pinate	p i ˈn a t e
hipocraterimorfo	i p o k ɾ a t e ɾ i ˈm o ɾ f o
brie	ˈb ɾ i
litio	ˈl i t j o
abdicará	a b d i k a ˈɾ a
fibroso	f i ˈb ɾ o s o
profundidad	p ɾ o f u n d i ˈd a d
enemistada	e n e m i s ˈt a d a
iglesita	i ɡ l e ˈs i t a
amillararemos	a m i ʝ a ɾ a ˈɾ e m o s
pronósticos	p ɾ o ˈn o s t i k o s
carlinga	k a ɾ ˈl i n ɡ a
padouca	p a ˈd o u k a
travestidos	t ɾ a b e s ˈt i d o s
mosaicos	m o ˈs a i k o s
prosterná	p ɾ o s t e ɾ ˈn a
samba	ˈs a m b a
sapa	ˈs a p a
vengados	b e n ˈɡ a d o s
afiladera	a f i l a ˈd e ɾ a
fondeados	f o n d e ˈa d o s
mediodía	m e d j o ˈd i a
batistiana	b a t i s ˈt j a n a
biodinámicos	b i o d i ˈn a m i k o s
ganjifa	ɡ a n ˈx i f a
simplifique	s i m p l i ˈf i k e
falafel	f a l a ˈf e l
notables	n o ˈt a b l e s
endocrino	e n d o ˈk ɾ i n o
brótola	ˈb ɾ o t o l a
choquear	t͡ʃ o k e ˈa ɾ
conecte	k o ˈn e ɡ t e
pocheadas	p o t͡ʃ e ˈa d a s
satisfechísimo	s a t i s f e ˈt͡ʃ i s i m o
amañada	a m a ˈɲ a d a
arponados	a ɾ p o ˈn a d o s
herradero	e r a ˈd e ɾ o
adiabático	a d j a ˈb a t i k o
endodérmico	e n d o ˈd e ɾ m i k o
leyendo	l e ˈʝ e n d o
fagosoma	f a ɡ o ˈs o m a
superaremos	s u p e ɾ a ˈɾ e m o s
transparente	t ɾ a n s p a ˈɾ e n t e
bamba	ˈb a m b a
casto	ˈk a s t o
profanidad	p ɾ o f a n i ˈd a d
esquel	e s ˈk e l
consultaremos	k o n s u l t a ˈɾ e m o s
anadeadas	a n a d e ˈa d a s
secretada	s e k ɾ e ˈt a d a
desgana	d e s ˈɡ a n a
miráculo	m i ˈɾ a k u l o
monegasco	m o n e ˈɡ a s k o
butacón	b u t a ˈk o n
castigable	k a s t i ˈɡ a b l e
calafateados	k a l a f a t e ˈa d o s
cosmovisión	k o s m o b i ˈs j o n
androide	a n ˈd ɾ o i d e
tántalo	ˈt a n t a l o
recopilador	r e k o p i l a ˈd o ɾ
leoninas	l e o ˈn i n a s
copilota	k o p i ˈl o t a
manguera	m a n ˈɡ e ɾ a
acuitados	a k w i ˈt a d o s
atutía	a t u ˈt i a
babeado	b a b e ˈa d o
desinteresado	d e s i n t e ɾ e ˈs a d o
trasparentadas	t ɾ a s p a ɾ e n ˈt a d a s
acostaste	a k o s ˈt a s t e
argumentes	a ɾ ɡ u ˈm e n t e s
escudriñamiento	e s k u d ɾ i ɲ a ˈm j e n t o
marihuanas	m a ɾ i ˈw a n a s
incoar	i n k o ˈa ɾ
abortistas	a b o ɾ ˈt i s t a s
argüiríais	a ɾ ɡ w i ˈɾ i a i s
paleolítico	p a l e o ˈl i t i k o
capuchina	k a p u ˈt͡ʃ i n a
sótano	ˈs o t a n o
santanderista	s a n t a n d e ˈɾ i s t a
tonadilla	t o n a ˈd i ʝ a
quebradita	k e b ɾ a ˈd i t a
modificativas	m o d i f i k a ˈt i b a s
anestesiados	a n e s t e ˈs j a d o s
definitivas	d e f i n i ˈt i b a s
filfa	ˈf i l f a
mucho	ˈm u t͡ʃ o
laboratorial	l a b o ɾ a t o ˈɾ j a l
Amarillo	a m a ˈɾ i ʝ o
alfaques	a l ˈf a k e s
resfriamos	r e s ˈf ɾ j a m o s
auscultares	a u s k u l ˈt a ɾ e s
bohrio	ˈb o ɾ j o
comiéndolo	k o ˈm j e n d o l o
éxtasis	ˈe ɡ s t a s i s
hablaste	a ˈb l a s t e
calvito	k a l ˈb i t o
disfemia	d i s ˈf e m j a
volteriana	b o l t e ˈɾ j a n a
paliada	p a ˈl j a d a
apachurrada	a p a t͡ʃ u ˈr a d a
medallita	m e d a ˈʝ i t a
paniaguado	p a n j a ˈɡ w a d o
lalada	l a ˈl a d a
anchura	a n ˈt͡ʃ u ɾ a
rondeña	r o n ˈd e ɲ a
bordillo	b o ɾ ˈd i ʝ o
codón	k o ˈd o n
prontito	p ɾ o n ˈt i t o
denotara	d e n o ˈt a ɾ a
cocodrila	k o k o ˈd ɾ i l a
