съжалявам	s ɐ ʒ ɐ lʲ a v ɐ m
плюто	p lʲ u t o
небесен	n ɛ b ɛ s ɛ n
гора	ɡ o r a
петдесет	p ɛ d d ɛ s ɛ t
автоблокировка	a f t o b ɫ o kʲ i r ɔ f k ɐ
подробност	p o d r ɔ b n o s t
помислям	p o m i s lʲ ɐ m
зрете	z r ɛ t ɛ
узаконявалият	u z ɐ k o nʲ a v ɐ lʲ i j ɐ t
окрада	o k r ɐ d ɤ
временен	v r ɛ m ɛ n ɛ n
восхищение	v o s xʲ i ʃ t ɛ n i ɛ
ужасия	u ʒ ɐ s i j ɐ
трудоемък	t r u d o ɛ m ɐ k
бавно	b a v n o
павлака	p a v ɫ ɐ k ɐ
мрат	m r ɤ t
списание	s p i s a n i ɛ
понапека	p o n ɐ p ɛ k ɤ
радио	r a d i o
юпитер	j u p i t ɛ r
нетопир	n ɛ t o p i r
забоде	z ɐ b ɔ d ɛ
анализ	ɐ n a lʲ i s
андора	ɐ n d ɔ r ɐ
продам	p r o d a m
лачен	ɫ a t͡ʃ ɛ n
разсед	r ɐ s s ɛ t
глух	ɡ ɫ u x
животи	ʒ i v ɔ t i
селище	s ɛ lʲ i ʃ t ɛ
метър	m ɛ t ɐ r
тарос	t a r o s
сляп	s lʲ a p
агробиолог	a ɡ r o b i o ɫ ɔ k
прегръщам	p r ɛ ɡ r ɤ ʃ t ɐ m
сърцат	s ɐ r t͡s a t
тъпак	t ɐ p a k
колата	k o ɫ a t ɐ
стръмен	s t r ɤ m ɛ n
аршин	ɐ r ʃ i n
събирам	s ɐ b i r ɐ m
октан	o k t a n
безименен	b ɛ z i m ɛ n ɛ n
аджемия	ɐ d ʒ ɛ m i j ɐ
поетеса	p o ɛ t ɛ s ɐ
ама	a m ɐ
гара	ɡ a r ɐ
диван	d i v a n
обичай	o b i t͡ʃ a j
спасяем	s p ɐ sʲ a ɛ m
директор	d i r ɛ k t o r
абдикиралата	ɐ b d i kʲ i r ɐ ɫ ɐ t ɐ
здравеняк	z d r ɐ v ɛ nʲ a k
сутиен	s u t i ɛ n
лабилен	ɫ ɐ b i lʲ ɛ n
назова	n ɐ z o v a
врабче	v r ɐ p t͡ʃ ɛ
агне	a ɡ n ɛ
икона	i k ɔ n ɐ
чешма	t͡ʃ ɛ ʃ m a
албания	ɐ ɫ b a n i j ɐ
викам	v i k ɐ m
автомотриса	a f t o m o t r i s ɐ
извикам	i z v i k ɐ m
корист	k ɔ r i s t
шибам	ʃ i b ɐ m
сияхте	s i j a x t ɛ
узаконявайте	u z ɐ k o nʲ a v ɐ j t ɛ
правист	p r ɐ v i s t
челяд	t͡ʃ ɛ lʲ ɐ t
светиня	s v ɛ t i nʲ ɐ
дреха	d r ɛ x ɐ
скопие	s k ɔ p i ɛ
чуващият	t͡ʃ u v ɐ ʃ t i j ɐ t
получавам	p o ɫ u t͡ʃ a v ɐ m
обиталище	o b i t a lʲ i ʃ t ɛ
пя	pʲ a
плитък	p lʲ i t ɐ k
говорите	ɡ o v ɔ r i t ɛ
ангина	ɐ n ɡʲ i n ɐ
вероятно	v ɛ r o j a t n o
изневяра	i z n ɛ vʲ a r ɐ
празник	p r a z n i k
завлека	z ɐ v lʲ ɛ k ɤ
дърча	d ɤ r t͡ʃ ɐ
британия	b r i t a n i j ɐ
климатик	k lʲ i m ɐ t i k
юфки	j u f kʲ i
ястребов	j a s t r ɛ b o f
ваше	v a ʃ ɛ
пречупвам	p r ɛ t͡ʃ u p v ɐ m
джин	d ʒ i n
протоме	p r o t ɔ m ɛ
физичен	f i z i t͡ʃ ɛ n
прегиня	p r ɛ ɡʲ i nʲ ɐ
мама	m a m ɐ
лекарски	lʲ ɛ k ɐ r s kʲ i
целина	t͡s ɛ lʲ i n a
афера	ɐ f ɛ r ɐ
завеждам	z ɐ v ɛ ʒ d ɐ m
сиях	s i j a x
литература	lʲ i t ɛ r ɐ t u r ɐ
булка	b u ɫ k ɐ
белград	b ɛ ɫ ɡ r ɐ t
смъртник	s m ɤ r t n i k
гъз	ɡ ɤ s
социален	s o t͡s i a lʲ ɛ n
купи	k u p i
препека	p r ɛ p ɛ k ɤ
ушия	u ʃ i j ɐ
неголям	n ɛ ɡ o lʲ ɐ m
лютив	lʲ u t i f
хелий	xʲ ɛ lʲ i
декларация	d ɛ k ɫ ɐ r a t͡s i j ɐ
абдал	ɐ b d a ɫ
бей	b ɛ j
палав	p a ɫ ɐ f
томува	t o m u v ɐ
какъвто	k ɐ k ɤ f t o
наденица	n a d ɛ n i t͡s ɐ
ран	r a n
швейцарски	ʃ v ɛ j t͡s a r s kʲ i
всякога	f sʲ a k o ɡ ɐ
молитва	m o lʲ i t v ɐ
гламав	ɡ ɫ a m ɐ f
киноцентър	kʲ i n o t͡s ɛ n t ɐ r
мед	m ɛ t
вървите	v ɐ r v i t ɛ
желая	ʒ ɛ ɫ a j ɐ
ръждав	r ɐ ʒ d a f
агитпункт	ɐ ɡʲ i t p u n k t
машина	m ɐ ʃ i n ɐ
закон	z ɐ k ɔ n
крадла	k r a d ɫ ɐ
селекционен	s ɛ lʲ ɛ k t͡s i ɔ n ɛ n
отпущам	o t p u ʃ t ɐ m
намака	n ɐ m a k ɐ
конюнктура	k o nʲ u n k t u r ɐ
жарък	ʒ a r ɐ k
земноводно	z ɛ m n o v ɔ d n o
краен	k r a ɛ n
липък	lʲ i p ɐ k
коноп	k o n ɔ p
началник	n ɐ t͡ʃ a ɫ n i k
шифър	ʃ i f ɐ r
гяурин	ɡʲ ɐ u r i n
изпея	i s p ɛ j ɐ
ядяща	j a dʲ a ʃ t ɐ
ами	ɐ m i
чичо	t͡ʃ i t͡ʃ o
вестник	v ɛ s n i k
бързолет	b ɐ r z o lʲ ɛ t
гърлица	ɡ ɤ r lʲ i t͡s ɐ
ледовит	lʲ ɛ d o v i t
сложа	s ɫ ɔ ʒ ɐ
любителка	lʲ u b i t ɛ ɫ k ɐ
желалата	ʒ ɛ ɫ a ɫ ɐ t ɐ
дизя	d i zʲ ɐ
безделнича	b ɛ z d ɛ ɫ n i t͡ʃ ɐ
лук	ɫ u k
загина	z ɐ ɡʲ i n ɐ
служа	s ɫ u ʒ ɐ
ветрило	v ɛ t r i ɫ o
археолог	ɐ r xʲ ɛ o ɫ ɔ k
борба	b o r b a
бележит	b ɛ lʲ ɛ ʒ i t
направям	n ɐ p r a vʲ ɐ m
приема	p r i ɛ m ɐ
надолу	n ɐ d ɔ ɫ u
значимост	z n ɐ t͡ʃ i m o s t
присое	p r i s ɔ ɛ
ибис	i b i s
тоалет	t o ɐ lʲ ɛ t
извадя	i z v a dʲ ɐ
холандски	x o ɫ a n t s kʲ i
техният	t ɛ x n i j ɐ t
пащърнак	p ɐ ʃ t ɐ r n a k
оцветявам	o t͡s v ɛ tʲ a v ɐ m
гигантски	ɡʲ i ɡ a n t s kʲ i
католичка	k ɐ t o lʲ i t͡ʃ k ɐ
навътре	n ɐ v ɤ t r ɛ
раждам	r a ʒ d ɐ m
имаше	i m ɐ ʃ ɛ
пречупя	p r ɛ t͡ʃ u pʲ ɐ
изправям	i s p r a vʲ ɐ m
властник	v ɫ a s n i k
дневен	d n ɛ v ɛ n
светлосянка	s v ɛ t ɫ o sʲ a n k ɐ
нехая	n ɛ x a j ɐ
пропаст	p r ɔ p ɐ s t
торта	t ɔ r t ɐ
щука	ʃ t u k ɐ
стъпало	s t ɐ p a ɫ o
полски	p ɔ ɫ s kʲ i
гледам	ɡ lʲ ɛ d ɐ m
имащо	i m ɐ ʃ t o
пепелник	p ɛ p ɛ ɫ n i k
безчестя	b ɛ ʃ t͡ʃ ɛ s tʲ a
капак	k ɐ p a k
минск	m i n s k
страх	s t r a x
скърчав	s k ɤ r t͡ʃ ɐ f
проследяем	p r o s lʲ ɛ dʲ a ɛ m
срака	s r a k ɐ
определено	o p r ɛ d ɛ lʲ ɛ n o
гмуркач	ɡ m u r k a t͡ʃ
дебелея	d ɛ b ɛ lʲ ɛ j ɐ
узаконяват	u z ɐ k o nʲ a v ɐ t
феникс	f ɛ n i k s
строй	s t r ɔ j
абразия	ɐ b r a z i j ɐ
облаче	ɔ b ɫ ɐ t͡ʃ ɛ
владичица	v ɫ ɐ d i t͡ʃ i t͡s ɐ
маниак	m ɐ n i a k
върна	v ɤ r n ɐ
напредна	n ɐ p r ɛ d n ɐ
прозирам	p r o z i r ɐ m
огромен	o ɡ r ɔ m ɛ n
гмурец	ɡ m u r ɛ t͡s
дойда	d ɔ j d ɐ
носят	n ɔ sʲ ɐ t
преперец	p r ɛ p ɛ r ɛ t͡s
долен	d ɔ lʲ ɛ n
ленив	lʲ ɛ n i f
разчитам	r ɐ ʃ t͡ʃ i t ɐ m
чивия	t͡ʃ i v i j ɐ
етика	ɛ t i k ɐ
негов	n ɛ ɡ o f
лоуис	ɫ ɔ u i s
нектаринка	n ɛ k t ɐ r i n k ɐ
лиляк	lʲ i lʲ ɐ k
джамия	d ʒ ɐ m i j ɐ
репортер	r ɛ p o r t ɛ r
сияехме	s i j a ɛ x m ɛ
предмет	p r ɛ d m ɛ t
продан	p r ɔ d ɐ n
безплатен	b ɛ s p ɫ a t ɛ n
нежелан	n ɛ ʒ ɛ ɫ a n
неодим	n ɛ o d i m
стратегически	s t r ɐ t ɛ ɡʲ i t͡ʃ ɛ s kʲ i
мъгла	m ɐ ɡ ɫ a
мишка	m i ʃ k ɐ
мразовит	m r ɐ z o v i t
накажа	n ɐ k a ʒ ɐ
телур	t ɛ ɫ u r
мюре	mʲ u r ɛ
мях	mʲ a x
езера	ɛ z ɛ r a
германски	ɡʲ ɛ r m a n s kʲ i
изваждам	i z v a ʒ d ɐ m
невъзможно	n ɛ v ɐ z m ɔ ʒ n o
болница	b o ɫ n i t͡s ɐ
пистолет	p i s t o lʲ ɛ t
почивка	p o t͡ʃ i f k ɐ
повярвам	p o vʲ a r v ɐ m
видра	v i d r ɐ
въоръжавам	v ɐ o r ɐ ʒ a v ɐ m
падишах	p ɐ d i ʃ a x
крякот	k rʲ a k o t
невярващ	n ɛ vʲ a r v ɐ ʃ t
същ	s ɤ ʃ t
дий	d i
миров	m i r o f
панкреас	p a n k r ɛ ɐ s
защитен	z ɐ ʃ t i t ɛ n
коледа	k ɔ lʲ ɛ d ɐ
атентат	ɐ t ɛ n t a t
ѝ	i
тръгна	t r ɐ ɡ n a
груб	ɡ r u p
англия	a n ɡ lʲ i j ɐ
имащото	i m ɐ ʃ t o t o
облак	ɔ b ɫ ɐ k
енцелад	ɛ n t͡s ɛ ɫ a t
забелязвам	z ɐ b ɛ lʲ a z v ɐ m
шивачница	ʃ i v a t͡ʃ n i t͡s ɐ
местоимение	m ɛ s t o i m ɛ n i ɛ
супермаркет	s u p ɛ r m a r kʲ ɛ t
информация	i n f o r m a t͡s i j ɐ
работя	r ɐ b ɔ tʲ ɐ
замра	z ɐ m r ɤ
глота	ɡ ɫ ɔ t ɐ
неизвестен	n ɛ i z v ɛ s t ɛ n
орехче	ɔ r ɛ x t͡ʃ ɛ
абатски	ɐ b a t s kʲ i
разгърна	r ɐ z ɡ ɤ r n ɐ
похватен	p o x v a t ɛ n
арабин	ɐ r a b i n
еднодневка	ɛ d n o d n ɛ f k ɐ
подялба	p o dʲ a ɫ b ɐ
вещица	v ɛ ʃ t i t͡s ɐ
борец	b o r ɛ t͡s
юрод	j u r o t
поддръжка	p o d d r ɤ ʃ k ɐ
население	n ɐ s ɛ lʲ ɛ n i ɛ
овластителен	o v ɫ ɐ s t i t ɛ lʲ ɛ n
пек	p ɛ k
пуйка	p u j k ɐ
от	o t
газ	ɡ a s
довеждам	d o v ɛ ʒ d ɐ m
карам	k a r ɐ m
балюстрада	b ɐ lʲ u s t r a d ɐ
агрегатен	ɐ ɡ r ɛ ɡ a t ɛ n
изключение	i s k lʲ u t͡ʃ ɛ n i ɛ
разтурия	r ɐ s t u r i j ɐ
рехабилитационен	r ɛ x ɐ b i lʲ i t ɐ t͡s i ɔ n ɛ n
цвете	t͡s v ɛ t ɛ
техни	t ɛ x n i
русалия	r u s a lʲ i j ɐ
гяур	ɡʲ ɐ u r
яденета	j a d ɛ n ɛ t ɐ
яденето	j a d ɛ n ɛ t o
плащ	p ɫ a ʃ t
пернат	p ɛ r n a t
чиито	t͡ʃ i i t o
ой	ɔ j
узаконилите	u z ɐ k o n i lʲ i t ɛ
вея	v ɛ j ɐ
напред	n ɐ p r ɛ t
мезе	m ɛ z ɛ
легнете	lʲ ɛ ɡ n ɛ t ɛ
гемия	ɡʲ ɛ m i j ɐ
хващам	x v a ʃ t ɐ m
наблюдавам	n ɐ b lʲ u d a v ɐ m
бърне	b ɐ r n ɛ
майтнерий	m ɐ j t n ɛ r i
вина	v i n a
абдикиране	ɐ b d i kʲ i r ɐ n ɛ
коля	k ɔ lʲ ɐ
роднина	r o d n i n ɐ
лястовичи	lʲ a s t o v i t͡ʃ i
подкупя	p o t k u pʲ ɐ
тънък	t ɤ n ɐ k
състояние	s ɐ s t o j a n i ɛ
мерзавец	m ɛ r z a v ɛ t͡s
решение	r ɛ ʃ ɛ n i ɛ
почитаем	p o t͡ʃ i t a ɛ m
солен	s o lʲ ɛ n
зло	z ɫ ɔ
техничен	t ɛ x n i t͡ʃ ɛ n
изгреба	i z ɡ r ɛ b ɐ
злъч	z ɫ ɤ t͡ʃ
белтък	b ɛ ɫ t ɤ k
внезапен	v n ɛ z a p ɛ n
матерен	m a t ɛ r ɛ n
гной	ɡ n ɔ j
обещавам	o b ɛ ʃ t a v ɐ m
пъргав	p ɤ r ɡ ɐ f
пряпор	p rʲ a p o r
напълно	n ɐ p ɤ ɫ n o
блюя	b lʲ u j ɐ
запра	z ɐ p r ɤ
македонски	m ɐ kʲ ɛ d ɔ n s kʲ i
подозирам	p o d o z i r ɐ m
имахме	i m a x m ɛ
цица	t͡s i t͡s ɐ
говорихте	ɡ o v o r i x t ɛ
поклатя	p o k ɫ a tʲ ɐ
къртичи	k ɐ r t i t͡ʃ i
офис	ɔ f i s
хладък	x ɫ a d ɐ k
меч	m ɛ t͡ʃ
борий	b ɔ r i
седя	s ɛ dʲ a
абстрактен	ɐ p s t r a k t ɛ n
възел	v ɤ z ɛ ɫ
имате	i m ɐ t ɛ
приближа	p r i b lʲ i ʒ a
логан	ɫ ɔ ɡ ɐ n
регистрационен	r ɛ ɡʲ i s t r ɐ t͡s i ɔ n ɛ n
устоявам	u s t o j a v ɐ m
труп	t r u p
багер	b a ɡʲ ɛ r
китаец	kʲ i t a ɛ t͡s
познавам	p o z n a v ɐ m
спя	s pʲ ɤ
светлана	s v ɛ t ɫ a n ɐ
пафкам	p a f k ɐ m
пижо	p i ʒ o
сказуемо	s k ɐ z u ɛ m o
нескромен	n ɛ s k r ɔ m ɛ n
евакуационен	ɛ v ɐ k u ɐ t͡s i ɔ n ɛ n
наредба	n ɐ r ɛ d b ɐ
сто	s t ɔ
бих	b i x
кърнак	k ɐ r n a k
версия	v ɛ r s i j ɐ
единайсет	ɛ d i n a j s ɛ t
лактационен	ɫ ɐ k t ɐ t͡s i ɔ n ɛ n
кожарница	k o ʒ a r n i t͡s ɐ
деспотизъм	d ɛ s p o t i z ɐ m
смрад	s m r a t
австралийски	ɐ f s t r ɐ lʲ i s kʲ i
къделя	k ɐ d ɛ lʲ ɐ
опаковчик	o p ɐ k ɔ f t͡ʃ i k
дискусия	d i s k u s i j ɐ
алкохол	ɐ ɫ k o x ɔ ɫ
дали	d a lʲ i
повтор	p o f t ɔ r
пасохме	p a s o x m ɛ
ламаринен	ɫ ɐ m ɐ r i n ɛ n
фрегата	f r ɛ ɡ a t ɐ
адютант	ɐ dʲ u t a n t
всъщност	f s ɤ ʃ n o s t
одежда	o d ɛ ʒ d ɐ
хамбар	x ɐ m b a r
радиоцентър	r a d i o t͡s ɛ n t ɐ r
жуй	ʒ u j
знаме	z n a m ɛ
стикс	s t i k s
автобиографично	ɐ f t o b i o ɡ r ɐ f i t͡ʃ n o
мозък	m ɔ z ɐ k
вегав	v ɛ ɡ ɐ f
откажа	o t k a ʒ ɐ
любознателен	lʲ u b o z n a t ɛ lʲ ɛ n
ръст	r ɤ s t
будилник	b u d i ɫ n i k
сив	s i f
шатка	ʃ a t k ɐ
остатък	o s t a t ɐ k
свързан	s v ɤ r z ɐ n
абанос	ɐ b ɐ n ɔ s
дъщеря	d ɐ ʃ t ɛ rʲ a
никта	n i k t ɐ
квачка	k v a t͡ʃ k ɐ
главен	ɡ ɫ a v ɛ n
корпорация	k o r p o r a t͡s i j ɐ
швейцарка	ʃ v ɛ j t͡s a r k ɐ
орле	o r lʲ ɛ
розов	r ɔ z o f
научавам	n ɐ u t͡ʃ a v ɐ m
отрови	o t r o v i
волфрам	v ɔ ɫ f r ɐ m
биче	b i t͡ʃ ɛ
алчен	a ɫ t͡ʃ ɛ n
често	t͡ʃ ɛ s t o
югоизток	j u ɡ o i s t o k
ядящата	j a dʲ a ʃ t ɐ t ɐ
стратегичен	s t r ɐ t ɛ ɡʲ i t͡ʃ ɛ n
възкръсна	v ɐ s k r ɤ s n ɐ
бразилски	b r ɐ z i ɫ s kʲ i
мрем	m r ɛ m
оправдавам	o p r ɐ v d a v ɐ m
течен	t ɛ t͡ʃ ɛ n
счетоводен	ʃ t͡ʃ ɛ t o v ɔ d ɛ n
сад	s a t
помпа	p ɔ m p ɐ
разпределение	r ɐ s p r ɛ d ɛ lʲ ɛ n i ɛ
бъбрек	b ɤ b r ɛ k
престъпник	p r ɛ s t ɤ p n i k
бълха	b ɐ ɫ x a
тежест	t ɛ ʒ ɛ s t
професионален	p r o f ɛ s i o n a lʲ ɛ n
жегавица	ʒ ɛ ɡ a v i t͡s ɐ
възмущение	v ɐ z m u ʃ t ɛ n i ɛ
гуждам	ɡ u ʒ d ɐ m
узаконилото	u z ɐ k o n i ɫ o t o
сърпоклюн	s ɐ r p o k lʲ u n
червив	t͡ʃ ɛ r v i f
бангладеш	b a n ɡ ɫ ɐ d ɛ ʃ
европеец	ɛ v r o p ɛ ɛ t͡s
двусмислие	d v u s m i s lʲ i ɛ
върло	v ɐ r ɫ ɔ
опера	ɔ p ɛ r ɐ
увал	u v a ɫ
гангстер	ɡ a n k s t ɛ r
напредък	n ɐ p r ɛ d ɐ k
наводня	n ɐ v o d nʲ ɤ
плосък	p ɫ ɔ s ɐ k
абсолютно	ɐ p s o lʲ u t n o
успех	u s p ɛ x
устна	u s n ɐ
ютия	j u t i j ɐ
легла	lʲ ɛ ɡ ɫ a
нашествие	n ɐ ʃ ɛ s t v i ɛ
билото	b i ɫ o t o
имали	i m a lʲ i
япет	j ɐ p ɛ t
онакава	o n ɐ k a v ɐ
поднеса	p o d n ɛ s ɤ
сея	s ɛ j ɐ
крастел	k r a s t ɛ ɫ
убедя	u b ɛ dʲ ɤ
дворец	d v o r ɛ t͡s
авлия	ɐ v lʲ i j ɐ
числителен	t͡ʃ i s lʲ i t ɛ lʲ ɛ n
идентификационен	i d ɛ n t i f i k ɐ t͡s i ɔ n ɛ n
вашето	v a ʃ ɛ t o
висш	v i ʃ ʃ
каква	k ɐ k v a
врабей	v r a b ɛ j
плаша	p ɫ a ʃ ɐ
сретя	s r ɛ tʲ ɐ
амвон	ɐ m v ɔ n
движа	d v i ʒ ɐ
философия	f i ɫ o s ɔ f i j ɐ
хопам	x ɔ p ɐ m
стилист	s t i lʲ i s t
жълтеникав	ʒ ɐ ɫ t ɛ n i k ɐ f
отвръщам	o t v r ɤ ʃ t ɐ m
какви	k ɐ k v i
възкреся	v ɐ s k r ɛ sʲ ɐ
север	s ɛ v ɛ r
четвъртък	t͡ʃ ɛ t v ɤ r t ɐ k
арка	a r k ɐ
сладък	s ɫ a d ɐ k
започна	z ɐ p ɔ t͡ʃ n ɐ
модален	m o d a lʲ ɛ n
творец	t v o r ɛ t͡s
изплаша	i s p ɫ a ʃ ɐ
пивък	p i v ɐ k
надебелея	n ɐ d ɛ b ɛ lʲ ɛ j ɐ
настояще	n ɐ s t o j a ʃ t ɛ
бидейки	b i d ɛ j kʲ i
къщи	k ɤ ʃ t i
измете	i z m ɛ t ɛ
жътва	ʒ ɤ t v ɐ
узаконяването	u z ɐ k o nʲ a v ɐ n ɛ t o
основателност	o s n o v a t ɛ ɫ n o s t
данък	d a n ɐ k
фиорд	f i ɔ r t
олово	o ɫ ɔ v o
немкиня	n ɛ m kʲ i nʲ ɐ
ниобий	n i ɔ b i
открия	o t k r i j ɐ
хлебарка	x lʲ ɛ b a r k ɐ
узаконеният	u z ɐ k o n ɛ n i j ɐ t
работодател	r ɐ b o t o d a t ɛ ɫ
междувременно	m ɛ ʒ d u v r ɛ m ɛ n n o
зарист	z ɐ r i s t
джазов	d ʒ a z o f
човек	t͡ʃ o v ɛ k
хавлия	x ɐ v lʲ i j ɐ
водолюбив	v o d o lʲ u b i f
ядящото	j a dʲ a ʃ t o t o
ден	d ɛ n
нога	n o ɡ a
лош	ɫ ɔ ʃ
да	d a
ядък	j a d ɐ k
озаглавя	o z ɐ ɡ ɫ ɐ vʲ ɤ
другаде	d r u ɡ ɐ d ɛ
паткан	p ɐ t k a n
зърна	z ɤ r n ɐ
забраните	z ɐ b r a n i t ɛ
прочут	p r o t͡ʃ u t
боричкам	b o r i t͡ʃ k ɐ m
чуждестранен	t͡ʃ u ʒ d ɛ s t r a n ɛ n
шествие	ʃ ɛ s t v i ɛ
бавя	b a vʲ ɐ
изтребител	i s t r ɛ b i t ɛ ɫ
обяснявам	o bʲ a s nʲ a v ɐ m
саламандър	s ɐ ɫ ɐ m a n d ɐ r
улей	u lʲ ɛ j
въстание	v ɐ s t a n i ɛ
кубоподобен	k u b o p o d ɔ b ɛ n
стреж	s t r ɛ ʃ
някакви	nʲ ɐ k ɐ k v i
прадеди	p r a d ɛ d i
връст	v r ɤ s t
привнеса	p r i v n ɛ s ɤ
провлак	p r ɔ v ɫ ɐ k
величина	v ɛ lʲ i t͡ʃ i n a
аби	ɐ b i
пиша	p i ʃ ɐ
актиний	ɐ k t i n i
допринасям	d o p r i n a sʲ ɐ m
нар	n a r
съчка	s ɤ t͡ʃ k ɐ
избия	i z b i j ɐ
наши	n a ʃ i
чехкиня	t͡ʃ ɛ x kʲ i nʲ ɐ
леко	lʲ ɛ k o
корем	k o r ɛ m
грузински	ɡ r u z i n s kʲ i
трепетлика	t r ɛ p ɛ t lʲ i k ɐ
глаголи	ɡ ɫ ɐ ɡ ɔ lʲ i
тербий	t ɛ r b i
тишина	t i ʃ i n a
представа	p r ɛ t s t a v ɐ
послушко	p o s ɫ u ʃ k o
негово	n ɛ ɡ o v o
женски	ʒ ɛ n s kʲ i
багър	b a ɡ ɐ r
узаконяванетата	u z ɐ k o nʲ a v ɐ n ɛ t ɐ t ɐ
сервитьор	s ɛ r v i tʲ ɔ r
дълбочина	d ɐ ɫ b o t͡ʃ i n a
долина	d o lʲ i n a
стъкленица	s t ɐ k lʲ ɛ n i t͡s ɐ
през	p r ɛ s
мрелият	m r ɛ lʲ i j ɐ t
пасохте	p a s o x t ɛ
глуж	ɡ ɫ u ʃ
свободен	s v o b ɔ d ɛ n
нанасям	n ɐ n a sʲ ɐ m
усорлица	u s ɔ r lʲ i t͡s ɐ
сатрап	s ɐ t r a p
хидра	xʲ i d r ɐ
узаконил	u z ɐ k o n i ɫ
журналист	ʒ u r n ɐ lʲ i s t
фазан	f ɐ z a n
бозайник	b o z a j n i k
случвам	s ɫ u t͡ʃ v ɐ m
саксия	s ɐ k s i j ɐ
издател	i z d a t ɛ ɫ
тука	t u k ɐ
гадина	ɡ ɐ d i n ɐ
каменарка	k ɐ m ɛ n a r k ɐ
смяна	s mʲ a n ɐ
череша	t͡ʃ ɛ r ɛ ʃ ɐ
кожух	k o ʒ u x
преживям	p r ɛ ʒ i vʲ ɐ m
плавен	p ɫ a v ɛ n
тъкмо	t ɤ k m o
трофей	t r o f ɛ j
строг	s t r ɔ k
напръстник	n a p r ɐ s n i k
галба	ɡ ɐ ɫ b a
век	v ɛ k
щяло	ʃ tʲ a ɫ o
прощален	p r o ʃ t a lʲ ɛ n
бъчвар	b ɐ t͡ʃ v a r
уви	u v i
апс	a p s
причинявам	p r i t͡ʃ i nʲ a v ɐ m
ягне	j a ɡ n ɛ
породист	p o r o d i s t
парите	p ɐ r i t ɛ
русе	r u s ɛ
деветнадесет	d ɛ v ɛ t n a d ɛ s ɛ t
изгубя	i z ɡ u bʲ ɐ
пшеница	p ʃ ɛ n i t͡s ɐ
енциклопедия	ɛ n t͡s i k ɫ o p ɛ d i j ɐ
ягодов	j a ɡ o d o f
граната	ɡ r ɐ n a t ɐ
принцеса	p r i n t͡s ɛ s ɐ
фир	f i r
втори	f t ɔ r i
мъж	m ɤ ʃ
членестоного	t͡ʃ lʲ ɛ n ɛ s t o n ɔ ɡ o
сви	s v i
микроорганизъм	m i k r o o r ɡ ɐ n i z ɐ m
абсциса	ɐ p s t͡s i s ɐ
самоличност	s ɐ m o lʲ i t͡ʃ n o s t
рея	r ɛ j ɐ
средище	s r ɛ d i ʃ t ɛ
мироглед	m i r o ɡ lʲ ɛ t
тения	t ɛ n i j ɐ
хава	x a v ɐ
зала	z a ɫ ɐ
сестрински	s ɛ s t r i n s kʲ i
едно	ɛ d n ɔ
определителен	o p r ɛ d ɛ lʲ i t ɛ lʲ ɛ n
верига	v ɛ r i ɡ ɐ
измисля	i z m i s lʲ ɐ
вирус	v i r u s
аллах	ɐ ɫ ɫ a x
биографичен	b i o ɡ r ɐ f i t͡ʃ ɛ n
снасям	s n a sʲ ɐ m
памет	p a m ɛ t
общ	ɔ p ʃ t
будуя	b u d u j ɐ
сеизмичен	s ɛ i z m i t͡ʃ ɛ n
усмихвам	u s m i x v ɐ m
ограничавам	o ɡ r ɐ n i t͡ʃ a v ɐ m
непълен	n ɛ p ɤ lʲ ɛ n
факултет	f ɐ k u ɫ t ɛ t
специален	s p ɛ t͡s i a lʲ ɛ n
ухапете	u x a p ɛ t ɛ
недалечен	n ɛ d ɐ lʲ ɛ t͡ʃ ɛ n
извлека	i z v lʲ ɛ k ɤ
руснаци	r u s n a t͡s i
членувано	t͡ʃ lʲ ɛ n u v ɐ n o
плутоний	p ɫ u t ɔ n i
домашно	d o m a ʃ n o
неща	n ɛ ʃ t a
различим	r ɐ z lʲ i t͡ʃ i m
възсед	v ɐ s s ɛ t
мода	m ɔ d ɐ
обучение	o b u t͡ʃ ɛ n i ɛ
зърнен	z ɤ r n ɛ n
чуващ	t͡ʃ u v ɐ ʃ t
чуждица	t͡ʃ u ʒ d i t͡s ɐ
кания	k ɐ n i j ɐ
узаконявахте	u z ɐ k o nʲ a v ɐ x t ɛ
бахар	b ɐ x a r
негър	n ɛ ɡ ɐ r
носител	n o s i t ɛ ɫ
братски	b r a t s kʲ i
вести	v ɛ s t i
тояга	t o j a ɡ ɐ
хирургичен	xʲ i r u r ɡʲ i t͡ʃ ɛ n
як	j a k
етърва	ɛ t ɤ r v ɐ
робот	r ɔ b o t
двоеточие	d v o ɛ t ɔ t͡ʃ i ɛ
доведа	d o v ɛ d ɤ
кои	k o i
отред	o t r ɛ t
езда	ɛ z d ɤ
съсирек	s ɐ s i r ɛ k
навечерие	n ɐ v ɛ t͡ʃ ɛ r i ɛ
хуй	x u j
пасенета	p a s ɛ n ɛ t ɐ
кур	k u r
градът	ɡ r a d ɐ t
технически	t ɛ x n i t͡ʃ ɛ s kʲ i
предупредя	p r ɛ d u p r ɛ dʲ ɤ
зрител	z r i t ɛ ɫ
моето	m ɔ ɛ t o
осип	ɔ s i p
осмий	ɔ s m i
врат	v r a t
щелия	ʃ t ɛ lʲ i j ɐ
шум	ʃ u m
азербайджан	ɐ z ɛ r b ɐ j d ʒ a n
плесен	p lʲ ɛ s ɛ n
въвра	v ɐ v r ɤ
генерал	ɡʲ ɛ n ɛ r a ɫ
мярка	mʲ a r k ɐ
кисело	kʲ i s ɛ ɫ o
девет	d ɛ v ɛ t
хирургически	xʲ i r u r ɡʲ i t͡ʃ ɛ s kʲ i
работа	r a b o t ɐ
бог	b ɔ k
обвиня	o b v i nʲ ɤ
свидетелство	s v i d ɛ t ɛ ɫ s t v o
мегалитър	m ɛ ɡ ɐ lʲ i t ɐ r
хиляда	xʲ i lʲ a d ɐ
забраня	z ɐ b r ɐ nʲ ɤ
пощаджия	p ɔ ʃ t ɐ d ʒ i j ɐ
изтънчен	i s t ɤ n t͡ʃ ɛ n
апсида	ɐ p s i d ɐ
свръхякане	s v r ɐ xʲ a k ɐ n ɛ
съглася	s ɐ ɡ ɫ ɐ sʲ a
мрене	m r ɛ n ɛ
двуличен	d v u lʲ i t͡ʃ ɛ n
българка	b ɤ ɫ ɡ ɐ r k ɐ
международен	m ɛ ʒ d u n ɐ r ɔ d ɛ n
абонат	a b o n a t
бяхте	bʲ a x t ɛ
върху	v ɐ r x u
керамика	kʲ ɛ r a m i k ɐ
крава	k r a v ɐ
пърдя	p ɐ r dʲ a
опак	ɔ p ɐ k
сън	s ɤ n
скроб	s k r ɔ p
почти	p o t͡ʃ t i
назад	n ɐ z a t
очи	o t͡ʃ i
трици	t r i t͡s i
чвор	t͡ʃ v ɔ r
охлюв	ɔ x lʲ u f
биолог	b i o ɫ ɔ k
архитектурен	ɐ r xʲ i t ɛ k t u r ɛ n
шофьорка	ʃ o fʲ ɔ r k ɐ
езичен	ɛ z i t͡ʃ ɛ n
убивам	u b i v ɐ m
роса	r o s a
юрган	j u r ɡ a n
местност	m ɛ s n o s t
ваште	v a ʃ t ɛ
щателен	ʃ t a t ɛ lʲ ɛ n
президент	p r ɛ z i d ɛ n t
те	t ɛ
отдел	o d d ɛ ɫ
алка	a ɫ k ɐ
инфантилен	i n f ɐ n t i lʲ ɛ n
любовен	lʲ u b ɔ v ɛ n
корабокрушение	k o r ɐ b o k r u ʃ ɛ n i ɛ
ему	ɛ m u
власт	v ɫ a s t
чист	t͡ʃ i s t
чедо	t͡ʃ ɛ d o
хубав	x u b ɐ f
говорех	ɡ o v ɔ r ɛ x
долар	d ɔ ɫ ɐ r
освен	o s v ɛ n
храня	x r a nʲ ɐ
книжен	k n i ʒ ɛ n
мечок	m ɛ t͡ʃ ɔ k
турция	t u r t͡s i j ɐ
въглен	v ɤ ɡ lʲ ɛ n
мушитрънка	m u ʃ i t r ɤ n k ɐ
обсъдя	o p s ɤ dʲ ɐ
самотен	s ɐ m ɔ t ɛ n
круша	k r u ʃ ɐ
виждам	v i ʒ d ɐ m
подлог	p ɔ d ɫ o k
манган	m ɐ n ɡ a n
адаш	ɐ d a ʃ
забождам	z ɐ b ɔ ʒ d ɐ m
авансцена	ɐ v ɐ n s t͡s ɛ n ɐ
звънлив	z v ɐ n lʲ i f
лесовик	lʲ ɛ s o v i k
абатския	ɐ b a t s kʲ i j ɐ
бол	b ɔ ɫ
вътрешност	v ɤ t r ɛ ʃ n o s t
непрекъснато	n ɛ p r ɛ k ɤ s n ɐ t o
панкреатит	p ɐ n k r ɛ ɐ t i t
зъболекарски	z ɐ b o lʲ ɛ k ɐ r s kʲ i
шантажирам	ʃ ɐ n t ɐ ʒ i r ɐ m
архитектура	ɐ r xʲ i t ɛ k t u r ɐ
наводнявам	n ɐ v o d nʲ a v ɐ m
петалитър	p ɛ t ɐ lʲ i t ɐ r
скръбав	s k r ɤ b ɐ f
лебедица	lʲ ɛ b ɛ d i t͡s ɐ
гъделичкам	ɡ ɐ d ɛ lʲ i t͡ʃ k ɐ m
анкетен	ɐ n kʲ ɛ t ɛ n
собственост	s ɔ p s t v ɛ n o s t
мускулен	m u s k u lʲ ɛ n
довлека	d o v lʲ ɛ k ɤ
сипкав	s i p k ɐ f
стил	s t i ɫ
континент	k o n t i n ɛ n t
авантюристически	ɐ v ɐ n tʲ u r i s t i t͡ʃ ɛ s kʲ i
свалям	s v a lʲ ɐ m
очен	ɔ t͡ʃ ɛ n
ида	i d ɐ
ветрилник	v ɛ t r i ɫ n i k
окръжен	o k r ɤ ʒ ɛ n
калай	k ɐ ɫ a j
подред	p o d r ɛ t
връв	v r ɤ f
мощ	m ɔ ʃ t
неговите	n ɛ ɡ o v i t ɛ
нещастие	n ɛ ʃ t a s t i ɛ
панаир	p ɐ n ɐ i r
ястреб	j a s t r ɛ p
чие	t͡ʃ i ɛ
градовете	ɡ r ɐ d o v ɛ t ɛ
сплав	s p ɫ a f
удобен	u d ɔ b ɛ n
пласт	p ɫ a s t
яж	j a ʃ
двамата	d v a m ɐ
въглероден	v ɐ ɡ lʲ ɛ r ɔ d ɛ n
потребител	p o t r ɛ b i t ɛ ɫ
кое	k o ɛ
бижу	b i ʒ u
алчба	a ɫ d͡ʒ b ɐ
различие	r ɐ z lʲ i t͡ʃ i ɛ
стихия	s t i xʲ i j ɐ
скрия	s k r i j ɐ
хомосексуалистка	x ɔ m o s ɛ k s u ɐ lʲ i s k ɐ
господи	ɡ ɔ s p o d i
мастит	m ɐ s t i t
петънце	p ɛ t ɐ n t͡s ɛ
падина	p ɐ d i n a
щедър	ʃ t ɛ d ɐ r
иманетата	i m ɐ n ɛ t ɐ t ɐ
съюз	s ɐ j u s
дрозд	d r ɔ s t
длето	d lʲ ɛ t ɔ
джунгла	d ʒ u n ɡ ɫ ɐ
сърбин	s ɤ r b i n
мазен	m a z ɛ n
самка	s a m k ɐ
бежов	b ɛ ʒ o f
легален	lʲ ɛ ɡ a lʲ ɛ n
татба	t a d b ɐ
ваш	v a ʃ
авджия	ɐ v d ʒ i j ɐ
анасон	ɐ n ɐ s ɔ n
скоро	s k ɔ r o
подвързия	p o d v ɐ r z i j ɐ
жидък	ʒ i d ɐ k
калинка	k ɐ lʲ i n k ɐ
нос	n ɔ s
възголям	v ɐ z ɡ o lʲ a m
ситен	s i t ɛ n
пасох	p a s o x
суесловие	s u ɛ s ɫ ɔ v i ɛ
дрипав	d r i p ɐ f
стръмнина	s t r ɐ m n i n a
гордо	ɡ ɔ r d o
топлик	t o p lʲ i k
лелек	lʲ ɛ lʲ ɛ k
кратък	k r a t ɐ k
случаен	s ɫ u t͡ʃ ɐ ɛ n
осмивам	o s m i v ɐ m
бодил	b o d i ɫ
черногорка	t͡ʃ ɛ r n o ɡ ɔ r k ɐ
резлив	r ɛ z lʲ i f
гърция	ɡ ɤ r t͡s i j ɐ
гриза	ɡ r i z a
видим	v i d i m
подпиша	p o t p i ʃ ɐ
унион	u n i ɔ n
шебой	ʃ ɛ b ɔ j
молив	m o lʲ i f
престол	p r ɛ s t ɔ ɫ
гъркиня	ɡ ɐ r kʲ i nʲ ɐ
вляза	v lʲ a z ɐ
тъпочовка	t ɐ p o t͡ʃ ɔ f k ɐ
парк	p a r k
равен	r a v ɛ n
фермер	f ɛ r m ɛ r
мишница	m i ʃ n i t͡s ɐ
джип	d ʒ i p
спомня	s p ɔ m nʲ ɐ
мощен	m ɔ ʃ t ɛ n
бивам	b i v ɐ m
мажете	m a ʒ ɛ t ɛ
смрадливец	s m r ɐ d lʲ i v ɛ t͡s
слузест	s ɫ u z ɛ s t
русин	r u s i n
християнин	x r i s t i j a n i n
жрея	ʒ r ɛ j ɐ
трескав	t r ɛ s k ɐ f
пошъл	p ɔ ʃ ɐ ɫ
арабски	ɐ r a p s kʲ i
скуа	s k u ɐ
акорд	ɐ k ɔ r t
затворен	z ɐ t v ɔ r ɛ n
междуметие	m ɛ ʒ d u m ɛ t i ɛ
запъртък	z a p ɐ r t ɐ k
пасинок	p a s i n o k
щастие	ʃ t a s t i ɛ
твоето	t v ɔ ɛ t o
монах	m o n a x
поилка	p o i ɫ k ɐ
зрял	z rʲ a ɫ
чудо	t͡ʃ u d o
към	k ɤ m
лещарка	lʲ ɛ ʃ t a r k ɐ
лале	ɫ ɐ lʲ ɛ
странен	s t r a n ɛ n
другар	d r u ɡ a r
щастлив	ʃ t ɐ s lʲ i f
байно	b a j n o
къща	k ɤ ʃ t ɐ
телефон	t ɛ lʲ ɛ f ɔ n
узаконен	u z ɐ k o n ɛ n
здравейте	z d r ɐ v ɛ j t ɛ
три	t r i
чифлик	t͡ʃ i f lʲ i k
водопад	v o d o p a t
склонен	s k ɫ ɔ n ɛ n
изслушам	i s ɫ u ʃ ɐ m
статус	s t a t u s
домете	d o m ɛ t ɛ
покрай	p o k r a j
столова	s t o ɫ ɔ v ɐ
убеждавам	u b ɛ ʒ d a v ɐ m
доверчив	d o v ɛ r t͡ʃ i f
чутура	t͡ʃ u t u r ɐ
среден	s r ɛ d ɛ n
блато	b ɫ a t o
ухапя	u x a pʲ ɐ
узаконяващият	u z ɐ k o nʲ a v ɐ ʃ t i j ɐ t
дърволазка	d ɐ r v o ɫ a s k ɐ
стрепет	s t r ɛ p ɛ t
лея	lʲ ɛ j ɐ
люксембург	lʲ u k s ɛ m b u r k
теле	t ɛ lʲ ɛ
немощност	n ɛ m o ʃ n o s t
проповедник	p r o p o v ɛ d n i k
благ	b ɫ a k
узаконения	u z ɐ k o n ɛ n i j ɐ
цезий	t͡s ɛ z i
ужасно	u ʒ a s n o
блудкав	b ɫ u t k ɐ f
ездачка	ɛ z d a t͡ʃ k ɐ
тигър	t i ɡ ɐ r
влагалище	v ɫ ɐ ɡ a lʲ i ʃ t ɛ
витък	v i t ɐ k
фикус	f i k u s
зелен	z ɛ lʲ ɛ n
бъдеш	b ɤ d ɛ ʃ
авантюристичен	ɐ v ɐ n tʲ u r i s t i t͡ʃ ɛ n
пъртина	p ɐ r t i n ɐ
парче	p ɐ r t͡ʃ ɛ
разлюбвам	r ɐ z lʲ u b v ɐ m
технеций	t ɛ x n ɛ t͡s i
жертва	ʒ ɛ r t v ɐ
докторка	d ɔ k t o r k ɐ
откриваем	o t k r i v a ɛ m
жито	ʒ i t o
оръжие	o r ɤ ʒ i ɛ
мренета	m r ɛ n ɛ t ɐ
орден	ɔ r d ɛ n
мироточив	m i r o t o t͡ʃ i f
узаконяха	u z ɐ k o nʲ a x ɐ
екип	ɛ kʲ i p
кон	k ɔ n
брадва	b r a d v ɐ
гагарка	ɡ ɐ ɡ a r k ɐ
летя	lʲ ɛ tʲ a
синкав	s i n k ɐ f
дюля	dʲ u lʲ ɐ
акушерка	ɐ k u ʃ ɛ r k ɐ
дряновец	d rʲ a n o v ɛ t͡s
стигна	s t i ɡ n ɐ
рубидий	r u b i d i
обоснова	o b o s n o v a
братле	b r ɐ t lʲ ɛ
попичам	p o p i t͡ʃ ɐ m
тогавашен	t o ɡ a v ɐ ʃ ɛ n
автостоп	a f t o s t ɔ p
картина	k ɐ r t i n ɐ
пасено	p a s ɛ n o
отговорност	o d ɡ o v ɔ r n o s t
високо	v i s ɔ k o
знатен	z n a t ɛ n
жълтък	ʒ ɐ ɫ t ɤ k
светлосянката	s v ɛ t ɫ o sʲ a n k ɐ t ɐ
аметистов	ɐ m ɛ t i s t o f
тихо	t i x o
ддс	d ɤ d ɤ s ɤ
лижете	lʲ i ʒ ɛ t ɛ
пръчица	p r ɤ t͡ʃ i t͡s ɐ
беларус	b ɛ ɫ ɐ r u s
белезници	b ɛ lʲ ɛ z n i t͡s i
болниците	b o ɫ n i t͡s i t ɛ
моля	m ɔ lʲ ɐ
кубик	k u b i k
безгрижие	b ɛ z ɡ r i ʒ i ɛ
ядената	j a d ɛ n ɐ t ɐ
семейство	s ɛ m ɛ j s t v o
месо	m ɛ s ɔ
влез	v lʲ ɛ s
покруса	p o k r u s ɐ
фермий	f ɛ r m i
неразбория	n ɛ r ɐ z b o r i j ɐ
етажерка	ɛ t ɐ ʒ ɛ r k ɐ
архипелаг	ɐ r xʲ i p ɛ ɫ a k
кърджалия	k ɐ r d ʒ a lʲ i j ɐ
кубирам	k u b i r ɐ m
изопачен	i z o p ɐ t͡ʃ ɛ n
аргатин	ɐ r ɡ a t i n
контакт	k o n t a k t
тухла	t u x ɫ ɐ
реален	r ɛ a lʲ ɛ n
ниско	n i s k o
навра	n ɐ v r ɤ
лопатар	ɫ o p ɐ t a r
май	m a j
каквото	k ɐ k v ɔ t o
лечба	lʲ ɛ d͡ʒ b ɐ
калугерица	k ɐ ɫ u ɡʲ ɛ r i t͡s ɐ
упова	u p o v a
предприятие	p r ɛ t p r i j a t i ɛ
пия	p i j ɐ
мрейки	m r ɛ j kʲ i
хълм	x ɤ ɫ m
церий	t͡s ɛ r i
любима	lʲ u b i m ɐ
ако	a k o
низина	n i z i n a
езически	ɛ z i t͡ʃ ɛ s kʲ i
основа	o s n ɔ v ɐ
длъжен	d ɫ ɤ ʒ ɛ n
фобос	f ɔ b o s
аджемилъшки	ɐ d ʒ ɛ m i ɫ ɤ ʃ kʲ i
железария	ʒ ɛ lʲ ɛ z ɐ r i j ɐ
главоного	ɡ ɫ ɐ v o n ɔ ɡ o
политичен	p o lʲ i t i t͡ʃ ɛ n
нашта	n a ʃ t ɐ
чия	t͡ʃ i j a
бетонен	b ɛ t ɔ n ɛ n
минус	m i n u s
кирпич	kʲ i r p i t͡ʃ
нейни	n ɛ j n i
един	ɛ d i n
изведнъж	i z v ɛ d n ɤ ʃ
вас	v a s
котка	k ɔ t k ɐ
мъка	m ɤ k ɐ
нивье	n i vʲ ɛ
щрих	ʃ t r i x
синьо	s i nʲ o
отточник	o t t ɔ t͡ʃ n i k
беси	b ɛ s i
потъна	p o t ɤ n ɐ
участък	u t͡ʃ a s t ɐ k
прекален	p r ɛ k ɐ lʲ ɛ n
абсолютност	ɐ p s o lʲ u t n o s t
тъкан	t ɐ k a n
глаголе	ɡ ɫ ɐ ɡ ɔ lʲ ɛ
пръг	p r ɤ k
артикулационен	ɐ r t i k u ɫ ɐ t͡s i ɔ n ɛ n
участие	u t͡ʃ a s t i ɛ
позволя	p o z v o lʲ a
вертикален	v ɛ r t i k a lʲ ɛ n
протека	p r o t ɛ k ɤ
драгой	d r ɐ ɡ ɔ j
млечнобял	m lʲ ɛ t͡ʃ n o bʲ a ɫ
кимна	kʲ i m n ɐ
развитие	r ɐ z v i t i ɛ
учебник	u t͡ʃ ɛ b n i k
гневлив	ɡ n ɛ v lʲ i f
управителка	u p r a v i t ɛ ɫ k ɐ
бръзгам	b r ɤ z ɡ ɐ m
януари	j ɐ n u a r i
дайка	d a j k ɐ
събудя	s ɐ b u dʲ ɐ
праг	p r a k
легна	lʲ ɛ ɡ n a
сатанински	s ɐ t ɐ n i n s kʲ i
чужденец	t͡ʃ u ʒ d ɛ n ɛ t͡s
узаконена	u z ɐ k o n ɛ n ɐ
лихва	lʲ i x v ɐ
ментовка	m ɛ n t ɔ f k ɐ
еврейка	ɛ v r ɛ j k ɐ
бомба	b ɔ m b ɐ
податък	p o d a t ɐ k
заповед	z a p o v ɛ t
узаконихме	u z ɐ k o n i x m ɛ
арестувахме	a r ɛ s t u v a x m ɛ
костница	k ɔ s n i t͡s ɐ
наша	n a ʃ ɐ
надуваем	n ɐ d u v a ɛ m
амфитеатър	a m f i t ɛ a t ɐ r
узаконихте	u z ɐ k o n i x t ɛ
касационен	k ɐ s ɐ t͡s i ɔ n ɛ n
живак	ʒ i v a k
благодаря	b ɫ ɐ ɡ o d ɐ rʲ ɤ
финанси	f i n a n s i
медицина	m ɛ d i t͡s i n ɐ
бихте	b i x t ɛ
забранявам	z ɐ b r ɐ nʲ a v ɐ m
стоя	s t o j ɤ
кражба	k r a ʒ b ɐ
горица	ɡ o r i t͡s ɐ
българин	b ɤ ɫ ɡ ɐ r i n
накъде	n ɐ k ɐ d ɛ
четирите	t͡ʃ ɛ t i r i t ɛ
картал	k ɐ r t a ɫ
жираф	ʒ i r a f
мас	m a s
полковник	p o ɫ k ɔ v n i k
девойка	d ɛ v ɔ j k ɐ
стъпка	s t ɤ p k ɐ
загивам	z ɐ ɡʲ i v ɐ m
силно	s i ɫ n o
клуб	k ɫ u p
жужел	ʒ u ʒ ɛ ɫ
превзема	p r ɛ v z ɛ m ɐ
кръстат	k r ɐ s t a t
зреше	z r ɛ ʃ ɛ
игрив	i ɡ r i f
история	i s t ɔ r i j ɐ
изпълвам	i s p ɤ ɫ v ɐ m
достатък	d o s t a t ɐ k
силиций	s i lʲ i t͡s i
простак	p r o s t a k
рогов	r ɔ ɡ o f
вашият	v a ʃ i j ɐ t
щиглец	ʃ t i ɡ lʲ ɛ t͡s
предложа	p r ɛ d ɫ ɔ ʒ ɐ
оставка	o s t a f k ɐ
беся	b ɛ sʲ ɐ
бръндза	b r ɤ n d z ɐ
сура	s u r ɐ
азот	ɐ z ɔ t
узаконим	u z ɐ k o n i m
кафез	k ɐ f ɛ s
ония	o n i j ɐ
спра	s p r ɤ
хамбургер	x a m b u r ɡʲ ɛ r
бразилия	b r ɐ z i lʲ i j ɐ
сияй	s i j a j
кукам	k u k ɐ m
положение	p o ɫ o ʒ ɛ n i ɛ
южнячка	j u ʒ nʲ a t͡ʃ k ɐ
ален	a lʲ ɛ n
пристъп	p r i s t ɐ p
набожен	n ɐ b ɔ ʒ ɛ n
читателка	t͡ʃ i t a t ɛ ɫ k ɐ
места	m ɛ s t a
величавост	v ɛ lʲ i t͡ʃ a v o s t
трудно	t r u d n o
пасени	p a s ɛ n i
флуор	f ɫ u ɔ r
легализирам	lʲ ɛ ɡ ɐ lʲ i z i r ɐ m
гърне	ɡ ɐ r n ɛ
каменарче	k ɐ m ɛ n a r t͡ʃ ɛ
фосфор	f ɔ s f o r
дупка	d u p k ɐ
представям	p r ɛ t s t a vʲ ɐ m
телецентър	t ɛ lʲ ɛ t͡s ɛ n t ɐ r
скарабей	s k ɐ r ɐ b ɛ j
устат	u s t a t
мърляв	m ɤ r lʲ ɐ f
властен	v ɫ a s t ɛ n
сабя	s a bʲ ɐ
тресом	t r ɛ s o m
следобед	s lʲ ɛ d ɔ b ɛ t
изказване	i s k a z v ɐ n ɛ
знам	z n a m
суровина	s u r o v i n a
аксиома	a k s i ɔ m ɐ
двоичен	d v o i t͡ʃ ɛ n
правя	p r a vʲ ɐ
вкаменен	f k ɐ m ɛ n ɛ n
съветвам	s ɐ v ɛ t v ɐ m
почва	p o t͡ʃ v a
бандит	b ɐ n d i t
корморан	k o r m o r a n
съществувам	s ɐ ʃ t ɛ s t v u v ɐ m
затека	z ɐ t ɛ k ɤ
чичопей	t͡ʃ i t͡ʃ o p ɛ j
зашивам	z ɐ ʃ i v ɐ m
опашка	o p a ʃ k ɐ
допълнение	d o p ɐ ɫ n ɛ n i ɛ
ярък	j a r ɐ k
туткав	t u t k ɐ f
интернет	i n t ɛ r n ɛ t
цел	t͡s ɛ ɫ
зра	z r ɤ
мрящото	m rʲ a ʃ t o t o
гайда	ɡ a j d ɐ
тегло	t ɛ ɡ ɫ ɔ
харамия	x ɐ r ɐ m i j ɐ
пасат	p ɐ s ɤ t
слюнка	s lʲ u n k ɐ
сматрям	s m a t rʲ ɐ m
хлявав	x lʲ ɐ v a f
пасящия	p ɐ sʲ a ʃ t i j ɐ
доведе	d o v ɛ d ɛ
чорба	t͡ʃ o r b a
рудник	r u d n i k
зъл	z ɤ ɫ
шумак	ʃ u m a k
азербайджански	ɐ z ɛ r b ɐ j d͡ʒ a n s kʲ i
сой	s ɔ j
жъна	ʒ ɤ n ɐ
охрид	o x r i t
индийски	i n d i s kʲ i
скришом	s k r i ʃ o m
академия	ɐ k ɐ d ɛ m i j ɐ
обущарница	o b u ʃ t a r n i t͡s ɐ
кафенета	k ɐ f ɛ n ɛ t ɐ
копаница	k ɔ p ɐ n i t͡s ɐ
принуждавам	p r i n u ʒ d a v ɐ m
определен	o p r ɛ d ɛ lʲ ɛ n
острие	o s t r i ɛ
мамут	m ɐ m u t
тогова	t o ɡ ɔ v ɐ
адмирал	ɐ d m i r a ɫ
завоевател	z ɐ v o ɛ v a t ɛ ɫ
уверен	u v ɛ r ɛ n
радой	r ɐ d ɔ j
поред	p o r ɛ t
прахоляк	p r ɐ x o lʲ a k
мексико	m ɛ k s i k o
епископите	ɛ p i s k o p i t ɛ
добавя	d o b a vʲ ɐ
прекалявам	p r ɛ k ɐ lʲ a v ɐ m
наема	n ɐ ɛ m ɐ
упреквам	u p r ɛ k v ɐ m
камшик	k ɐ m ʃ i k
предвестие	p r ɛ d v ɛ s t i ɛ
пренасяне	p r ɛ n a sʲ ɐ n ɛ
разходи	r ɐ s x ɔ d i
върховие	v ɐ r x ɔ v i ɛ
нему	n ɛ m u
мръсен	m r ɤ s ɛ n
поляна	p o lʲ a n ɐ
нейния	n ɛ j n i j ɐ
коронясвам	k o r o nʲ a s v ɐ m
гоблин	ɡ ɔ b lʲ i n
езиков	ɛ z i k o f
припра	p r i p r ɤ
гадолиний	ɡ ɐ d o lʲ i n i
богат	b o ɡ a t
швейцария	ʃ v ɛ j t͡s a r i j ɐ
стръмно	s t r ɤ m n o
щелите	ʃ t ɛ lʲ i t ɛ
родителен	r o d i t ɛ lʲ ɛ n
френски	f r ɛ n s kʲ i
собол	s o b ɔ ɫ
ладия	ɫ ɐ d i j ɐ
чай	t͡ʃ a j
било	b i ɫ o
навестявам	n ɐ v ɛ s tʲ a v ɐ m
допека	d o p ɛ k ɤ
пате	p a t ɛ
честит	t͡ʃ ɛ s t i t
коларница	k o ɫ a r n i t͡s ɐ
мрящата	m rʲ a ʃ t ɐ t ɐ
отсянка	o t sʲ a n k ɐ
сладко	s ɫ a t k o
венера	v ɛ n ɛ r ɐ
кей	kʲ ɛ j
гостилница	ɡ o s t i ɫ n i t͡s ɐ
ялото	j a ɫ o t o
узаконяла	u z ɐ k o nʲ a ɫ ɐ
едновременен	ɛ d n o v r ɛ m ɛ n ɛ n
исландски	i s ɫ a n t s kʲ i
негодяй	n ɛ ɡ o dʲ a j
лъжица	ɫ ɐ ʒ i t͡s ɐ
говно	ɡ o v n ɔ
твоята	t v ɔ j ɐ t ɐ
африкански	ɐ f r i k a n s kʲ i
прехапвам	p r ɛ x a p v ɐ m
мир	m i r
скверен	s k v ɛ r ɛ n
кафе	k ɐ f ɛ
законен	z ɐ k ɔ n ɛ n
катерица	k a t ɛ r i t͡s ɐ
мюсюлмански	mʲ u sʲ u ɫ m a n s kʲ i
буренак	b u r ɛ n a k
театър	t ɛ a t ɐ r
момиче	m o m i t͡ʃ ɛ
синхронизационен	s i n x r o n i z ɐ t͡s i ɔ n ɛ n
пека	p ɛ k ɤ
чучулига	t͡ʃ u t͡ʃ u lʲ i ɡ ɐ
водоскок	v o d o s k ɔ k
текстилен	t ɛ k s t i lʲ ɛ n
мраченик	m r a t͡ʃ ɛ n i k
сингапур	s i n ɡ ɐ p u r
ядяхте	j a dʲ a x t ɛ
здание	z d a n i ɛ
данъчен	d a n ɐ t͡ʃ ɛ n
имах	i m a x
река	r ɛ k a
отделен	o d d ɛ lʲ ɛ n
избягам	i z bʲ a ɡ ɐ m
поисквам	p o i s k v ɐ m
зрящ	z rʲ a ʃ t
рис	r i s
чрез	t͡ʃ r ɛ s
неопределен	n ɛ o p r ɛ d ɛ lʲ ɛ n
реклама	r ɛ k ɫ a m ɐ
надебелявам	n ɐ d ɛ b ɛ lʲ a v ɐ m
безопасност	b ɛ z o p a s n o s t
възлизалият	v ɐ z lʲ i z ɐ lʲ i j ɐ t
запреда	z ɐ p r ɛ d ɤ
пловдив	p ɫ ɔ v d i f
раздялба	r ɐ z dʲ a ɫ b ɐ
меля	m ɛ lʲ ɐ
никой	n i k o j
блия	b lʲ i j ɐ
на	n a
перилен	p ɛ r i lʲ ɛ n
узаконявала	u z ɐ k o nʲ a v ɐ ɫ ɐ
абдоминален	ɐ b d o m i n a lʲ ɛ n
цад	t͡s a t
панталон	p ɐ n t ɐ ɫ ɔ n
припадна	p r i p a d n ɐ
лед	lʲ ɛ t
неон	n ɛ ɔ n
редактиране	r ɛ d ɐ k t i r ɐ n ɛ
колибри	k o lʲ i b r i
институт	i n s t i t u t
елемент	ɛ lʲ ɛ m ɛ n t
народен	n ɐ r ɔ d ɛ n
спанак	s p ɐ n a k
бъдейки	b ɤ d ɛ j kʲ i
кюфте	kʲ o f t ɛ
сирене	s i r ɛ n ɛ
хвърлям	x v ɤ r lʲ ɐ m
гуна	ɡ u n ɐ
изминавам	i z m i n a v ɐ m
оногоз	o n o ɡ ɔ s
снощи	s n ɔ ʃ t i
тромав	t r ɔ m ɐ f
боде	b o d ɛ
молба	m o ɫ b a
традиция	t r ɐ d i t͡s i j ɐ
бастилия	b ɐ s t i lʲ i j ɐ
велосипед	v ɛ ɫ o s i p ɛ t
противоречив	p r o t i v o r ɛ t͡ʃ i f
самун	s ɐ m u n
доверие	d o v ɛ r i ɛ
резба	r ɛ z b a
термин	t ɛ r m i n
отвес	o t v ɛ s
свойто	s v ɔ j t o
боя	b o j a
алиби	ɐ lʲ i b i
измъкна	i z m ɤ k n ɐ
разлог	r ɐ z ɫ ɔ k
революция	r ɛ v o lʲ u t͡s i j ɐ
скакавица	s k ɐ k a v i t͡s ɐ
пола	p o ɫ a
варя	v a rʲ ɐ
въртошийка	v ɐ r t o ʃ i k ɐ
държа	d ɐ r ʒ ɤ
въртя	v ɐ r tʲ ɤ
реша	r ɛ ʃ ɤ
нит	n i t
пролет	p r ɔ lʲ ɛ t
пасяща	p ɐ sʲ a ʃ t ɐ
има	i m a
взривен	v z r i v ɛ n
узаконила	u z ɐ k o n i ɫ ɐ
мухоловка	m u x o ɫ ɔ f k ɐ
нов	n ɔ f
въпреки	v ɤ p r ɛ kʲ i
бруя	b r u j ɐ
зестра	z ɛ s t r ɐ
лесно	lʲ ɛ s n o
димитър	d i m i t ɐ r
интересувам	i n t ɛ r ɛ s u v ɐ m
ревност	r ɛ v n o s t
ухо	u x ɔ
заплаши	z ɐ p ɫ a ʃ i
плъх	p ɫ ɤ x
зор	z ɔ r
пушене	p u ʃ ɛ n ɛ
явя	j a vʲ a
чет	t͡ʃ ɛ t
прям	p rʲ a m
великански	v ɛ lʲ i k a n s kʲ i
април	ɐ p r i ɫ
горест	ɡ ɔ r ɛ s t
немощен	n ɛ m o ʃ t ɛ n
буля	b u lʲ ɐ
желаещият	ʒ ɛ ɫ a ɛ ʃ t i j ɐ t
юначен	j u n a t͡ʃ ɛ n
бръмбар	b r ɤ m b ɐ r
албатрос	ɐ ɫ b ɐ t r ɔ s
отличим	o t lʲ i t͡ʃ i m
кочи	k ɔ t͡ʃ i
камък	k a m ɐ k
древен	d r ɛ v ɛ n
който	k ɔ j t o
лутеций	ɫ u t ɛ t͡s i
неговото	n ɛ ɡ o v o t o
възрастта	v ɐ z r ɐ s t a
ималите	i m a lʲ i t ɛ
грохот	ɡ r ɔ x o t
производство	p r o i z v ɔ t s t v o
авиобомба	a v i o b ɔ m b ɐ
сърце	s ɐ r t͡s ɛ
император	i m p ɛ r a t o r
сноп	s n ɔ p
го	ɡ o
билет	b i lʲ ɛ t
раздразним	r ɐ z d r ɐ z n i m
извличам	i z v lʲ i t͡ʃ ɐ m
диспросий	d i s p r ɔ s i
милионер	m i lʲ i o n ɛ r
аджаба	a d ʒ ɐ b ɐ
узаконените	u z ɐ k o n ɛ n i t ɛ
козле	k o z lʲ ɛ
операция	o p ɛ r a t͡s i j ɐ
сценарий	s t͡s ɛ n a r i
стеля	s t ɛ lʲ ɐ
обърна	o b ɤ r n ɐ
пристоен	p r i s t ɔ ɛ n
белоруски	b ɛ ɫ o r u s kʲ i
абдукция	ɐ b d u k t͡s i j ɐ
аерометър	a ɛ r o m ɛ t ɐ r
изминаваща	i z m i n a v ɐ ʃ t ɐ
лоуренсий	ɫ o u r ɛ n s i
тетрев	t ɛ t r ɛ f
кавал	k ɐ v a ɫ
глутница	ɡ ɫ u t n i t͡s ɐ
рода	r o d a
стърчиопашка	s t ɐ r t͡ʃ i o p a ʃ k ɐ
нож	n ɔ ʃ
много	m n ɔ ɡ o
цикламен	t͡s i k ɫ a m ɛ n
узаконят	u z ɐ k o nʲ ɤ t
тяло	tʲ a ɫ o
канап	k ɐ n a p
избоде	i z b o d ɛ
узаконял	u z ɐ k o nʲ a ɫ
съобщавам	s ɐ o p ʃ t a v ɐ m
адютантски	ɐ dʲ u t a n t s kʲ i
автодрезина	a f t o d r ɛ z i n ɐ
седемнадесет	s ɛ d ɛ m n a d ɛ s ɛ t
след	s lʲ ɛ t
бахър	b a x ɐ r
избера	i z b ɛ r ɤ
изпълнителен	i s p ɐ ɫ n i t ɛ lʲ ɛ n
твърд	t v ɤ r t
доктор	d ɔ k t o r
лукавец	ɫ u k a v ɛ t͡s
моден	m ɔ d ɛ n
корейски	k o r ɛ j s kʲ i
усещам	u s ɛ ʃ t ɐ m
пряк	p rʲ a k
моя	m ɔ j ɐ
възбуден	v ɐ z b u d ɛ n
нет	n ɛ t
надежден	n ɐ d ɛ ʒ d ɛ n
неутрален	n ɛ u t r a lʲ ɛ n
желаещ	ʒ ɛ ɫ a ɛ ʃ t
глезен	ɡ lʲ ɛ z ɛ n
вашто	v a ʃ t o
извлече	i z v lʲ ɛ t͡ʃ ɛ
адаптационен	ɐ d ɐ p t ɐ t͡s i ɔ n ɛ n
мраз	m r a s
икономически	i k o n o m i t͡ʃ ɛ s kʲ i
дава	d a v ɐ
скачам	s k a t͡ʃ ɐ m
католически	k ɐ t o lʲ i t͡ʃ ɛ s kʲ i
каца	k a t͡s ɐ
весел	v ɛ s ɛ ɫ
зрак	z r a k
сарма	s ɐ r m a
превъзнеса	p r ɛ v ɐ z n ɛ s ɤ
влакно	v ɫ ɐ k n ɔ
заведа	z ɐ v ɛ d ɤ
иман	i m ɐ n
губя	ɡ u bʲ ɐ
ляво	lʲ a v o
чинка	t͡ʃ i n k ɐ
свойство	s v ɔ j s t v o
бъдеще	b ɤ d ɛ ʃ t ɛ
кротък	k r ɔ t ɐ k
мряща	m rʲ a ʃ t ɐ
насече	n ɐ s ɛ t͡ʃ ɛ
нула	n u ɫ a
любов	lʲ u b ɔ f
атолитър	ɐ t o lʲ i t ɐ r
шептя	ʃ ɛ p tʲ ɤ
трипръстка	t r i p r ɤ s k ɐ
тайван	t ɐ j v a n
късно	k ɤ s n o
туристка	t u r i s k ɐ
естествен	ɛ s t ɛ s t v ɛ n
сигурен	s i ɡ u r ɛ n
станой	s t ɐ n ɔ j
длан	d ɫ a n
ядящите	j a dʲ a ʃ t i t ɛ
апология	ɐ p o ɫ ɔ ɡʲ i j ɐ
елате	ɛ ɫ a t ɛ
або	a b o
нека	n ɛ k ɐ
узаконявалата	u z ɐ k o nʲ a v ɐ ɫ ɐ t ɐ
духов	d u x o f
храсте	x r a s t ɛ
възнасям	v ɐ z n a sʲ ɐ m
тия	t i j ɐ
конкретен	k o n k r ɛ t ɛ n
стилистичен	s t i lʲ i s t i t͡ʃ ɛ n
автобаза	a f t o b a z ɐ
число	t͡ʃ i s ɫ ɔ
благоевград	b ɫ ɐ ɡ ɔ ɛ v ɡ r ɐ t
двор	d v ɔ r
юха	j u x a
братче	b r a t t͡ʃ ɛ
серен	s ɛ r ɛ n
ярост	j a r o s t
аглика	ɐ ɡ lʲ i k ɐ
писмо	p i s m ɔ
посетител	p o s ɛ t i t ɛ ɫ
затресе	z ɐ t r ɛ s ɛ
словения	s ɫ o v ɛ n i j ɐ
миролюбив	m i r o lʲ u b i f
млак	m ɫ a k
рижав	r i ʒ ɐ f
техен	t ɛ xʲ ɛ n
бърчина	b ɐ r t͡ʃ i n ɐ
щя	ʃ tʲ a
търговец	t ɐ r ɡ ɔ v ɛ t͡s
черногорски	t͡ʃ ɛ r n o ɡ ɔ r s kʲ i
мъжкар	m ɐ ʃ k a r
сума	s u m ɐ
строя	s t r o j ɤ
юлски	j u ɫ s kʲ i
мойта	m ɔ j t ɐ
помоля	p o m ɔ lʲ ɐ
интерес	i n t ɛ r ɛ s
пакет	p ɐ kʲ ɛ t
туркменистан	t u r k m ɛ n i s t a n
величав	v ɛ lʲ i t͡ʃ a f
нелеп	n ɛ lʲ ɛ p
благодарност	b ɫ ɐ ɡ o d a r n o s t
неделя	n ɛ d ɛ lʲ ɐ
дъждосвирец	d ɐ ʒ d o s v i r ɛ t͡s
наличие	n ɐ lʲ i t͡ʃ i ɛ
редица	r ɛ d i t͡s ɐ
славянин	s ɫ ɐ vʲ a n i n
някои	nʲ ɐ k ɔ i
прилика	p r i lʲ i k ɐ
прекарам	p r ɛ k a r ɐ m
поопичам	p o o p i t͡ʃ ɐ m
падало	p a d ɐ ɫ o
такива	t ɐ kʲ i v ɐ
цирей	t͡s i r ɛ j
означавам	o z n ɐ t͡ʃ a v ɐ m
проблема	p r o b lʲ ɛ m ɐ
шилинг	ʃ i lʲ i n k
седемдесет	s ɛ d ɛ m d ɛ s ɛ t
танц	t a n t͡s
мюезин	mʲ u ɛ z i n
отговарям	o d ɡ o v a rʲ ɐ m
заема	z ɐ ɛ m ɐ
ландшафт	ɫ a n t ʃ ɐ f t
сияеше	s i j a ɛ ʃ ɛ
ренде	r ɛ n d ɛ
помолвам	p o m ɔ ɫ v ɐ m
анархия	ɐ n a r xʲ i j ɐ
тъмен	t ɤ m ɛ n
чушле	t͡ʃ u ʃ lʲ ɛ
чествам	t͡ʃ ɛ s t v ɐ m
глупец	ɡ ɫ u p ɛ t͡s
южняшки	j u ʒ nʲ a ʃ kʲ i
берилий	b ɛ r i lʲ i
разшифровам	r ɐ ʃ ʃ i f r ɔ v ɐ m
узаконявало	u z ɐ k o nʲ a v ɐ ɫ o
трети	t r ɛ t i
треса	t r ɛ s ɤ
подлец	p o d lʲ ɛ t͡s
ват	v a t
август	a v ɡ u s t
поема	p o ɛ m ɐ
играя	i ɡ r a j ɐ
брош	b r ɔ ʃ
североизток	s ɛ v ɛ r o i s t o k
сияехте	s i j a ɛ x t ɛ
мренията	m r ɛ n i j ɐ t ɐ
бележка	b ɛ lʲ ɛ ʃ k ɐ
прекарвам	p r ɛ k a r v ɐ m
координационен	k o o r d i n ɐ t͡s i ɔ n ɛ n
господин	ɡ o s p o d i n
индикативен	i n d i k ɐ t i v ɛ n
частен	t͡ʃ a s t ɛ n
трактор	t r a k t o r
шунка	ʃ u n k ɐ
бедя	b ɛ dʲ ɤ
ароматен	ɐ r o m a t ɛ n
разгръщам	r ɐ z ɡ r ɤ ʃ t ɐ m
мистър	m i s t ɐ r
иманета	i m ɐ n ɛ t ɐ
рив	r i f
куя	k u j ɐ
родий	r ɔ d i
материя	m ɐ t ɛ r i j ɐ
кукувица	k u k u v i t͡s ɐ
автогара	a f t o ɡ a r ɐ
колело	k o lʲ ɛ ɫ ɔ
заемам	z ɐ ɛ m ɐ m
узаконяваните	u z ɐ k o nʲ a v ɐ n i t ɛ
яденото	j a d ɛ n o t o
побеждавам	p o b ɛ ʒ d a v ɐ m
авторитарен	ɐ f t o r i t a r ɛ n
джудже	d ʒ u d ʒ ɛ
личба	lʲ i d͡ʒ b ɐ
тилтия	t i ɫ t i j ɐ
авантюра	ɐ v ɐ n tʲ u r ɐ
ракия	r a kʲ i j a
твойто	t v ɔ j t o
особняк	o s o b nʲ a k
острица	o s t r i t͡s ɐ
имаща	i m ɐ ʃ t ɐ
говореха	ɡ o v ɔ r ɛ x ɐ
вършея	v ɐ r ʃ ɛ j ɐ
свят	s vʲ a t
пряспа	p rʲ a s p ɐ
цял	t͡sʲ a ɫ
сляза	s lʲ a z ɐ
рунтав	r u n t ɐ f
против	p r o t i f
творя	t v o rʲ a
липа	lʲ i p a
сладкарница	s ɫ ɐ t k a r n i t͡s ɐ
разрушавам	r ɐ z r u ʃ a v ɐ m
тях	tʲ a x
безразсъден	b ɛ z r ɐ s s ɤ d ɛ n
баба	b a b ɐ
бива	b i v ɐ
разговор	r a z ɡ o v o r
какаду	k ɐ k ɐ d u
климатология	k lʲ i m ɐ t o ɫ ɔ ɡʲ i j ɐ
здравей	z d r ɐ v ɛ j
гуде	ɡ u d ɛ
кокоши	k o k ɔ ʃ i
пожар	p o ʒ a r
плуг	p ɫ u k
стъпям	s t ɤ pʲ ɐ m
горист	ɡ o r i s t
акумулатор	ɐ k u m u ɫ a t o r
сприхав	s p r i x ɐ f
оставям	o s t a vʲ ɐ m
мегаметър	m ɛ ɡ ɐ m ɛ t ɐ r
ватикана	v ɐ t i k a n ɐ
бор	b ɔ r
алигатор	ɐ lʲ i ɡ a t o r
заедно	z a ɛ d n o
кат	k a t
слава	s ɫ a v ɐ
телесен	t ɛ lʲ ɛ s ɛ n
ванадий	v ɐ n a d i
аварски	ɐ v a r s kʲ i
яд	j a t
авариен	a v ɐ r i ɛ n
просба	p r ɔ z b ɐ
старец	s t a r ɛ t͡s
ядящо	j a dʲ a ʃ t o
ужасено	u ʒ ɐ s ɛ n o
солдат	s o ɫ d a t
запека	z ɐ p ɛ k ɤ
космат	k o s m a t
кубатура	k u b ɐ t u r ɐ
рений	r ɛ n i
брънка	b r ɤ n k ɐ
зрян	z rʲ a n
абдоминалната	ɐ b d o m i n a ɫ n ɐ t ɐ
билата	b i ɫ a t ɐ
дотичам	d o t i t͡ʃ ɐ m
иманите	i m ɐ n i t ɛ
алкохолен	ɐ ɫ k o x ɔ lʲ ɛ n
то	t ɔ
коря	k o rʲ ɤ
малайзийо	m ɐ ɫ a j z i j o
рицар	r i t͡s ɐ r
носия	n o s i j ɐ
нужда	n u ʒ d a
мрялото	m rʲ a ɫ o t o
имайте	i m ɐ j t ɛ
тъмница	t ɐ m n i t͡s ɐ
абортивен	ɐ b o r t i v ɛ n
редя	r ɛ dʲ a
тринадесет	t r i n a d ɛ s ɛ t
безгрижен	b ɛ z ɡ r i ʒ ɛ n
превъзхождам	p r ɛ v ɐ s x ɔ ʒ d ɐ m
амин	ɐ m i n
обходим	o p x o d i m
оногози	o n o ɡ ɔ z i
токсичност	t o k s i t͡ʃ n o s t
китайка	kʲ i t a j k ɐ
термит	t ɛ r m i t
деактивирам	d ɛ ɐ k t i v i r ɐ m
тинест	t i n ɛ s t
раня	r ɐ nʲ ɤ
струва	s t r u v a
йерарх	j ɛ r a r x
нанеса	n ɐ n ɛ s ɤ
брания	b r a n i j ɐ
миг	m i k
дръвце	d r ɐ f t͡s ɛ
пък	p ɤ k
оскъден	o s k ɤ d ɛ n
вертолет	v ɛ r t o lʲ ɛ t
изнесе	i z n ɛ s ɛ
ропот	r ɔ p o t
полза	p ɔ ɫ z ɐ
кроя	k r o j ɤ
яла	j a ɫ ɐ
следвам	s lʲ ɛ d v ɐ m
ейприл	ɛ j p r i ɫ
чувам	t͡ʃ u v ɐ m
светлик	s v ɛ t lʲ i k
бюро	bʲ u r ɔ
глагол	ɡ ɫ ɐ ɡ ɔ ɫ
показвам	p o k a z v ɐ m
родител	r o d i t ɛ ɫ
магнезий	m ɐ ɡ n ɛ z i
звяр	z vʲ a r
пазата	p ɐ z a t ɐ
мързел	m ɤ r z ɛ ɫ
пищен	p i ʃ t ɛ n
резултат	r ɛ z u ɫ t a t
старина	s t ɐ r i n a
интернационален	i n t ɛ r n ɐ t͡s i o n a lʲ ɛ n
любовник	lʲ u b ɔ v n i k
щене	ʃ t ɛ n ɛ
влека	v lʲ ɛ k ɤ
занимая	z ɐ n i m a j ɐ
съобщя	s ɐ o p ʃ tʲ ɤ
човешки	t͡ʃ o v ɛ ʃ kʲ i
сирийка	s i r i k ɐ
заплаха	z ɐ p ɫ a x ɐ
алчност	a ɫ t͡ʃ n o s t
инакво	i n a k v o
лъжи	ɫ ɐ ʒ i
месец	m ɛ s ɛ t͡s
ясминов	j ɐ s m i n o f
ядяхме	j a dʲ a x m ɛ
съдебен	s ɐ d ɛ b ɛ n
живот	ʒ i v ɔ t
огорчен	o ɡ o r t͡ʃ ɛ n
мечта	m ɛ t͡ʃ t a
олицетворение	o lʲ i t͡s ɛ t v o r ɛ n i ɛ
начало	n ɐ t͡ʃ a ɫ o
дъх	d ɤ x
щяха	ʃ tʲ a x ɐ
мърша	m ɤ r ʃ ɐ
дърво	d ɐ r v ɔ
лекарствен	lʲ ɛ k a r s t v ɛ n
аджемилък	ɐ d ʒ ɛ m i ɫ ɤ k
изненада	i z n ɛ n a d ɐ
хлапе	x ɫ ɐ p ɛ
толкоз	t ɔ ɫ k o s
деепричастие	d ɛ ɛ p r i t͡ʃ a s t i ɛ
враговете	v r a ɡ o v ɛ t ɛ
кълва	k ɐ ɫ v a
оберон	ɔ b ɛ r o n
променя	p r o m ɛ nʲ a
варшава	v ɐ r ʃ a v ɐ
кроме	k r ɔ m ɛ
рожба	r ɔ ʒ b ɐ
събитие	s ɐ b i t i ɛ
извън	i z v ɤ n
фалшив	f ɐ ɫ ʃ i f
абсурдност	ɐ p s u r d n o s t
членувана	t͡ʃ lʲ ɛ n u v ɐ n ɐ
бая	b ɐ j a
кадифе	k ɐ d i f ɛ
ананас	ɐ n ɐ n a s
отнеса	o t n ɛ s ɤ
подривен	p o d r i v ɛ n
лантан	ɫ ɐ n t a n
жалък	ʒ a ɫ ɐ k
доя	d o j ɤ
ядоха	j a d o x ɐ
движение	d v i ʒ ɛ n i ɛ
въздух	v ɤ z d u x
медник	m ɛ d n i k
юнакиня	j u n ɐ kʲ i nʲ ɐ
кой	k ɔ j
арамия	ɐ r ɐ m i j ɐ
сенокосец	s ɛ n o k ɔ s ɛ t͡s
ад	a t
оногова	o n o ɡ ɔ v ɐ
зри	z r i
справедливост	s p r ɐ v ɛ d lʲ i v o s t
каквато	k ɐ k v a t o
вашта	v a ʃ t ɐ
дециметър	d ɛ t͡s i m ɛ t ɐ r
повторим	p o f t o r i m
пари	p a r i
отрязък	o t rʲ a z ɐ k
роветина	r o v ɛ t i n ɐ
подчертавам	p o t t͡ʃ ɛ r t a v ɐ m
иванов	i v a n o f
адамов	ɐ d a m o f
изговори	i z ɡ o v o r i
говориш	ɡ o v ɔ r i ʃ
разболявам	r ɐ z b o lʲ a v ɐ m
жаба	ʒ a b ɐ
ябълка	j a b ɐ ɫ k ɐ
нобелий	n o b ɛ lʲ i
узаконяванета	u z ɐ k o nʲ a v ɐ n ɛ t ɐ
канара	k ɐ n ɐ r a
мишца	m i ʃ t͡s ɐ
села	s ɛ ɫ a
кубичен	k u b i t͡ʃ ɛ n
паслия	p a s lʲ i j ɐ
четиридесет	t͡ʃ ɛ t i r i d ɛ s ɛ t
боязън	b o j a z ɐ n
парфюм	p ɐ r fʲ u m
вест	v ɛ s t
закова	z ɐ k o v a
допрочета	d o p r o t͡ʃ ɛ t ɤ
уплашвам	u p ɫ a ʃ v ɐ m
шал	ʃ a ɫ
браташ	b r ɐ t a ʃ
гулия	ɡ u lʲ i j ɐ
оставя	o s t a vʲ ɐ
въдя	v ɤ dʲ ɐ
поп	p ɔ p
тревист	t r ɛ v i s t
вар	v a r
щом	ʃ t ɔ m
абисински	ɐ b i s i n s kʲ i
кост	k ɔ s t
у	u
харон	x ɐ r ɔ n
космополитен	k o s m o p o lʲ i t ɛ n
чопка	t͡ʃ ɔ p k ɐ
бонус	b ɔ n u s
биле	b i lʲ ɛ
икономичен	i k o n o m i t͡ʃ ɛ n
миши	m i ʃ i
патладжан	p ɐ t ɫ ɐ d ʒ a n
антитяло	a n t i tʲ a ɫ o
лев	lʲ ɛ f
глина	ɡ lʲ i n ɐ
експедиция	ɛ k s p ɛ d i t͡s i j ɐ
дърва	d ɐ r v a
абдикирайте	ɐ b d i kʲ i r ɐ j t ɛ
падна	p a d n ɐ
числително	t͡ʃ i s lʲ i t ɛ ɫ n o
нарече	n ɐ r ɛ t͡ʃ ɛ
дарба	d a r b ɐ
кюрий	kʲ u r i
нагриза	n ɐ ɡ r i z ɐ
герасим	ɡʲ ɛ r a s i m
завирушка	z ɐ v i r u ʃ k ɐ
нито	n i t o
оженя	o ʒ ɛ nʲ ɐ
размяна	r ɐ z mʲ a n ɐ
мряхме	m rʲ a x m ɛ
блед	b lʲ ɛ t
целува	t͡s ɛ ɫ u v a
абсолютизъм	ɐ p s o lʲ u t i z ɐ m
носорог	n o s o r ɔ k
риж	r i ʃ
ласка	ɫ a s k ɐ
клиент	k lʲ i ɛ n t
абитуриент	ɐ b i t u r i ɛ n t
единадесет	ɛ d i n a d ɛ s ɛ t
ядените	j a d ɛ n i t ɛ
тръне	t r ɤ n ɛ
брегове	b r ɛ ɡ o v ɛ
токачка	t o k a t͡ʃ k ɐ
бележа	b ɛ lʲ ɛ ʒ ɐ
европа	ɛ v r ɔ p ɐ
експедиционен	ɛ k s p ɛ d i t͡s i ɔ n ɛ n
чуваш	t͡ʃ u v ɐ ʃ
тъмнина	t ɐ m n i n a
селен	s ɛ lʲ ɛ n
огорча	o ɡ o r t͡ʃ a
превозен	p r ɛ v o z ɛ n
козодой	k o z o d ɔ j
хроничен	x r o n i t͡ʃ ɛ n
дебна	d ɛ b n a
боец	b o ɛ t͡s
екран	ɛ k r a n
хидроелектричен	xʲ i d r o ɛ lʲ ɛ k t r i t͡ʃ ɛ n
гълъбица	ɡ ɐ ɫ ɐ b i t͡s ɐ
лъч	ɫ ɤ t͡ʃ
шейна	ʃ ɛ j n a
например	n ɐ p r i m ɛ r
клей	k lʲ ɛ j
март	m a r t
съзвездие	s ɐ z v ɛ z d i ɛ
челце	t͡ʃ ɛ ɫ t͡s ɛ
музей	m u z ɛ j
аерогара	a ɛ r o ɡ a r ɐ
неловък	n ɛ ɫ ɔ v ɐ k
течение	t ɛ t͡ʃ ɛ n i ɛ
юбилей	j u b i lʲ ɛ j
съдба	s ɐ d b a
поличба	p o lʲ i d͡ʒ b ɐ
стефан	s t ɛ f ɐ n
кучи	k u t͡ʃ i
печален	p ɛ t͡ʃ a lʲ ɛ n
гибел	ɡʲ i b ɛ ɫ
изпявам	i s pʲ a v ɐ m
мразилник	m r ɐ z i ɫ n i k
абразивен	ɐ b r ɐ z i v ɛ n
октомври	o k t ɔ m v r i
тон	t ɔ n
чък	t͡ʃ ɤ k
въсат	v ɐ s a t
син	s i n
ром	r ɔ m
децилитър	d ɛ t͡s i lʲ i t ɐ r
кайгана	k ɐ j ɡ ɐ n a
метна	m ɛ t n ɐ
орех	ɔ r ɛ x
щъркел	ʃ t ɤ r kʲ ɛ ɫ
желаещо	ʒ ɛ ɫ a ɛ ʃ t o
деймос	d ɛ j m o s
чародей	t͡ʃ ɐ r o d ɛ j
февруари	f ɛ v r u a r i
наведе	n ɐ v ɛ d ɛ
юфка	j u f k ɐ
довлея	d o v lʲ ɛ j ɐ
ограничен	o ɡ r ɐ n i t͡ʃ ɛ n
татко	t a t k o
шок	ʃ ɔ k
школа	ʃ k ɔ ɫ ɐ
масло	m a s ɫ o
бром	b r ɔ m
авлига	ɐ v lʲ i ɡ ɐ
уплаши	u p ɫ a ʃ i
юли	j u lʲ i
наш	n a ʃ
абсорбирания	ɐ p s o r b i r ɐ n i j ɐ
ала	a ɫ ɐ
четка	t͡ʃ ɛ t k ɐ
лют	lʲ u t
обесвам	o b ɛ s v ɐ m
премяна	p r ɛ mʲ a n ɐ
естонски	ɛ s t ɔ n s kʲ i
узаконявахме	u z ɐ k o nʲ a v ɐ x m ɛ
вой	v ɔ j
бабанка	b ɐ b a n k ɐ
мостик	m ɔ s t i k
узаконяваха	u z ɐ k o nʲ a v ɐ x ɐ
убийство	u b i s t v o
витег	v i t ɛ k
червей	t͡ʃ ɛ r v ɛ j
примирам	p r i m i r ɐ m
бъдете	b ɐ d ɛ t ɛ
внимателно	v n i m a t ɛ ɫ n o
имана	i m ɐ n ɐ
гробище	ɡ r ɔ b i ʃ t ɛ
кофа	k ɔ f ɐ
възпитание	v ɐ s p i t a n i ɛ
лава	ɫ a v ɐ
танцувам	t ɐ n t͡s u v ɐ m
валя	v ɐ lʲ ɤ
сричка	s r i t͡ʃ k ɐ
бекасина	b ɛ k ɐ s i n ɐ
братя	b r a tʲ ɐ
онакива	o n ɐ kʲ i v ɐ
подозра	p o d o z r ɤ
турна	t u r n a
брада	b r ɐ d a
мляко	m lʲ a k o
сладост	s ɫ a d o s t
реч	r ɛ t͡ʃ
нежен	n ɛ ʒ ɛ n
узаконявай	u z ɐ k o nʲ a v ɐ j
литовски	lʲ i t ɔ f s kʲ i
комитет	k o m i t ɛ t
руски	r u s kʲ i
автентичен	a f t ɛ n t i t͡ʃ ɛ n
узаконяващия	u z ɐ k o nʲ a v ɐ ʃ t i j ɐ
обятия	o bʲ a t i j ɐ
божи	b ɔ ʒ i
изковавам	i s k o v a v ɐ m
цупя	t͡s u pʲ ɐ
авиотакси	a v i o t ɐ k s i
сивкав	s i f k ɐ f
узаконях	u z ɐ k o nʲ a x
ноември	n o ɛ m v r i
пасене	p ɐ s ɛ n ɛ
ям	j a m
женен	ʒ ɛ n ɛ n
лис	lʲ i s
предприемач	p r ɛ t p r i ɛ m a t͡ʃ
пасящото	p ɐ sʲ a ʃ t o t o
двигател	d v i ɡ ɐ t ɛ ɫ
аз	a s
обсъждам	o p s ɤ ʒ d ɐ m
по	p ɔ
вадя	v a dʲ ɐ
веселие	v ɛ s ɛ lʲ i ɛ
кресло	k r ɛ s ɫ ɔ
спален	s p a lʲ ɛ n
дългуч	d ɐ ɫ ɡ u t͡ʃ
ловец	ɫ o v ɛ t͡s
прилеп	p r i lʲ ɛ p
птица	p t i t͡s ɐ
обезглавя	o b ɛ z ɡ ɫ ɐ vʲ ɤ
петле	p ɛ t lʲ ɛ
обед	ɔ b ɛ t
напротив	n ɐ p r ɔ t i f
изтребвам	i s t r ɛ b v ɐ m
ме	m ɛ
сък	s ɤ k
изобщо	i z ɔ p ʃ t o
повтором	p o f t ɔ r o m
водоизпускател	v ɔ d o i s p u s k a t ɛ ɫ
буна	b u n ɐ
зърнест	z ɤ r n ɛ s t
ищай	i ʃ t a j
плащам	p ɫ a ʃ t ɐ m
видая	v i d a j ɐ
непорочност	n ɛ p o r ɔ t͡ʃ n o s t
хала	x a ɫ ɐ
одринлия	ɔ d r i n lʲ i j ɐ
чук	t͡ʃ u k
чавка	t͡ʃ a f k ɐ
промеждутък	p r o m ɛ ʒ d u t ɐ k
обратно	o b r a t n o
господарски	ɡ o s p o d a r s kʲ i
покажа	p o k a ʒ ɐ
ръководител	r ɐ k o v o d i t ɛ ɫ
спичам	s p i t͡ʃ ɐ m
чутя	t͡ʃ u tʲ ɐ
веда	v ɛ d ɐ
слон	s ɫ ɔ n
среда	s r ɛ d a
подслушам	p o t s ɫ u ʃ ɐ m
абонаментен	ɐ b o n ɐ m ɛ n t ɛ n
невъзможен	o o o o o
рева	r ɛ v a
леля	lʲ ɛ lʲ ɐ
войски	v o j s kʲ i
улулица	u ɫ u lʲ i t͡s ɐ
без	b ɛ s
кръсточовка	k r ɐ s t o t͡ʃ ɔ f k ɐ
слагам	s ɫ a ɡ ɐ m
изслушвам	i s ɫ u ʃ v ɐ m
мамин	m a m i n
решителен	r ɛ ʃ i t ɛ lʲ ɛ n
ателие	ɐ t ɛ lʲ i ɛ
зноен	z n ɔ ɛ n
направя	n ɐ p r a vʲ ɐ
говорихме	ɡ o v o r i x m ɛ
хладно	x ɫ a d n o
промяна	p r o mʲ a n ɐ
дома	d o m a
касация	k ɐ s a t͡s i j ɐ
план	p ɫ a n
цербер	t͡s ɛ r b ɛ r
белодробен	b ɛ ɫ o d r ɔ b ɛ n
узаконяващите	u z ɐ k o nʲ a v ɐ ʃ t i t ɛ
хулиганство	x u lʲ i ɡ a n s t v o
окажа	o k a ʒ ɐ
главоч	ɡ ɫ ɐ v ɔ t͡ʃ
грапав	ɡ r a p ɐ f
пубер	p u b ɛ r
напека	n ɐ p ɛ k ɤ
прав	p r a f
дърводелец	d ɐ r v o d ɛ lʲ ɛ t͡s
глобя	ɡ ɫ o bʲ ɤ
букурещ	b u k u r ɛ ʃ t
платя	p ɫ ɐ tʲ ɤ
всуе	f s u ɛ
декалитър	d ɛ k ɐ lʲ i t ɐ r
мисъл	m i s ɐ ɫ
гърци	ɡ ɤ r t͡s i
правилник	p r a v i ɫ n i k
мойто	m ɔ j t o
каня	k a nʲ ɐ
сребрист	s r ɛ b r i s t
любеница	lʲ u b ɛ n i t͡s ɐ
съблазнявам	s ɐ b ɫ ɐ z nʲ a v ɐ m
единица	ɛ d i n i t͡s ɐ
тучен	t u t͡ʃ ɛ n
градус	ɡ r a d u s
кралски	k r a ɫ s kʲ i
наркотик	n ɐ r k o t i k
кълвач	k ɐ ɫ v a t͡ʃ
цупят	t͡s u pʲ ɐ t
арестува	a r ɛ s t u v a
погреба	p o ɡ r ɛ b ɐ
варна	v a r n ɐ
елементарен	ɛ lʲ ɛ m ɛ n t a r ɛ n
балнеолечение	b a ɫ n ɛ o lʲ ɛ t͡ʃ ɛ n i ɛ
абсолвентски	a p s o ɫ v ɛ n t s kʲ i
говорете	ɡ o v o r ɛ t ɛ
благой	b ɫ ɐ ɡ ɔ j
бъди	b ɐ d i
физически	f i z i t͡ʃ ɛ s kʲ i
зряхте	z rʲ a x t ɛ
ядох	j a d o x
ровина	r o v i n ɐ
онакова	o n ɐ k ɔ v ɐ
улица	u lʲ i t͡s ɐ
ноже	n o ʒ ɛ
уолдо	u ɔ ɫ d o
бил	b i ɫ
спорен	s p ɔ r ɛ n
право	p r a v o
тръпчив	t r ɐ p t͡ʃ i f
епос	ɛ p o s
поща	p ɔ ʃ t ɐ
наште	n a ʃ t ɛ
никоя	n i k o j ɐ
накаже	n ɐ k a ʒ ɛ
ливада	lʲ i v a d ɐ
карти	k a r t i
предвиждам	p r ɛ d v i ʒ d ɐ m
ръка	r ɐ k a
остана	o s t a n ɐ
препоръчам	p r ɛ p o r ɤ t͡ʃ ɐ m
безпаричен	b ɛ s p ɐ r i t͡ʃ ɛ n
твойте	t v ɔ j t ɛ
имала	i m a ɫ ɐ
мътен	m ɤ t ɛ n
озаглавявам	o z ɐ ɡ ɫ ɐ vʲ a v ɐ m
декември	d ɛ kʲ ɛ m v r i
петрол	p ɛ t r ɔ ɫ
шестдесет	ʃ ɛ z d ɛ s ɛ t
необходим	n ɛ o p x o d i m
късам	k ɤ s ɐ m
седна	s ɛ d n a
досега	d o s ɛ ɡ a
забележа	z ɐ b ɛ lʲ ɛ ʒ ɐ
гълъб	ɡ ɤ ɫ ɐ p
мъхнат	m ɐ x n a t
съвсем	s ɐ f s ɛ m
топъл	t ɔ p ɐ ɫ
огнище	o ɡ n i ʃ t ɛ
ономува	o n o m u v ɐ
китайски	kʲ i t a j s kʲ i
сянка	sʲ a n k ɐ
къжлица	k ɐ ʒ lʲ i t͡s ɐ
отново	o t n ɔ v o
сараево	s ɐ r a ɛ v o
мощност	m ɔ ʃ n o s t
асансьор	ɐ s ɐ n sʲ ɔ r
дявол	dʲ a v o ɫ
джийн	d ʒ i n
мренетата	m r ɛ n ɛ t ɐ t ɐ
годинак	ɡ o d i n a k
основател	o s n o v a t ɛ ɫ
аперитив	a p ɛ r i t i f
камила	k ɐ m i ɫ ɐ
ушивам	u ʃ i v ɐ m
сипей	s i p ɛ j
вуйчо	v u j t͡ʃ o
резедав	r ɛ z ɛ d a f
дьо	dʲ ɔ
лакей	ɫ ɐ kʲ ɛ j
иглика	i ɡ lʲ i k ɐ
опозиционен	o p o z i t͡s i ɔ n ɛ n
боб	b ɔ p
узаконяваше	u z ɐ k o nʲ a v ɐ ʃ ɛ
словакия	s ɫ o v a kʲ i j ɐ
мече	m ɛ t͡ʃ ɛ
гръм	ɡ r ɤ m
портрет	p o r t r ɛ t
вериго	v ɛ r i ɡ o
буди	b u d i
стреме	s t r ɛ m ɛ
хоризонтален	x o r i z o n t a lʲ ɛ n
славянски	s ɫ ɐ vʲ a n s kʲ i
мафия	m a f i j ɐ
добре	d o b r ɛ
педя	p ɛ dʲ ɐ
сприятеля	s p r i j ɐ t ɛ lʲ ɤ
аборигенче	a b o r i ɡʲ ɛ n t͡ʃ ɛ
азе	a z ɛ
напластяване	n ɐ p ɫ ɐ s tʲ a v ɐ n ɛ
приятен	p r i j a t ɛ n
огън	ɔ ɡ ɐ n
тиква	t i k v ɐ
червеношийка	t͡ʃ ɛ r v ɛ n o ʃ i k ɐ
възкръсвам	v ɐ s k r ɤ s v ɐ m
оса	o s a
яйцевиден	j a j t͡s ɛ v i d ɛ n
съседен	s ɐ s ɛ d ɛ n
кислород	kʲ i s ɫ o r ɔ t
науча	n ɐ u t͡ʃ ɐ
хладен	x ɫ a d ɛ n
отказвам	o t k a z v ɐ m
годеница	ɡ o d ɛ n i t͡s ɐ
въоръжа	v ɐ o r ɐ ʒ ɤ
слой	s ɫ ɔ j
пухест	p u xʲ ɛ s t
нашето	n a ʃ ɛ t o
цинк	t͡s i n k
арестувах	a r ɛ s t u v a x
невеж	n ɛ v ɛ ʃ
милостиня	m i ɫ o s t i nʲ ɐ
епископе	ɛ p i s k o p i t ɛ
нахапя	n ɐ x a pʲ ɐ
тежа	t ɛ ʒ ɤ
случай	s ɫ u t͡ʃ a j
кошница	k ɔ ʃ n i t͡s ɐ
зярвам	zʲ a r v ɐ m
после	p ɔ s lʲ ɛ
отдавнашен	o d d a v n ɐ ʃ ɛ n
разлат	r ɐ z ɫ a t
глас	ɡ ɫ a s
позволително	p o z v o lʲ i t ɛ ɫ n o
винце	v i n t͡s ɛ
вяра	vʲ a r ɐ
ганимед	ɡ ɐ n i m ɛ t
едноличен	ɛ d n o lʲ i t͡ʃ ɛ n
слуга	s ɫ u ɡ a
съединител	s ɐ ɛ d i n i t ɛ ɫ
пуст	p u s t
филолог	f i ɫ o ɫ ɔ k
два	d v a
автобус	ɐ f t o b u s
щърбав	ʃ t ɤ r b ɐ f
звучен	z v u t͡ʃ ɛ n
спасявам	s p ɐ sʲ a v ɐ m
ясно	j a s n o
бавноходка	b ɐ v n o x ɔ t k ɐ
бида	b i d ɐ
немец	n ɛ m ɛ t͡s
щяхме	ʃ tʲ a x m ɛ
изгледам	i z ɡ lʲ ɛ d ɐ m
крагуй	k r ɐ ɡ u j
брега	b r ɛ ɡ a
съд	s ɤ t
средновековие	s r ɛ d n o v ɛ k ɔ v i ɛ
пенис	p ɛ n i s
адет	ɐ d ɛ t
фотограф	f o t o ɡ r a f
страхливец	s t r ɐ x lʲ i v ɛ t͡s
буляк	b u lʲ ɐ k
сочен	s ɔ t͡ʃ ɛ n
пръстен	p r ɤ s t ɛ n
вишна	v i ʃ n ɐ
художествен	x u d ɔ ʒ ɛ s t v ɛ n
труден	t r u d ɛ n
плав	p ɫ a f
никое	n i k o ɛ
учителски	u t͡ʃ i t ɛ ɫ s kʲ i
чул	t͡ʃ u ɫ
шоколад	ʃ o k o ɫ a t
ватра	v a t r ɐ
лозунг	ɫ ɔ z u n k
корея	k o r ɛ j ɐ
работничка	r ɐ b ɔ t n i t͡ʃ k ɐ
инстинкт	i n s t i n k t
сестричка	s ɛ s t r i t͡ʃ k ɐ
комар	k o m a r
глобявам	ɡ ɫ o bʲ a v ɐ m
рига	r i ɡ ɐ
съвършенство	s ɐ v ɐ r ʃ ɛ n s t v o
полувреме	p o ɫ u v r ɛ m ɛ
узаконили	u z ɐ k o n i lʲ i
страница	s t r a n i t͡s ɐ
стилов	s t i ɫ o f
скок	s k ɔ k
ориентационен	o r i ɛ n t ɐ t͡s i ɔ n ɛ n
париж	p ɐ r i ʃ
вино	v i n o
румънец	r u m ɤ n ɛ t͡s
късмет	k ɐ s m ɛ t
брегобегач	b r ɛ ɡ o b ɛ ɡ a t͡ʃ
гавед	ɡ a v ɛ t
малайзия	m ɐ ɫ a j z i j ɐ
победя	p o b ɛ dʲ ɤ
колбас	k o ɫ b a s
изток	i s t o k
всякаква	f sʲ a k ɐ k v ɐ
аеротакси	a ɛ r o t ɐ k s i
уши	u ʃ i
свитък	s v i t ɐ k
канарче	k ɐ n a r t͡ʃ ɛ
баня	b a nʲ ɐ
тенесин	t ɛ n ɛ s i n
трезв	t r ɛ s f
щипалка	ʃ t i p a ɫ k ɐ
оди	ɔ d i
сера	s ɛ r ɤ
крастав	k r a s t ɐ f
управителен	u p r a v i t ɛ lʲ ɛ n
ангелина	ɐ n ɡʲ ɛ lʲ i n ɐ
плавей	p ɫ a v ɛ j
буен	b u ɛ n
веднага	v ɛ d n a ɡ ɐ
германий	ɡʲ ɛ r m a n i
потурнак	p o t u r n a k
гигаметър	ɡʲ i ɡ ɐ m ɛ t ɐ r
повеляем	p o v ɛ lʲ a ɛ m
където	k ɐ d ɛ t o
лимони	lʲ i m ɔ n i
куфар	k u f ɐ r
дилянка	d i lʲ a n k ɐ
образован	o b r ɐ z ɔ v ɐ n
срам	s r a m
фотоапарат	f ɔ t o ɐ p ɐ r a t
прекалено	p r ɛ k ɐ lʲ ɛ n o
взрив	v z r i f
тъща	t ɤ ʃ t ɐ
почивш	p o t͡ʃ i f ʃ
позитрон	p o z i t r ɔ n
узаконило	u z ɐ k o n i ɫ o
сое	s ɔ ɛ
диаграма	d i ɐ ɡ r a m ɐ
заслужавам	z ɐ s ɫ u ʒ a v ɐ m
давам	d a v ɐ m
жасминов	ʒ ɐ s m i n o f
понеса	p o n ɛ s ɤ
стилистка	s t i lʲ i s k ɐ
пасем	p ɐ s ɛ m
тикам	t i k ɐ m
стисна	s t i s n ɐ
договор	d ɔ ɡ o v o r
ужасявам	u ʒ ɐ sʲ a v ɐ m
противен	p r o t i v ɛ n
кюлоти	kʲ u ɫ ɔ t i
електронен	ɛ lʲ ɛ k t r ɔ n ɛ n
хилядолетен	xʲ i lʲ ɐ d o lʲ ɛ t ɛ n
лая	ɫ a j a
сиборгий	s i b ɔ r ɡʲ i
юда	j u d ɐ
принеса	p r i n ɛ s ɤ
августовски	a v ɡ u s t o f s kʲ i
узаконявалия	u z ɐ k o nʲ a v ɐ lʲ i j ɐ
започвам	z ɐ p ɔ t͡ʃ v ɐ m
мирта	m i r t ɐ
яли	j a lʲ i
роля	r ɔ lʲ ɐ
драгаш	d r ɐ ɡ a ʃ
безсмъртен	b ɛ s s m ɤ r t ɛ n
утка	u t k ɐ
килолитър	kʲ i ɫ o lʲ i t ɐ r
техния	t ɛ x n i j ɐ
щир	ʃ t i r
чао	t͡ʃ a o
кале	k ɐ lʲ ɛ
лейди	lʲ ɛ j d i
великан	v ɛ lʲ i k a n
решим	r ɛ ʃ i m
парещ	p a r ɛ ʃ t
повторно	p o f t ɔ r n o
имания	i m ɐ n i j ɐ
леща	lʲ ɛ ʃ t ɐ
губи	ɡ u b i
въжен	v ɤ ʒ ɛ n
раста	r ɐ s t ɤ
фенер	f ɛ n ɛ r
пижек	p i ʒ ɛ k
ням	nʲ a m
капя	k a pʲ ɐ
смъртница	s m ɤ r t n i t͡s ɐ
русло	r u s ɫ o
криеница	k r i ɛ n i t͡s ɐ
папуняк	p ɐ p u nʲ ɐ k
крехък	k r ɛ x ɐ k
плешив	p lʲ ɛ ʃ i f
септември	s ɛ p t ɛ m v r i
град	ɡ r a t
моите	m ɔ i t ɛ
лае	ɫ a ɛ
позлата	p o z ɫ a t ɐ
брия	b r i j ɐ
том	t ɔ m
шибой	ʃ i b ɔ j
зъбест	z ɤ b ɛ s t
мрялата	m rʲ a ɫ ɐ t ɐ
аржентина	ɐ r ʒ ɛ n t i n ɐ
