валенком	v a lʲ i n k a m
предписываться	p rʲ i t pʲ i s i v a t͡s a
обтёсывают	a p tʲ o s i v a j u t
подействовать	p a dʲ e j s t v a v a tʲ
пересказываем	pʲ i rʲ i s k a z i v a j i m
осведомляющийся	a s vʲ i d a m lʲ a j u ɕː i j sʲ a
процедуру	p r a t͡s i d u r u
шарахать	ʂ a r a x a tʲ
вседозволенностях	f sʲ i d a z v o lʲ i n a sʲ tʲ a x
рецептора	rʲ i t͡s e p t a r a
смудрит	s m u d rʲ i t
радикалу	r a dʲ i k a ɫ u
бронетехникою	b r o nʲ i tʲ e x nʲ i k a j u
вакансию	v a k a n ⁽ʲ ⁾ sʲ i j u
ошеломлением	a ʂ i ɫ a m lʲ e nʲ i j i m
кроссовках	k r a s o f k a x
выкраивал	v i k r a i v a ɫ
пронюхиваете	p r a nʲ u xʲ i v a j i tʲ e
кровоснабжение	k r a v a s n a b ʐ e nʲ i j e
красно	k r a s n a
прыснет	p r i sʲ nʲ i t
сигнализации	sʲ i ɡ n a lʲ i z a t͡s i i
зацепляло	z a t͡s i p lʲ a ɫ a
перебрасывающийся	pʲ i rʲ i b r a s i v a j u ɕː i j sʲ a
уточняй	u t a t͡ɕ nʲ a j
клади	k ɫ a dʲ i
рогаликом	r a ɡ a lʲ i k a m
монголом	m a n ɡ o ɫ a m
поджогами	p a d͡ʐ ʐ o ɡ a mʲ i
растворителя	r a s t v a rʲ i tʲ i lʲ a
откашлявшись	a t k a ʂ lʲ i f ʂ i sʲ
уполномоченный	u p a ɫ n a m o t͡ɕ i n i j
совершенный	s a vʲ i r ʂ e n i j
мхом	m x o m
вёсла	vʲ o s ɫ a
генералитете	ɡʲ i nʲ i r a lʲ i tʲ e tʲ e
приводили	p rʲ i v a dʲ i lʲ i
выставляясь	v i s t a v lʲ a j i sʲ
гомони	ɡ a m a nʲ i
заслышит	z a s ɫ i ʂ i t
створу	s t v o r u
таскавшись	t a s k a f ʂ i sʲ
волочилось	v a ɫ a t͡ɕ i ɫ a sʲ
файликах	f a j lʲ i k a x
гонялись	ɡ a nʲ a lʲ i sʲ
мешковиною	mʲ i ʂ k a vʲ i n a j u
подведём	p a d vʲ i dʲ o m
взбираетесь	v z bʲ i r a j i tʲ i sʲ
общагою	a p ɕː a ɡ a j u
размягчаемый	r a z mʲ i x t͡ɕ a j i m i j
надушу	n a d u ʂ u
тружусь	t r u ʐ u sʲ
сплетениями	s p lʲ i tʲ e nʲ i j a mʲ i
послушался	p a s ɫ u ʂ a ɫ s ⁽ʲ ⁾ a
вампирах	v a m ⁽ʲ ⁾ pʲ i r a x
ватка	v a t k a
него	nʲ i v o
западаешь	z a p a d a j i ʂ
сконфузят	s k a n f u zʲ a t
беспощадно	bʲ i s p a ɕː a d n a
ветютнями	vʲ i tʲ u tʲ nʲ a mʲ i
длительный	d lʲ i tʲ i lʲ n i j
шумов	ʂ u m a f
закричали	z a k rʲ i t͡ɕ a lʲ i
туманностях	t u m a n a sʲ tʲ a x
прорежется	p r a rʲ e ʐ i t͡s a
ворвитесь	v a r vʲ i tʲ i sʲ
подлокотником	p a d ɫ a k o tʲ nʲ i k a m
бакинки	b a kʲ i n kʲ i
доползёт	d a p a ɫ zʲ o t
разочаровываешь	r a z a t͡ɕ i r o v i v a j i ʂ
секирам	sʲ i kʲ i r a m
оттискиваем	a tʲː i s kʲ i v a j i m
генетикам	ɡʲ i n e tʲ i k a m
затаптывавши	z a t a p t i v a f ʂ i
штрафанёте	ʂ t r a f a nʲ o tʲ e
затрудни	z a t r u dʲ nʲ i
зевал	zʲ i v a ɫ
литром	lʲ i t r a m
допустимость	d a p u sʲ tʲ i m a sʲ tʲ
дрейфами	d rʲ e j f a mʲ i
спросите	s p r o sʲ i tʲ e
увенчался	u vʲ i nʲ t͡ɕ a ɫ s ⁽ʲ ⁾ a
реквизита	rʲ i k vʲ i zʲ i t a
зубра	z u b r a
ухаживавши	u x a ʐ i v a f ʂ i
ненадобный	nʲ i n a d a b n i j
плевав	p lʲ i v a f
оттаскивай	a t a s kʲ i v a j
привязь	p rʲ i vʲ i sʲ
выявишься	v i j i vʲ i ʂ sʲ a
операция	a pʲ i r a t͡s i j a
рефракторе	rʲ i f r a k t a rʲ e
горячностям	ɡ a rʲ a t͡ɕ n a sʲ tʲ a m
мякните	mʲ a k nʲ i tʲ e
добивавшийся	d a bʲ i v a f ʂ i j sʲ a
литовцах	lʲ i t o f t͡s a x
добычи	d a b i t͡ɕ i
убирайте	u bʲ i r a j tʲ e
змиям	z mʲ i j a m
выметаю	v i mʲ i t a j u
генпрокурорам	ɡʲ e n p r a k u r o r a m
азиками	a zʲ i k a mʲ i
харьковчанах	x a rʲ k a f t͡ɕ a n a x
заблагорассудим	z a b ɫ a ɡ a r a s u dʲ i m
подрастала	p a d r a s t a ɫ a
хусткою	x u s t k a j u
грузимый	ɡ r u zʲ i m i j
выломлю	v i ɫ a m lʲ u
маневренностями	m a nʲ e v rʲ i n a sʲ tʲ a mʲ i
прояснениями	p r a j i sʲ nʲ e nʲ i j a mʲ i
заимеет	z a i mʲ e j i t
обыгравший	a b i ɡ r a f ʂ i j
ознакомляемся	a z n a k a m lʲ a j i m sʲ a
бедуина	bʲ i d u i n a
плутон	p ɫ u t o n
перетягивавши	pʲ i rʲ i tʲ a ɡʲ i v a f ʂ i
ябедой	j a bʲ i d a j
стукнулся	s t u k n u ɫ s ⁽ʲ ⁾ a
оросил	a r a sʲ i ɫ
русифицируешься	r u sʲ i fʲ i t͡s i r u j i ʂ sʲ a
потёрла	p a tʲ o r ɫ a
перекупаем	pʲ i rʲ i k u p a j i m
полётом	p a lʲ o t a m
государственникам	ɡ a s u d a r s t vʲ i nʲ i k a m
притягаете	p rʲ i tʲ i ɡ a j i tʲ e
лайкнула	ɫ a j k n u ɫ a
взыскавши	v z i s k a f ʂ i
аншлюсов	a n ʂ lʲ u s a f
хламы	x ɫ a m i
невежественна	nʲ i vʲ e ʐ i s t vʲ i n a
всхлипываниями	f s x lʲ i p i v a nʲ i j a mʲ i
плеоназм	p lʲ i a n a z m
анемоном	a nʲ i m o n a m
буккеры	b u kʲ i r i
выращивание	v i r a ɕː i v a nʲ i j e
паникёр	p a nʲ i kʲ o r
разъём	r a z j o m
надоедания	n a d a j i d a nʲ i j a
эклер	i k lʲ e r
накалывать	n a k a ɫ i v a tʲ
вышагнувши	v i ʂ a ɡ n u f ʂ i
губерниях	ɡ u bʲ e r nʲ i j a x
опрокинул	a p r a kʲ i n u ɫ
британцев	b rʲ i t a n t͡s i f
закипим	z a kʲ i pʲ i m
корыту	k a r i t u
заколебать	z a k a lʲ i b a tʲ
пионеру	pʲ i a nʲ e r u
выломай	v i ɫ a m a j
мале	m a lʲ e
вкалывая	f k a ɫ i v a j a
претенденткою	p rʲ i tʲ i nʲ dʲ e n t k a j u
задумках	z a d u m k a x
злоключением	z ɫ a k lʲ u t͡ɕ e nʲ i j i m
владиславом	v ɫ a dʲ i s ɫ a v a m
пожирает	p a ʐ i r a j i t
вставишься	f s t a vʲ i ʂ sʲ a
обливающийся	a b lʲ i v a j u ɕː i j sʲ a
кастаньеты	k a s t a nʲ j e t i
пользованиях	p o lʲ z a v a nʲ i j a x
приземлилась	p rʲ i zʲ i m lʲ i ɫ a sʲ
запонок	z a p a n a k
префикса	p rʲ e fʲ i k s a
правобережный	p r a v a bʲ i rʲ e ʐ n i j
оплыли	a p ɫ i lʲ i
презрел	p rʲ i z rʲ e ɫ
задремлешь	z a d rʲ e m lʲ i ʂ
походов	p a x o d a f
зарвёшься	z a r vʲ o ʂ sʲ a
посвистывали	p a s vʲ i s t i v a lʲ i
объезжав	a b j i ʐ a f
доверяете	d a vʲ i rʲ a j i tʲ e
протестуешь	p r a tʲ i s t u j i ʂ
прославляйтесь	p r a s ɫ a v lʲ a j tʲ i sʲ
вокзалах	v a ɡ z a ɫ a x
реабилитируем	rʲ i a bʲ i lʲ i tʲ i r u j i m
металась	mʲ i t a ɫ a sʲ
шахназаров	ʂ a x n a z a r a f
тын	t i n
грязнувший	ɡ rʲ a z n u f ʂ i j
мясорубками	mʲ i s a r u p k a mʲ i
поправишь	p a p r a vʲ i ʂ
учредительный	u t͡ɕ rʲ i dʲ i tʲ i lʲ n i j
подмигивай	p a d mʲ i ɡʲ i v a j
чугунно	t͡ɕ u ɡ u n a
мастодонты	m a s t a d o n t i
груздям	ɡ r u zʲ dʲ a m
блютус	b lʲ u t u s
одиноко	a dʲ i n o k a
мыслях	m i s ⁽ʲ ⁾ lʲ a x
осечкам	a sʲ e t͡ɕ k a m
льда	lʲ d a
познать	p a z n a tʲ
годы	ɡ o d i
фляжек	f lʲ a ʐ i k
шпионке	ʂ pʲ i o n kʲ e
чахотке	t͡ɕ i x o t kʲ e
попросись	p a p r a sʲ i sʲ
водосгон	v a d a z ɡ o n
ущемлениями	u ɕː i m lʲ e nʲ i j a mʲ i
отмывайте	a t m i v a j tʲ e
промахивался	p r a m a xʲ i v a ɫ s ⁽ʲ ⁾ a
дождичкам	d o ʐ dʲ i t͡ɕ k a m
впитываниями	f ⁽ʲ ⁾ pʲ i t i v a nʲ i j a mʲ i
мобильники	m a bʲ i lʲ nʲ i kʲ i
разуметь	r a z u mʲ e tʲ
перемежало	pʲ i rʲ i mʲ i ʐ a ɫ a
приколоть	p rʲ i k a ɫ o tʲ
гитаристам	ɡʲ i t a rʲ i s t a m
застрелив	z a s t rʲ i lʲ i f
людях	lʲ u dʲ a x
колодцем	k a ɫ o t͡s i m
правоохранительный	p r a v a a x r a nʲ i tʲ i lʲ n i j
жёрнов	ʐ o r n a f
вальдшнепу	v a lʲ t͡ʂ ʂ nʲ i p u
шепнув	ʂ i p n u f
засорю	z a s a rʲ u
копило	k a pʲ i ɫ a
добавляться	d a b a v lʲ a t͡s a
прогудевший	p r a ɡ u dʲ e f ʂ i j
леях	lʲ e j a x
гугл	ɡ u ɡ ɫ
обносишь	a b n o sʲ i ʂ
вылезавший	v i lʲ i z a f ʂ i j
бляшкам	b lʲ a ʂ k a m
пястях	pʲ a sʲ tʲ a x
варьируют	v a rʲ j i r u j u t
кошелях	k a ʂ i lʲ a x
однообразиям	a d n a a b r a zʲ i j a m
поспешивший	p a s pʲ i ʂ i f ʂ i j
жучков	ʐ u t͡ɕ k o f
ночники	n a t͡ɕ nʲ i kʲ i
лишках	lʲ i ʂ k a x
оговориться	a ɡ a v a rʲ i t͡s a
умаляемся	u m a lʲ a j i m sʲ a
прокалываешь	p r a k a ɫ i v a j i ʂ
приговаривайтесь	p rʲ i ɡ a v a rʲ i v a j tʲ i sʲ
крупинкой	k r u pʲ i n k a j
зацеплять	z a t͡s i p lʲ a tʲ
устрашим	u s t r a ʂ i m
проникаются	p r a nʲ i k a j u t͡s a
надавайте	n a d a v a j tʲ e
обстановку	a p s t a n o f k u
закроет	z a k r o j i t
триатлонов	t rʲ i a t ɫ o n a f
басом	b a s a m
перекликаем	pʲ i rʲ i k lʲ i k a j i m
переступавший	pʲ i rʲ i s t u p a f ʂ i j
давлениям	d a v lʲ e nʲ i j a m
отнимает	a tʲ nʲ i m a j i t
раскисли	r a s kʲ i s ⁽ʲ ⁾ lʲ i
реяв	rʲ e j i f
влачимый	v ɫ a t͡ɕ i m i j
интеллектами	i nʲ tʲ i lʲ e k t a mʲ i
колледж	k o lʲ i t͡ʂ ʂ
дискетах	dʲ i s kʲ e t a x
выписал	v i pʲ i s a ɫ
прокрадываетесь	p r a k r a d i v a j i tʲ i sʲ
приплясывать	p rʲ i p lʲ a s i v a tʲ
расстраивался	r a s t r a i v a ɫ s ⁽ʲ ⁾ a
усмехаясь	u s mʲ i x a j i sʲ
похвалилась	p a x v a lʲ i ɫ a sʲ
искупления	i s k u p lʲ e nʲ i j a
интерпретированный	i n t i r p rʲ i tʲ i r a v a n i j
поторопятся	p a t a r o pʲ a t͡s a
преобразовывавшийся	p rʲ i a b r a z o v i v a f ʂ i j sʲ a
говорунам	ɡ a v a r u n a m
связисте	s vʲ i zʲ i sʲ tʲ e
заплетайтесь	z a p lʲ i t a j tʲ i sʲ
смотрят	s m o t rʲ a t
интриган	i n t rʲ i ɡ a n
поклонничество	p a k ɫ o nʲ i t͡ɕ i s t v a
подослало	p a d a s ɫ a ɫ a
купают	k u p a j u t
видайся	vʲ i d a j sʲ a
турой	t u r o j
хорошей	x a r o ʂ i j
свистела	s vʲ i sʲ tʲ e ɫ a
щепок	ɕː e p a k
облицевали	a b lʲ i t͡s i v a lʲ i
минчанками	mʲ i nʲ t͡ɕ a n k a mʲ i
созналось	s a z n a ɫ a sʲ
окопа	a k o p a
крикнул	k rʲ i k n u ɫ
шхун	ʂ x u n
вложивший	v ɫ a ʐ i f ʂ i j
налегке	n a lʲ i xʲ kʲ e
деканаты	d i k a n a t i
задёргиваем	z a dʲ o r ɡʲ i v a j i m
фотонов	f a t o n a f
выразивший	v i r a zʲ i f ʂ i j
гирям	ɡʲ i rʲ a m
арумынкой	a r u m i n k a j
сателлиту	s a tʲ i lʲ i t u
сберкнижками	z bʲ i r k nʲ i ʂ k a mʲ i
свечнике	s vʲ i t͡ɕ nʲ i kʲ e
биотоксичность	bʲ i a t a k sʲ i t͡ɕ n a sʲ tʲ
кебабах	kʲ i b a b a x
амбра	a m b r a
четырнадцатью	t͡ɕ i t i r n a t͡s i tʲ j u
обучавшийся	a b u t͡ɕ a f ʂ i j sʲ a
лодыря	ɫ o d i rʲ a
уязвляя	u j i z v lʲ a j a
выставит	v i s t a vʲ i t
осязает	a sʲ i z a j i t
убежим	u bʲ i ʐ i m
заботитесь	z a b o tʲ i tʲ i sʲ
опьянением	a p ⁽ʲ ⁾ j i nʲ e nʲ i j i m
коллапсам	k a ɫ a p s a m
фургону	f u r ɡ o n u
потрохам	p a t r a x a m
весельчаках	vʲ i sʲ i lʲ t͡ɕ i k a x
попеть	p a pʲ e tʲ
сосать	s a s a tʲ
погрешите	p a ɡ rʲ i ʂ i tʲ e
верующим	vʲ e r u j u ɕː i m
отводившийся	a t v a dʲ i f ʂ i j sʲ a
вальцу	v a lʲ t͡s u
бабосам	b a b o s a m
водятлу	v a dʲ a t ɫ u
обрушивают	a b r u ʂ i v a j u t
мачизмов	m a t͡ɕ i z m a f
смещаем	s mʲ i ɕː a j i m
граммами	ɡ r a m a mʲ i
осклабляю	a s k ɫ a b lʲ a j u
захлопывайся	z a x ɫ o p i v a j sʲ a
шелковистый	ʂ i ɫ k a vʲ i s t i j
настань	n a s t a nʲ
перевешиваю	pʲ i rʲ i vʲ e ʂ i v a j u
укладчиками	u k ɫ a t͡ɕ i k a mʲ i
социнианам	s a t͡s i nʲ i a n a m
кастрировав	k a s t rʲ i r a v a f
нахмурюсь	n a x m u rʲ u sʲ
проводкой	p r a v o t k a j
одаривая	a d a rʲ i v a j a
разглядишь	r a z ɡ lʲ i dʲ i ʂ
хост	x o s t
скатываешься	s k a t i v a j i ʂ sʲ a
параллелен	p a r a lʲ e lʲ i n
распишите	r a s pʲ i ʂ i tʲ e
провозы	p r a v o z i
ситами	sʲ i t a mʲ i
клеивший	k lʲ e i f ʂ i j
извергший	i z vʲ e r k ʂ i j
волноломы	v a ɫ n a ɫ o m i
аллергене	a lʲ i r ɡʲ e nʲ e
подвозите	p a d v o zʲ i tʲ e
подавляют	p a d a v lʲ a j u t
преследователем	p rʲ i s ⁽ʲ ⁾ lʲ e d a v a tʲ i lʲ i m
работницами	r a b o tʲ nʲ i t͡s a mʲ i
новоангличанах	n o v a a n ɡ lʲ i t͡ɕ a n a x
надувающийся	n a d u v a j u ɕː i j sʲ a
волкодава	v a ɫ k a d a v a
понизишься	p a nʲ i zʲ i ʂ sʲ a
дифференциальный	dʲ i fʲ i rʲ i n t͡s i a lʲ n i j
прилетаю	p rʲ i lʲ i t a j u
постыло	p a s t i ɫ a
туды	t u d i
распространяйся	r a s p r a s t r a nʲ a j sʲ a
чуявши	t͡ɕ u j i f ʂ i
вознамериваются	v a z n a mʲ e rʲ i v a j u t͡s a
непогрешимый	nʲ i p a ɡ rʲ i ʂ i m i j
скороговорка	s k a r a ɡ a v o r k a
буревестника	b u rʲ i vʲ e sʲ nʲ i k a
заправке	z a p r a f kʲ e
припоминаешь	p rʲ i p a mʲ i n a j i ʂ
стар	s t a r
зачёркиваем	z a t͡ɕ o r kʲ i v a j i m
удостоверял	u d a s t a vʲ i rʲ a ɫ
совратили	s a v r a tʲ i lʲ i
моем	m o j i m
скорчилась	s k o r t͡ɕ i ɫ a sʲ
озадаченный	a z a d a t͡ɕ i n i j
снисходили	sʲ nʲ i s x a dʲ i lʲ i
отпускавши	a t p u s k a f ʂ i
ресторанчик	rʲ i s t a r a nʲ t͡ɕ i k
негодяя	nʲ i ɡ a dʲ a j a
стрекозы	s t rʲ i k o z i
обличав	a b lʲ i t͡ɕ a f
капитализациям	k a pʲ i t a lʲ i z a t͡s i j a m
штрафовал	ʂ t r a f a v a ɫ
пробоя	p r a b o j a
разнесите	r a zʲ nʲ i sʲ i tʲ e
поставимся	p a s t a vʲ i m sʲ a
надававший	n a d a v a f ʂ i j
толкалось	t a ɫ k a ɫ a sʲ
проституции	p r a sʲ tʲ i t u t͡s i i
задаюсь	z a d a j u sʲ
наркомтяжпром	n a r k a m tʲ i ʂ p r o m
гидрологиях	ɡʲ i d r a ɫ o ɡʲ i j a x
гуманизме	ɡ u m a nʲ i z mʲ e
магнатов	m a ɡ n a t a f
интегралом	i n t i ɡ r a ɫ a m
разлились	r a z ⁽ʲ ⁾ lʲ i lʲ i sʲ
монорельса	m a n a rʲ e lʲ s a
олимпийкою	a lʲ i m ⁽ʲ ⁾ pʲ i j k a j u
зашумит	z a ʂ u mʲ i t
подешевевши	p a dʲ i ʂ i vʲ e f ʂ i
сеновал	sʲ i n a v a ɫ
костры	k a s t r i
управляетесь	u p r a v lʲ a j i tʲ i sʲ
недоедавший	nʲ i d a j i d a f ʂ i j
ничтожен	nʲ i t͡ɕ t o ʐ i n
пожелтеем	p a ʐ i ɫ tʲ e j i m
запросят	z a p r o sʲ a t
проектировщики	p r a i k tʲ i r o f ɕː i kʲ i
толстяком	t a ɫ s ⁽ʲ ⁾ tʲ i k o m
баянистку	b a j i nʲ i s t k u
забирай	z a bʲ i r a j
высвободимся	v i s v a b a dʲ i m sʲ a
обременённый	a b rʲ i mʲ i nʲ o n i j
пуза	p u z a
адгезией	a d ɡʲ e zʲ i j i j
нагрузка	n a ɡ r u s k a
летящий	lʲ i tʲ a ɕː i j
тирамису	tʲ i r a mʲ i s u
слиться	s ⁽ʲ ⁾ lʲ i t͡s a
буханке	b u x a n kʲ e
извлекут	i z v lʲ i k u t
обуевала	a b u j i v a ɫ a
швея	ʂ vʲ i j a
завершало	z a vʲ i r ʂ a ɫ a
стойлами	s t o j ɫ a mʲ i
тапочек	t a p a t͡ɕ i k
бесполезный	bʲ i s p a lʲ e z n i j
тушуй	t u ʂ u j
бровку	b r o f k u
манкой	m a n k a j
героинях	ɡʲ i r a i nʲ a x
соизволив	s a i z v o lʲ i f
верны	vʲ e r n i
принятий	p rʲ i nʲ a tʲ i j
претворить	p rʲ i t v a rʲ i tʲ
соизволением	s a i z v a lʲ e nʲ i j i m
провидцу	p r a vʲ i t͡s u
барахолок	b a r a x o ɫ a k
диаграммами	dʲ i a ɡ r a m a mʲ i
курилось	k u rʲ i ɫ a sʲ
подчёркивают	p a t͡ɕ o r kʲ i v a j u t
твердеющий	t vʲ i r dʲ e j u ɕː i j
сотри	s a t rʲ i
толкнёшь	t a ɫ k nʲ o ʂ
умились	u mʲ i lʲ i sʲ
изучитесь	i z u t͡ɕ i tʲ i sʲ
ударяемся	u d a rʲ a j i m sʲ a
навевавший	n a vʲ i v a f ʂ i j
порок	p o r a k
полуподвала	p o ɫ u p a d v a ɫ a
перегрелись	pʲ i rʲ i ɡ rʲ e lʲ i sʲ
осуждённый	a s u ʐ dʲ o n i j
мастерством	m a sʲ tʲ i r s t v o m
шатах	ʂ a t a x
отлучайте	a t ɫ u t͡ɕ a j tʲ e
затопляемый	z a t a p lʲ a j i m i j
усиливалась	u sʲ i lʲ i v a ɫ a sʲ
заполонённый	z a p a ɫ a nʲ o n i j
писку	pʲ i s k u
усваивать	u s v a i v a tʲ
голань	ɡ a ɫ a nʲ
сша	s ʂ a
контртерроризмы	k o n t r tʲ i r a rʲ i z m i
гончары	ɡ a nʲ t͡ɕ i r i
покинут	p a kʲ i n u t
отсидят	a t͡sʲ sʲ i dʲ a t
посовещаются	p a s a vʲ i ɕː a j u t͡s a
эксцессов	i k s t͡s e s a f
намыливающий	n a m i lʲ i v a j u ɕː i j
отрешаете	a t rʲ i ʂ a j i tʲ e
изящный	i zʲ a ɕː n i j
размежует	r a z mʲ i ʐ u j i t
наклоняться	n a k ɫ a nʲ a t͡s a
повертит	p a vʲ e r tʲ i t
глаукома	ɡ ɫ a u k o m a
растрогал	r a s t r o ɡ a ɫ
отопим	a t o pʲ i m
педиатрией	pʲ i dʲ i a t rʲ i j i j
орошу	a r a ʂ u
льдинок	lʲ dʲ i n a k
выражен	v i r a ʐ i n
отмерит	a t mʲ e rʲ i t
шарма	ʂ a r m a
беспокоить	bʲ i s p a k o i tʲ
пуделе	p u dʲ i lʲ e
вжал	v ʐ a ɫ
шевельнётесь	ʂ i vʲ i lʲ nʲ o tʲ i sʲ
бредим	b rʲ e dʲ i m
расшифровывал	r a ʂ i f r o v i v a ɫ
инет	i n e t
привставать	p rʲ i f s t a v a tʲ
плодился	p ɫ a dʲ i ɫ s ⁽ʲ ⁾ a
изжогах	i ʐ o ɡ a x
показываясь	p a k a z i v a j i sʲ
пижму	pʲ i ʐ m u
откраиваешь	a t k r a i v a j i ʂ
заебать	z a j i b a tʲ
провозглашай	p r a v a z ɡ ɫ a ʂ a j
расслабленные	r a s ɫ a b lʲ i n i j e
излияниями	i z ⁽ʲ ⁾ lʲ i j a nʲ i j a mʲ i
проститутки	p r a sʲ tʲ i t u t kʲ i
шаромыгой	ʂ a r a m i ɡ a j
похоронят	p a x a r o nʲ a t
поощряв	p a a ɕː rʲ a f
лайкнувший	ɫ a j k n u f ʂ i j
утком	u t k o m
зажигалках	z a ʐ i ɡ a ɫ k a x
навьючивший	n a v ⁽ʲ ⁾ j u t͡ɕ i f ʂ i j
лопарю	ɫ o p a rʲ u
маточный	m a t a t͡ɕ n i j
лесоматериалам	lʲ e s a m a tʲ i rʲ i a ɫ a m
глумлениях	ɡ ɫ u m lʲ e nʲ i j a x
чревами	t͡ɕ rʲ e v a mʲ i
вскакивавши	f s k a kʲ i v a f ʂ i
переставить	pʲ i rʲ i s t a vʲ i tʲ
понудь	p a n u tʲ
фуга	f u ɡ a
мирив	mʲ i rʲ i f
недержания	nʲ i dʲ i r ʐ a nʲ i j a
дальнобойщиках	d a lʲ n a b o j ɕː i k a x
электрон	i lʲ i k t r o n
отработайте	a t r a b o t a j tʲ e
брайан	b r a j i n
оробевший	a r a bʲ e f ʂ i j
подметайте	p a d mʲ i t a j tʲ e
выкраиваются	v i k r a i v a j u t͡s a
хуярил	x u j a rʲ i ɫ
поджариваем	p a d͡ʐ ʐ a rʲ i v a j i m
пародируешь	p a r a dʲ i r u j i ʂ
заверещи	z a vʲ i rʲ i ɕː i
пригибают	p rʲ i ɡʲ i b a j u t
усмотри	u s m a t rʲ i
маковках	m a k a f k a x
сканировало	s k a nʲ i r a v a ɫ a
морфием	m o r fʲ i j i m
бельгия	bʲ e lʲ ɡʲ i j a
спарывали	s p a r i v a lʲ i
присягнувши	p rʲ i sʲ i ɡ n u f ʂ i
порастёт	p a r a sʲ tʲ o t
обложитесь	a b ɫ o ʐ i tʲ i sʲ
повалила	p a v a lʲ i ɫ a
ревизия	rʲ i vʲ i zʲ i j a
потру	p a t r u
интеллигент	i nʲ tʲ i lʲ i ɡʲ e n t
бабульку	b a b u lʲ k u
запираюсь	z a pʲ i r a j u sʲ
разводились	r a z v a dʲ i lʲ i sʲ
фотокарточку	f a t a k a r t a t͡ɕ k u
упроси	u p r a sʲ i
моавитянине	m a a vʲ i tʲ i nʲ i nʲ e
сгрудьтесь	z ɡ r u tʲː i sʲ
торговцы	t a r ɡ o f t͡s i
скреплю	s k rʲ i p lʲ u
лепя	lʲ i pʲ a
почуете	p a t͡ɕ u j i tʲ e
восприняла	v a s p rʲ i nʲ i ɫ a
стилисту	sʲ tʲ i lʲ i s t u
обмираю	a b mʲ i r a j u
включав	f k lʲ u t͡ɕ a f
горнилу	ɡ a r nʲ i ɫ u
выписало	v i pʲ i s a ɫ a
терабайтами	tʲ i r a b a j t a mʲ i
мяукала	mʲ i u k a ɫ a
подкузьмит	p a t k u zʲ mʲ i t
сплющивавший	s p lʲ u ɕː i v a f ʂ i j
окрылили	a k r i lʲ i lʲ i
преодолениям	p rʲ i a d a lʲ e nʲ i j a m
подкормке	p a t k o r m kʲ e
уволю	u v o lʲ u
памятей	p a mʲ i tʲ i j
поладив	p a ɫ a dʲ i f
тахометра	t a x o mʲ i t r a
зайдя	z a j dʲ a
разворачиваю	r a z v a r a t͡ɕ i v a j u
долбануть	d a ɫ b a n u tʲ
апограф	a p o ɡ r a f
раздосадуешь	r a z d a s a d u j i ʂ
натерпелся	n a tʲ i r pʲ e ɫ s ⁽ʲ ⁾ a
показах	p a k a z a x
распустишься	r a s p u sʲ tʲ i ʂ sʲ a
девайсам	dʲ i v a j s a m
изготовлением	i z ɡ a t a v lʲ e nʲ i j i m
расправа	r a s p r a v a
черенами	t͡ɕ e rʲ i n a mʲ i
отправками	a t p r a f k a mʲ i
загадит	z a ɡ a dʲ i t
продиравши	p r a dʲ i r a f ʂ i
лязгнуло	lʲ a z ɡ n u ɫ a
противоправный	p r a tʲ i v a p r a v n i j
восхождений	v a s x a ʐ dʲ e nʲ i j
укрылся	u k r i ɫ s ⁽ʲ ⁾ a
ослабеете	a s ɫ a bʲ e j i tʲ e
самоконтроль	s a m a k a n t r o lʲ
навигация	n a vʲ i ɡ a t͡s i j a
поели	p a j e lʲ i
дуэта	d u e t a
опохмелившийся	a p a x mʲ i lʲ i f ʂ i j sʲ a
козлищ	k o z ⁽ʲ ⁾ lʲ i ɕː
водрузив	v a d r u zʲ i f
подрастай	p a d r a s t a j
набирав	n a bʲ i r a f
служеньям	s ɫ u ʐ e nʲ j a m
шаромыгами	ʂ a r a m i ɡ a mʲ i
бестолочь	bʲ e s t a ɫ a t͡ɕ
отмашу	a t m a ʂ u
уединилась	u j i dʲ i nʲ i ɫ a sʲ
опером	o pʲ i r a m
аблефароном	a b lʲ i f a r o n a m
бодрства	b o d r s t v a
комбинируешь	k a m ⁽ʲ ⁾ bʲ i nʲ i r u j i ʂ
сплетавшийся	s p lʲ i t a f ʂ i j sʲ a
сопряжёшь	s a p rʲ i ʐ o ʂ
темпераментами	tʲ i m ⁽ʲ ⁾ pʲ i r a mʲ i n t a mʲ i
приписать	p rʲ i pʲ i s a tʲ
мызе	m i zʲ e
картонах	k a r t o n a x
барбершопу	b a r bʲ i r ʂ o p u
издерживают	i zʲ dʲ e r ʐ i v a j u t
рыбёхою	r i bʲ o x a j u
накалялась	n a k a lʲ a ɫ a sʲ
думаем	d u m a j i m
попыталось	p a p i t a ɫ a sʲ
сманеврируем	s m a nʲ i v rʲ i r u j i m
отпугивало	a t p u ɡʲ i v a ɫ a
афганского	a v ɡ a n s k a v a
автогене	a f t a ɡʲ e nʲ e
продлеваю	p r a d lʲ i v a j u
казанах	k a z a n a x
воздухи	v o z d u xʲ i
завязло	z a vʲ a z ɫ a
высь	v i sʲ
выучишься	v i u t͡ɕ i ʂ sʲ a
втором	f t a r o m
лизнув	lʲ i z n u f
остротой	a s t r o t a j
вышитый	v i ʂ i t i j
опушайся	a p u ʂ a j sʲ a
урезавший	u rʲ e z a f ʂ i j
копеечкою	k a pʲ e j i t͡ɕ k a j u
чаячий	t͡ɕ a j i t͡ɕ i j
радиопередач	r a dʲ i o pʲ i rʲ i d a t͡ɕ
заглинизированности	z a ɡ lʲ i nʲ i zʲ i r a v a n a sʲ tʲ i
съедутся	s j e d u t͡s a
испуги	i s p u ɡʲ i
сквозняке	s k v a zʲ nʲ i kʲ e
слепнем	s ⁽ʲ ⁾ lʲ e p nʲ i m
рассекретьте	r a sʲ i k rʲ e tʲː e
компенсируете	k a m ⁽ʲ ⁾ pʲ i n ⁽ʲ ⁾ sʲ i r u j i tʲ e
кочевнике	k a t͡ɕ e v nʲ i kʲ e
стечению	sʲ tʲ i t͡ɕ e nʲ i j u
ручейник	r u t͡ɕ e j nʲ i k
повторяющийся	p a f t a rʲ a j u ɕː i j sʲ a
братиною	b r a tʲ i n a j u
глушил	ɡ ɫ u ʂ i ɫ
олимпиек	a lʲ i m ⁽ʲ ⁾ pʲ i j i k
раскисла	r a s kʲ i s ɫ a
заступало	z a s t u p a ɫ a
портупей	p a r t u pʲ e j
вкрался	f k r a ɫ s ⁽ʲ ⁾ a
реквизициями	rʲ i k vʲ i zʲ i t͡s i j a mʲ i
предпишем	p rʲ i t pʲ i ʂ i m
умён	u mʲ o n
востоковедам	v a s t a k a vʲ e d a m
дублин	d u b lʲ i n
альдегида	a lʲ d i ɡʲ i d a
десятиугольнику	dʲ i sʲ i tʲ i u ɡ o lʲ nʲ i k u
загрязнив	z a ɡ rʲ i zʲ nʲ i f
проскрипишь	p r a s k rʲ i pʲ i ʂ
громящий	ɡ r a mʲ a ɕː i j
вертлуг	vʲ i r t ɫ u k
вырисовываться	v i rʲ i s o v i v a t͡s a
отряхнули	a t rʲ i x n u lʲ i
купаний	k u p a nʲ i j
перевесила	pʲ i rʲ i vʲ e sʲ i ɫ a
самсарою	s a m s a r a j u
закину	z a kʲ i n u
размножимся	r a z m n o ʐ i m sʲ a
обуваете	a b u v a j i tʲ e
присылавши	p rʲ i s i ɫ a f ʂ i
тюльпана	tʲ u lʲ p a n a
ремиксов	rʲ i mʲ i k s a f
слушанию	s ɫ u ʂ a nʲ i j u
симулируй	sʲ i m u lʲ i r u j
пиву	pʲ i v u
прояснявшийся	p r a j i sʲ nʲ a f ʂ i j sʲ a
стыдобам	s t i d o b a m
заискивали	z a i s kʲ i v a lʲ i
водоснабжениях	v a d a s n a b ʐ e nʲ i j a x
бривший	b rʲ i f ʂ i j
причастилось	p rʲ i t͡ɕ i sʲ tʲ i ɫ a sʲ
бесноватыми	bʲ i s n a v a t i mʲ i
набивают	n a bʲ i v a j u t
поубавься	p a u b a f ⁽ʲ ⁾ sʲ a
закономерностями	z a k a n a mʲ e r n a sʲ tʲ a mʲ i
стогами	s t a ɡ a mʲ i
выплативший	v i p ɫ a tʲ i f ʂ i j
феминизмом	fʲ i mʲ i nʲ i z m a m
скорую	s k o r u j u
венчания	vʲ i nʲ t͡ɕ a nʲ i j a
раскручивало	r a s k r u t͡ɕ i v a ɫ a
компьютеризаций	k a m ⁽ʲ ⁾ p ⁽ʲ ⁾ j u t i rʲ i z a t͡s i j
абдраганами	a b d r a ɡ a n a mʲ i
камышниц	k a m i ʂ nʲ i t͡s
выдёргивай	v i dʲ o r ɡʲ i v a j
снашивала	s n a ʂ i v a ɫ a
предсказуемостью	p rʲ i t͡s k a z u j i m a sʲ tʲ j u
уменьшайся	u mʲ i nʲ ʂ a j sʲ a
фальсификациею	f a lʲ sʲ i fʲ i k a t͡s i j i j u
лесосплавами	lʲ i s a s p ɫ a v a mʲ i
руководств	r u k a v o t͡s t f
перелётом	pʲ i rʲ i lʲ o t a m
демографий	dʲ i m a ɡ r a fʲ i j
завоюет	z a v a j u j i t
катеров	k a tʲ i r o f
абгомотопии	a b ɡ a m a t o pʲ i i
болте	b a ɫ tʲ e
роках	r o k a x
просветишь	p r a s vʲ e tʲ i ʂ
подпрыгну	p a t p r i ɡ n u
контрактниках	k a n t r a k tʲ nʲ i k a x
приятны	p rʲ i j a t n i
хранило	x r a nʲ i ɫ a
планированиям	p ɫ a nʲ i r a v a nʲ i j a m
пастеризациями	p a s t i rʲ i z a t͡s i j a mʲ i
эксцентрик	i k s t͡s e n t rʲ i k
преградивший	p rʲ i ɡ r a dʲ i f ʂ i j
олимпиад	a lʲ i m ⁽ʲ ⁾ pʲ i a t
преломлял	p rʲ i ɫ a m lʲ a ɫ
садку	s a t k u
искорёжило	i s k a rʲ o ʐ i ɫ a
лицензиар	lʲ i t͡s i n ⁽ʲ ⁾ zʲ i a r
отслеживает	a t͡s s ⁽ʲ ⁾ lʲ e ʐ i v a j i t
ботиночках	b a tʲ i n a t͡ɕ k a x
кашицы	k a ʂ i t͡s i
подушечка	p a d u ʂ i t͡ɕ k a
прививай	p rʲ i vʲ i v a j
сцала	s t͡s a ɫ a
подготовляйте	p a d ɡ a t a v lʲ a j tʲ e
выпечкам	v i pʲ i t͡ɕ k a m
абецадло	a b i t͡s a d ɫ a
срастусь	s r a s t u sʲ
хищения	xʲ i ɕː e nʲ i j a
маркиза	m a r kʲ i z a
лапали	ɫ a p a lʲ i
удочерениях	u d a t͡ɕ i rʲ e nʲ i j a x
скрепляя	s k rʲ i p lʲ a j a
дисквалификациях	dʲ i s k v a lʲ i fʲ i k a t͡s i j a x
обеспечиваю	a bʲ i s pʲ e t͡ɕ i v a j u
парейдолиях	p a rʲ i j d a lʲ i j a x
упирав	u pʲ i r a f
отбавлявший	a d b a v lʲ a f ʂ i j
гувернантку	ɡ u vʲ i r n a n t k u
рассыплешься	r a s i p lʲ i ʂ sʲ a
абсолютизированиях	a p s a lʲ u tʲ i zʲ i r a v a nʲ i j a x
разбродом	r a z b r o d a m
женит	ʐ e nʲ i t
вселить	f sʲ i lʲ i tʲ
котдивуарцев	k o dʲ i v u a r t͡s i f
стерпеть	sʲ tʲ i r pʲ e tʲ
решалось	rʲ i ʂ a ɫ a sʲ
мужской	m u ʂ s k o j
обнявши	a b nʲ a f ʂ i
баллончики	b a ɫ o nʲ t͡ɕ i kʲ i
бондарням	b a n d a r nʲ a m
цесарем	t͡s e s a rʲ i m
нива	nʲ i v a
сужений	s u ʐ e nʲ i j
сопутствую	s a p u t͡s t v u j u
гуслям	ɡ u s ⁽ʲ ⁾ lʲ i m
намечаем	n a mʲ i t͡ɕ a j i m
компартиях	k a m p a r tʲ i j a x
афты	a f t i
заревом	z a rʲ i v a m
покатаешь	p a k a t a j i ʂ
нервничавший	nʲ e r v nʲ i t͡ɕ i f ʂ i j
тонею	t o nʲ i j u
ответству	a t vʲ e t͡s t v u
исчезавший	i ɕ t͡ɕ i z a f ʂ i j
намок	n a m o k
подобострастие	p a d a b a s t r a sʲ tʲ i j e
исполкому	i s p a ɫ k o m u
откинула	a t kʲ i n u ɫ a
очертенеете	a t͡ɕ i r tʲ i nʲ e j i tʲ e
чокаешься	t͡ɕ o k a j i ʂ sʲ a
муруй	m u r u j
объявлений	a b j i v lʲ e nʲ i j
георгинов	ɡʲ i a r ɡʲ i n a f
заправлял	z a p r a v lʲ a ɫ
баловнике	b a ɫ a v nʲ i kʲ e
абсолютизмах	a p s a lʲ u tʲ i z m a x
обжа	o b ʐ a
сплетавший	s p lʲ i t a f ʂ i j
богословы	b a ɡ a s ɫ o v i
распиная	r a s pʲ i n a j a
отвыкавший	a t v i k a f ʂ i j
окружностей	a k r u ʐ n a sʲ tʲ i j
смрадишь	s m r a dʲ i ʂ
аблактировать	a b ɫ a k tʲ i r a v a tʲ
гомер	ɡ a mʲ e r
треклистах	t r i k lʲ i s t a x
заключайтесь	z a k lʲ u t͡ɕ a j tʲ i sʲ
сатирах	s a tʲ i r a x
специализмы	s pʲ i t͡s i a lʲ i z m i
питомники	pʲ i t o m nʲ i kʲ i
нёсши	nʲ o ʂ i
отхватываемый	a t x v a t i v a j i m i j
смахиваю	s m a xʲ i v a j u
упоминаются	u p a mʲ i n a j u t͡s a
сочинением	s a t͡ɕ i nʲ e nʲ i j i m
покаявшийся	p a k a j i f ʂ i j sʲ a
брюссельский	b rʲ u sʲ e lʲ s kʲ i j
раскусывали	r a s k u s i v a lʲ i
осмысливаемый	a s m i s ⁽ʲ ⁾ lʲ i v a j i m i j
гостьей	ɡ o sʲ tʲ j i j
развеивавши	r a z vʲ e i v a f ʂ i
сладким	s ɫ a t kʲ i m
горкой	ɡ o r k a j
уют	u j u t
прокалывает	p r a k a ɫ i v a j i t
автоматонах	a f t a m a t o n a x
насылаем	n a s i ɫ a j i m
донах	d o n a x
откатившись	a t k a tʲ i f ʂ i sʲ
предприемлите	p rʲ i t p rʲ i j e m lʲ i tʲ e
лад	ɫ a t
выговорившись	v i ɡ a v a rʲ i f ʂ i sʲ
воображал	v a a b r a ʐ a ɫ
лотке	ɫ a t kʲ e
чтение	t͡ɕ tʲ e nʲ i j e
лысиной	ɫ i sʲ i n a j
отводилась	a t v a dʲ i ɫ a sʲ
доверительностям	d a vʲ i rʲ i tʲ i lʲ n a sʲ tʲ a m
сигналите	sʲ i ɡ n a lʲ i tʲ e
восславляю	v a s ɫ a v lʲ a j u
формализовавший	f a r m a lʲ i z a v a f ʂ i j
однородностям	a d n a r o d n a sʲ tʲ a m
майонезы	m a j i n e z i
вьюгами	v ⁽ʲ ⁾ j u ɡ a mʲ i
дисциплинировала	dʲ i s t͡s i p lʲ i nʲ i r a v a ɫ a
абсорбированиями	a p s a r bʲ i r a v a nʲ i j a mʲ i
самосвалах	s a m a s v a ɫ a x
перекладывал	pʲ i rʲ i k ɫ a d i v a ɫ
обозначаемый	a b a z n a t͡ɕ a j i m i j
ризе	rʲ i zʲ e
двухлетиями	d v u x lʲ e tʲ i j a mʲ i
тротуару	t r a t u a r u
уверовать	u vʲ e r a v a tʲ
звоночке	z v a n o t͡ɕ kʲ e
мотайтесь	m a t a j tʲ i sʲ
погоняем	p a ɡ a nʲ a j i m
факельщиков	f a kʲ i lʲ ɕː i k a f
сорняком	s a r nʲ i k o m
номинирует	n a mʲ i nʲ i r u j i t
согласовываетесь	s a ɡ ɫ a s o v i v a j i tʲ i sʲ
типажах	tʲ i p a ʐ a x
рисовал	rʲ i s a v a ɫ
бадей	b a dʲ e j
раздвинулись	r a z d vʲ i n u lʲ i sʲ
ужесточение	u ʐ i s t a t͡ɕ e nʲ i j e
мастодонтов	m a s t a d o n t a f
должные	d o ɫ ʐ n i j e
похвалю	p a x v a lʲ u
зажил	z a ʐ i ɫ
диагнозу	dʲ i a ɡ n a z u
поцелуют	p a t͡s i ɫ u j u t
умножаем	u m n a ʐ a j i m
четверостишиями	t͡ɕ i t vʲ i r a sʲ tʲ i ʂ i j a mʲ i
сыпали	s i p a lʲ i
артистка	a r tʲ i s t k a
мегаэрги	mʲ i ɡ a e r ɡʲ i
обнимало	a b nʲ i m a ɫ a
силаче	sʲ i ɫ a t͡ɕ e
диссонансами	dʲ i s a n a n s a mʲ i
залезем	z a lʲ e zʲ i m
адмиралов	a d mʲ i r a ɫ a f
микросхемы	mʲ i k r a s xʲ e m i
кукушкам	k u k u ʂ k a m
вавилонянами	v a vʲ i ɫ o nʲ i n a mʲ i
ослихам	a s ⁽ʲ ⁾ lʲ i x a m
крепчают	k rʲ i p t͡ɕ a j u t
дублёнки	d u b lʲ o n kʲ i
чалтыкам	t͡ɕ i ɫ t i k a m
пригревающий	p rʲ i ɡ rʲ i v a j u ɕː i j
стрясавший	s t rʲ i s a f ʂ i j
упомянитесь	u p a mʲ i nʲ i tʲ i sʲ
первые	pʲ e r v i j e
толстячку	t a ɫ s ⁽ʲ ⁾ tʲ i t͡ɕ k u
разглядите	r a z ɡ lʲ i dʲ i tʲ e
дрессировок	d rʲ i sʲ i r o v a k
смолкнет	s m o ɫ k nʲ i t
поблагодарить	p a b ɫ a ɡ a d a rʲ i tʲ
забудусь	z a b u d u sʲ
лесокатки	lʲ e s a k a t kʲ i
двигают	d vʲ i ɡ a j u t
допускаетесь	d a p u s k a j i tʲ i sʲ
угасла	u ɡ a s ɫ a
лесотундрой	lʲ e s a t u n d r a j
нагрянувший	n a ɡ rʲ a n u f ʂ i j
силуэты	sʲ i ɫ u e t i
высокохудожественный	v i s a k a x u d o ʐ i s t vʲ i n i j
вступались	f s t u p a lʲ i sʲ
слизняку	s ⁽ʲ ⁾ lʲ i zʲ nʲ i k u
отчужу	a t͡ɕ u ʐ u
насекомом	n a sʲ i k o m a m
касайтесь	k a s a j tʲ i sʲ
рабынями	r a b i nʲ a mʲ i
причинив	p rʲ i t͡ɕ i nʲ i f
предприемлете	p rʲ i t p rʲ i j e m lʲ i tʲ e
мироточение	mʲ i r a t a t͡ɕ e nʲ i j e
зацепитесь	z a t͡s e pʲ i tʲ i sʲ
холодавши	x a ɫ a d a f ʂ i
зачаровав	z a t͡ɕ i r a v a f
вгибал	v ɡʲ i b a ɫ
проткнуло	p r a t k n u ɫ a
бросьте	b r o sʲ tʲ e
рентабельность	rʲ i n t a bʲ i lʲ n a sʲ tʲ
жестокий	ʐ i s t o kʲ i j
веселеешь	vʲ i sʲ i lʲ e j i ʂ
пойменный	p o j mʲ i n i j
полиграфиях	p a lʲ i ɡ r a fʲ i j a x
демонстрацией	dʲ i m a n s t r a t͡s i j i j
погрязают	p a ɡ rʲ i z a j u t
мессою	mʲ e s a j u
кремниев	k rʲ e m nʲ i j i f
туалетам	t u a lʲ e t a m
уволенный	u v o lʲ i n i j
уговаривая	u ɡ a v a rʲ i v a j a
наездников	n a j e zʲ nʲ i k a f
изведав	i z vʲ e d a f
забрызжите	z a b r i ʐ i tʲ e
навлекали	n a v lʲ i k a lʲ i
матрасами	m a t r a s a mʲ i
зверюшки	z vʲ i rʲ u ʂ kʲ i
дотягивающийся	d a tʲ a ɡʲ i v a j u ɕː i j sʲ a
троичный	t r o i t͡ɕ n i j
выбравши	v i b r a f ʂ i
цевках	t͡s e f k a x
размежевавши	r a z mʲ i ʐ i v a f ʂ i
леденела	lʲ i dʲ i nʲ e ɫ a
золотистым	z a ɫ a tʲ i s t i m
слижите	s ⁽ʲ ⁾ lʲ i ʐ i tʲ e
астероидах	a s t i r o i d a x
англосфере	a n ɡ ɫ a s fʲ e rʲ e
замучай	z a m u t͡ɕ i j
каскадам	k a s k a d a m
вылечивайте	v i lʲ e t͡ɕ i v a j tʲ e
бурундуком	b u r u n d u k o m
дрессировал	d rʲ i sʲ i r a v a ɫ
пройдусь	p r a j d u sʲ
польстишь	p a lʲ sʲ tʲ i ʂ
разгневаюсь	r a z ɡ nʲ e v a j u sʲ
просушивать	p r a s u ʂ i v a tʲ
механизации	mʲ i x a nʲ i z a t͡s i i
вожмёте	v a ʐ mʲ o tʲ e
обвил	a b vʲ i ɫ
стряпухой	s t rʲ i p u x a j
язвивши	j i z vʲ i f ʂ i
неустроенностям	nʲ i u s t r o j i n a sʲ tʲ a m
лишивший	lʲ i ʂ i f ʂ i j
ранкам	r a n k a m
подстрекателем	p a t͡s s t rʲ i k a tʲ i lʲ i m
наступления	n a s t u p lʲ e nʲ i j a
наказаниями	n a k a z a nʲ i j a mʲ i
чувствуйте	t͡ɕ u s t v u j tʲ e
украдёшь	u k r a dʲ o ʂ
стлались	s t ɫ a lʲ i sʲ
сбило	z bʲ i ɫ a
распарила	r a s p a rʲ i ɫ a
ворочающий	v a r o t͡ɕ i j u ɕː i j
проскакиваю	p r a s k a kʲ i v a j u
благоприличиями	b ɫ a ɡ a p rʲ i lʲ i t͡ɕ i j a mʲ i
сближает	z b lʲ i ʐ a j i t
павлинах	p a v lʲ i n a x
новациям	n a v a t͡s i j a m
забывался	z a b i v a ɫ s ⁽ʲ ⁾ a
льнам	lʲ n a m
изодрали	i z a d r a lʲ i
неполноту	nʲ i p a ɫ n a t u
доброжелательностями	d a b r a ʐ i ɫ a tʲ i lʲ n a sʲ tʲ a mʲ i
утоли	u t a lʲ i
разбредалась	r a z b rʲ i d a ɫ a sʲ
разыгрался	r a z i ɡ r a ɫ s ⁽ʲ ⁾ a
котелки	k a tʲ i ɫ kʲ i
машите	m a ʂ i tʲ e
блядовало	b lʲ i d a v a ɫ a
пятёрках	pʲ i tʲ o r k a x
уединявшись	u j i dʲ i nʲ a f ʂ i sʲ
фокстерьерах	f a k s t i rʲ j e r a x
прислужили	p rʲ i s ɫ u ʐ i lʲ i
замяло	z a mʲ a ɫ a
барабанщику	b a r a b a nʲ ɕː i k u
поминках	p a mʲ i n k a x
кромкой	k r o m k a j
извиняй	i z vʲ i nʲ a j
хищничестве	xʲ i ɕː nʲ i t͡ɕ i s t vʲ e
ахи	a xʲ i
совершатся	s a vʲ i r ʂ a t͡s a
развернувший	r a z vʲ i r n u f ʂ i j
мнусь	m n u sʲ
опробованный	a p r o b a v a n i j
охранило	a x r a nʲ i ɫ a
сохраняете	s a x r a nʲ a j i tʲ e
негодованию	nʲ i ɡ a d a v a nʲ i j u
трефы	t rʲ e f i
замере	z a mʲ e rʲ e
навязаешь	n a vʲ i z a j i ʂ
альбоме	a lʲ b o mʲ e
уклонении	u k ɫ a nʲ e nʲ i i
антикварках	a nʲ tʲ i k v a r k a x
нокаута	n a k a u t a
толковании	t a ɫ k a v a nʲ i i
единомышленников	j i dʲ i n a m i ʂ lʲ i nʲ i k a f
киноактрисой	kʲ i n a a k t rʲ i s a j
виновницах	vʲ i n o v nʲ i t͡s a x
ласково	ɫ a s k a v a
запричитаешь	z a p rʲ i t͡ɕ i t a j i ʂ
холмиками	x o ɫ mʲ i k a mʲ i
кольчугой	k a lʲ t͡ɕ u ɡ a j
стукаясь	s t u k a j i sʲ
теплотрассе	tʲ i p ɫ a t r a sʲ e
фабрикую	f a b rʲ i k u j u
попками	p o p k a mʲ i
чардаша	t͡ɕ a r d a ʂ a
африкандерах	a f rʲ i k a n d i r a x
пригородом	p rʲ i ɡ a r a d a m
совещаешься	s a vʲ i ɕː a j i ʂ sʲ a
молодят	m a ɫ a dʲ a t
луна	ɫ u n a
статейкой	s t a tʲ e j k a j
ложечек	ɫ o ʐ i t͡ɕ i k
клирошанам	k lʲ i r a ʂ a n a m
тиранна	tʲ i r a n a
террористе	t i r a rʲ i sʲ tʲ e
попытками	p a p i t k a mʲ i
вероучением	vʲ e r a u t͡ɕ e nʲ i j i m
забора	z a b o r a
гуглите	ɡ u ɡ lʲ i tʲ e
звенеть	z vʲ i nʲ e tʲ
насупившийся	n a s u pʲ i f ʂ i j sʲ a
затмениях	z a t mʲ e nʲ i j a x
рассказывавшийся	r a s k a z i v a f ʂ i j sʲ a
ускоришься	u s k o rʲ i ʂ sʲ a
вышибалу	v i ʂ i b a ɫ u
проиграешь	p r a i ɡ r a j i ʂ
ёбанная	j o b a n a j a
юмористическая	j u m a rʲ i sʲ tʲ i t͡ɕ i s k a j a
лейкозом	lʲ i j k o z a m
исследовательницам	i s ⁽ʲ ⁾ː lʲ e d a v a tʲ i lʲ nʲ i t͡s a m
фреске	f rʲ e s kʲ e
распознаешь	r a s p a z n a j i ʂ
лебедята	lʲ i bʲ i dʲ a t a
синюхой	sʲ i nʲ u x a j
переустроит	pʲ i rʲ i u s t r o i t
наезжала	n a j i ʐ a ɫ a
защищаетесь	z a ɕː i ɕː a j i tʲ i sʲ
подвяжем	p a d vʲ a ʐ i m
иваси	i v a sʲ i
куриц	k u rʲ i t͡s
ворочанный	v a r o t͡ɕ i n i j
цензурировавший	t͡s i n z u rʲ i r a v a f ʂ i j
лопари	ɫ o p a rʲ i
пырнёшь	p i r nʲ o ʂ
всевозможна	f sʲ i v a z m o ʐ n a
дозрею	d a z rʲ e j u
берегами	bʲ i rʲ i ɡ a mʲ i
девальвации	d i v a lʲ v a t͡s i i
залепляла	z a lʲ i p lʲ a ɫ a
электроснабжениям	i lʲ e k t r a s n a b ʐ e nʲ i j a m
прощанья	p r a ɕː a nʲ j a
искусите	i s k u sʲ i tʲ e
сдавило	z d a vʲ i ɫ a
просчётах	p r a ɕː o t a x
кувшинках	k u f ʂ i n k a x
рейхстагу	r i j x s t a ɡ u
гримировкам	ɡ rʲ i mʲ i r o f k a m
отеческий	a tʲ e t͡ɕ i s kʲ i j
гостьях	ɡ o sʲ tʲ j a x
затворявшийся	z a t v a rʲ a f ʂ i j sʲ a
наморщите	n a m o r ɕː i tʲ e
загибай	z a ɡʲ i b a j
варшавянин	v a r ʂ a vʲ a nʲ i n
патокам	p a t a k a m
регистрируясь	rʲ i ɡʲ i s t rʲ i r u j i sʲ
маскарадам	m a s k a r a d a m
обозначься	a b a z n a t͡ɕ sʲ a
приготовлением	p rʲ i ɡ a t a v lʲ e nʲ i j i m
волочанине	v a ɫ a t͡ɕ a nʲ i nʲ e
позавидуйте	p a z a vʲ i d u j tʲ e
пофигизмами	p a fʲ i ɡʲ i z m a mʲ i
развернуло	r a z vʲ i r n u ɫ a
подкатить	p a t k a tʲ i tʲ
семиугольника	sʲ i mʲ i u ɡ o lʲ nʲ i k a
пропитаниях	p r a pʲ i t a nʲ i j a x
декларировав	dʲ i k ɫ a rʲ i r a v a f
почисть	p a t͡ɕ i sʲ tʲ
пронюхивала	p r a nʲ u xʲ i v a ɫ a
десницу	dʲ i sʲ nʲ i t͡s u
отяжелеть	a tʲ i ʐ i lʲ e tʲ
заменялись	z a mʲ i nʲ a lʲ i sʲ
тушёнками	t u ʂ o n k a mʲ i
залатавши	z a ɫ a t a f ʂ i
забил	z a bʲ i ɫ
заработало	z a r a b o t a ɫ a
подпорка	p a t p o r k a
встававши	f s t a v a f ʂ i
местничество	mʲ e sʲ nʲ i t͡ɕ i s t v a
октябрь	a k tʲ a b rʲ
убийцы	u bʲ i j t͡s i
лень	lʲ e nʲ
накрахмаливала	n a k r a x m a lʲ i v a ɫ a
рекламистами	rʲ i k ɫ a mʲ i s t a mʲ i
зачинам	z a t͡ɕ i n a m
ассистенте	a sʲ i sʲ tʲ e nʲ tʲ e
досадовавший	d a s a d a v a f ʂ i j
покривившись	p a k rʲ i vʲ i f ʂ i sʲ
выправка	v i p r a f k a
яду	j a d u
переломлю	pʲ i rʲ i ɫ a m lʲ u
соревнуйтесь	s a rʲ i v n u j tʲ i sʲ
утопаем	u t o p a j i m
употребляюсь	u p a t rʲ i b lʲ a j u sʲ
истопим	i s t o pʲ i m
бездн	bʲ e z d n
вбегаю	v ⁽ʲ ⁾ bʲ i ɡ a j u
остряках	a s t rʲ i k a x
выстелите	v i sʲ tʲ i lʲ i tʲ e
оспариваете	a s p a rʲ i v a j i tʲ e
попечениях	p a pʲ i t͡ɕ e nʲ i j a x
напоролся	n a p a r o ɫ s ⁽ʲ ⁾ a
угрях	u ɡ rʲ a x
гидраты	ɡʲ i d r a t i
трепыхаемся	t rʲ i p i x a j i m sʲ a
колодезями	k a ɫ o dʲ i zʲ a mʲ i
окаю	o k a j u
призываешь	p rʲ i z i v a j i ʂ
идеалистов	i dʲ i a lʲ i s t a f
прижигайте	p rʲ i ʐ i ɡ a j tʲ e
крошенный	k r o ʂ i n i j
порочили	p a r o t͡ɕ i lʲ i
урочат	u r o t͡ɕ a t
обручайте	a b r u t͡ɕ a j tʲ e
неявкой	nʲ i j a f k a j
сгинь	z ɡʲ i nʲ
пригубит	p rʲ i ɡ u bʲ i t
шлицам	ʂ lʲ i t͡s a m
бутилируют	b u tʲ i lʲ i r u j u t
дающийся	d a j u ɕː i j sʲ a
анусах	a n u s a x
коклюш	k a k lʲ u ʂ
разрешимый	r a z rʲ i ʂ i m i j
уругвай	u r u ɡ v a j
ски	s kʲ i
выгрузчиками	v i ɡ r u ɕː i k a mʲ i
айрум	a j r u m
упоениям	u p a j e nʲ i j a m
пообедай	p a a bʲ e d a j
исцелявши	i s t͡s i lʲ a f ʂ i
установит	u s t a n o vʲ i t
хахари	x a x a rʲ i
хмурю	x m u rʲ u
залепляю	z a lʲ i p lʲ a j u
растащим	r a s t a ɕː i m
унтер	u nʲ tʲ i r
божественны	b a ʐ e s t vʲ i n i
баблосы	b a b ɫ o s i
изматывало	i z m a t i v a ɫ a
нумерацией	n u mʲ i r a t͡s i j i j
мудоёба	m u d a j o b a
парейдолиею	p a rʲ i j d a lʲ i j i j u
рефераты	rʲ i fʲ i r a t i
приправе	p rʲ i p r a vʲ e
рассказало	r a s k a z a ɫ a
спёр	s pʲ o r
приравнялась	p rʲ i r a v nʲ a ɫ a sʲ
клонись	k ɫ a nʲ i sʲ
свергала	s vʲ i r ɡ a ɫ a
тавре	t a v rʲ e
захлопнитесь	z a x ɫ o p nʲ i tʲ i sʲ
нацеливаясь	n a t͡s e lʲ i v a j i sʲ
придаваемый	p rʲ i d a v a j i m i j
ободам	o b a d a m
подтягиваюсь	p a tʲː a ɡʲ i v a j u sʲ
платке	p ɫ a t kʲ e
повидать	p a vʲ i d a tʲ
взвинчивал	v z vʲ i nʲ t͡ɕ i v a ɫ
грязнуть	ɡ rʲ a z n u tʲ
диску	dʲ i s k u
перевешивай	pʲ i rʲ i vʲ e ʂ i v a j
комиссиями	k a mʲ i sʲ i j a mʲ i
относительны	a t n a sʲ i tʲ i lʲ n i
вскипали	f s kʲ i p a lʲ i
укутавши	u k u t a f ʂ i
бонбоньеркою	b a n b a nʲ j e r k a j u
рыльцам	r i lʲ t͡s a m
берестов	bʲ e rʲ i s t a f
сверхприбылью	s vʲ e r x p rʲ i b i lʲ j u
запирало	z a pʲ i r a ɫ a
провидца	p r a vʲ i t͡s a
обхватывав	a p x v a t i v a f
истребишь	i s t rʲ i bʲ i ʂ
чемпионами	t͡ɕ i m ⁽ʲ ⁾ pʲ i o n a mʲ i
тамильским	t a mʲ i lʲ s kʲ i m
пупку	p u p k u
волжан	v a ɫ ʐ a n
возмужалый	v a z m u ʐ a ɫ i j
взяточникам	v zʲ a t a t͡ɕ nʲ i k a m
абазинкою	a b a zʲ i n k a j u
оладики	a ɫ a dʲ i kʲ i
хамит	x a mʲ i t
тулии	t u lʲ i i
провзаимодействуешь	p r a v z a i m a dʲ e j s t v u j i ʂ
обрабатывают	a b r a b a t i v a j u t
тел	tʲ e ɫ
кровавил	k r a v a vʲ i ɫ
эвтаназиями	i f t a n a zʲ i j a mʲ i
лыком	ɫ i k a m
маток	m a t a k
налётанный	n a lʲ o t a n i j
долинах	d a lʲ i n a x
зарегистрируюсь	z a rʲ i ɡʲ i s t rʲ i r u j u sʲ
подделывали	p a dʲ e ɫ i v a lʲ i
досматривают	d a s m a t rʲ i v a j u t
поговорите	p a ɡ a v a rʲ i tʲ e
клетку	k lʲ e t k u
ужесточения	u ʐ i s t a t͡ɕ e nʲ i j a
самоцвета	s a m a t͡s vʲ e t a
запаздывав	z a p a z d i v a f
разговорись	r a z ɡ a v a rʲ i sʲ
приглядывавшийся	p rʲ i ɡ lʲ a d i v a f ʂ i j sʲ a
шпагах	ʂ p a ɡ a x
выдворявши	v i d v a rʲ a f ʂ i
заразятся	z a r a zʲ a t͡s a
безматку	bʲ i z m a t k u
совокупление	s a v a k u p lʲ e nʲ i j e
дымился	d i mʲ i ɫ s ⁽ʲ ⁾ a
усложняем	u s ɫ a ʐ nʲ a j i m
обручавший	a b r u t͡ɕ a f ʂ i j
прозвучишь	p r a z v u t͡ɕ i ʂ
перемычка	pʲ i rʲ i m i t͡ɕ k a
бесплодны	bʲ i s p ɫ o d n i
ознаменовав	a z n a mʲ i n a v a f
добреешь	d a b rʲ e j i ʂ
адоптировавшийся	a d a p tʲ i r a v a f ʂ i j sʲ a
пришпилила	p rʲ i ʂ pʲ i lʲ i ɫ a
колесить	k a lʲ i sʲ i tʲ
буксы	b u k s i
воскрешаешь	v a s k rʲ i ʂ a j i ʂ
аккредитива	a k rʲ i dʲ i tʲ i v a
охлопать	a x ɫ o p a tʲ
затирав	z a tʲ i r a f
закопушкой	z a k a p u ʂ k a j
поманили	p a m a nʲ i lʲ i
переиграешь	pʲ i rʲ i i ɡ r a j i ʂ
энцефалитах	i n t͡s i f a lʲ i t a x
опушавшись	a p u ʂ a f ʂ i sʲ
маразмы	m a r a z m i
синхронизаций	sʲ i n x r a nʲ i z a t͡s i j
жертву	ʐ e r t v u
вальцом	v a lʲ t͡s o m
общо	a p ɕː o
трансплантируем	t r a n s p ɫ a nʲ tʲ i r u j i m
вскриков	f s k rʲ i k a f
палеографиям	p a lʲ i a ɡ r a fʲ i j a m
древнейший	d rʲ i v nʲ e j ʂ i j
волчицам	v a ɫ t͡ɕ i t͡s a m
гимназией	ɡʲ i m n a zʲ i j i j
прошлось	p r a ʂ ɫ o sʲ
бантов	b a n t a f
неумерен	nʲ i u mʲ e rʲ i n
осмотрами	a s m o t r a mʲ i
повстанцами	p a f s t a n t͡s a mʲ i
апелляцию	a pʲ i lʲ a t͡s i j u
арке	a r kʲ e
ракша	r a k ʂ a
контроллера	k a n t r o lʲ i r a
чекать	t͡ɕ i k a tʲ
предрекала	p rʲ i d rʲ i k a ɫ a
краткам	k r a t k a m
обережённый	a bʲ i rʲ i ʐ o n i j
антропологии	a n t r a p a ɫ o ɡʲ i i
молилась	m a lʲ i ɫ a sʲ
ола	o ɫ a
жерлах	ʐ e r ɫ a x
сомнениями	s a m nʲ e nʲ i j a mʲ i
полемику	p a lʲ e mʲ i k u
сопроводишь	s a p r a v a dʲ i ʂ
сжалятся	ʐ a lʲ a t͡s a
объедаемый	a b j i d a j i m i j
засосов	z a s o s a f
крякав	k rʲ a k a f
восстанут	v a s t a n u t
ухаживают	u x a ʐ i v a j u t
радиями	r a dʲ i j a mʲ i
выспрашиваемый	v i s p r a ʂ i v a j i m i j
разъезжать	r a z j i ʐ a tʲ
устаревали	u s t a rʲ i v a lʲ i
благородно	b ɫ a ɡ a r o d n a
высевок	v i sʲ i v a k
покроя	p a k r o j a
акмеизма	a k mʲ i i z m a
проговоримся	p r a ɡ a v a rʲ i m sʲ a
надоедал	n a d a j i d a ɫ
наперстянок	n a pʲ i r s ⁽ʲ ⁾ tʲ a n a k
похоронишь	p a x a r o nʲ i ʂ
свалками	s v a ɫ k a mʲ i
подлодке	p a d ɫ o t kʲ e
нарушится	n a r u ʂ i t͡s a
краеведы	k r a j i vʲ e d i
усыновляйте	u s i n a v lʲ a j tʲ e
тратите	t r a tʲ i tʲ e
задумчивостями	z a d u m t͡ɕ i v a sʲ tʲ a mʲ i
отловлю	a t ɫ a v lʲ u
зажглись	z a ʐ ɡ lʲ i sʲ
обеспокоил	a bʲ i s p a k o i ɫ
разрушились	r a z r u ʂ i lʲ i sʲ
баловал	b a ɫ a v a ɫ
глотает	ɡ ɫ a t a j i t
бомбометаниям	b o m b a mʲ i t a nʲ i j a m
студнями	s t u dʲ nʲ a mʲ i
политологиею	p a lʲ i t a ɫ o ɡʲ i j i j u
отщепляйте	a t͡ɕ ɕː i p lʲ a j tʲ e
театре	tʲ i a t a rʲ e
проигрывал	p r a i ɡ r i v a ɫ
заботивши	z a b o tʲ i f ʂ i
котировать	k a tʲ i r a v a tʲ
целлюлозным	t͡s i lʲ u ɫ o z n i m
боронивши	b a r a nʲ i f ʂ i
омрачав	a m r a t͡ɕ a f
сковывай	s k o v i v a j
секунды	sʲ i k u n d i
натовский	n a t a f s kʲ i j
задремлют	z a d rʲ e m lʲ u t
столетний	s t a lʲ e tʲ nʲ i j
заправляем	z a p r a v lʲ a j i m
городишь	ɡ a r o dʲ i ʂ
закладывай	z a k ɫ a d i v a j
перегнёшься	pʲ i rʲ i ɡ nʲ o ʂ sʲ a
адекватностях	a d i k v a t n a sʲ tʲ a x
копчений	k a p t͡ɕ e nʲ i j
пробурчала	p r a b u r t͡ɕ a ɫ a
звонарях	z v a n a rʲ a x
аблактировке	a b ɫ a k tʲ i r o f kʲ e
взмётываемый	v z mʲ o t i v a j i m i j
унижавший	u nʲ i ʐ a f ʂ i j
вонзаешь	v a n z a j i ʂ
хаживал	x a ʐ i v a ɫ
пожирая	p a ʐ i r a j a
орграфами	a r ɡ r a f a mʲ i
цингою	t͡s i n ɡ o j u
рыскает	r i s k a j i t
убив	u bʲ i f
загорались	z a ɡ a r a lʲ i sʲ
договариваются	d a ɡ a v a rʲ i v a j u t͡s a
обмерю	a b mʲ e rʲ u
биатлонами	bʲ i a t ɫ o n a mʲ i
выкаливает	v i k a lʲ i v a j i t
разгибаться	r a z ɡʲ i b a t͡s a
проверяй	p r a vʲ i rʲ a j
дубли	d u b lʲ i
плетёмся	p lʲ i tʲ o m sʲ a
настучав	n a s t u t͡ɕ a f
чулок	t͡ɕ u ɫ o k
путаюсь	p u t a j u sʲ
неформально	nʲ i f a r m a lʲ n a
маршировали	m a r ʂ i r a v a lʲ i
расправилось	r a s p r a vʲ i ɫ a sʲ
заносит	z a n o sʲ i t
приспособите	p rʲ i s p a s o bʲ i tʲ e
контроллером	k a n t r o lʲ i r a m
предприимайте	p rʲ i t p rʲ i i m a j tʲ e
простроилось	p r a s t r o i ɫ a sʲ
нацист	n a t͡s i s t
врезаете	v rʲ i z a j i tʲ e
бант	b a n t
руконожках	r u k a n o ʂ k a x
маскировкою	m a s kʲ i r o f k a j u
уродец	u r o dʲ i t͡s
ожидая	a ʐ i d a j a
баллончик	b a ɫ o nʲ t͡ɕ i k
сразив	s r a zʲ i f
сгущая	z ɡ u ɕː a j a
ренессанса	r i n i s a n s a
отлежалась	a t lʲ i ʐ a ɫ a sʲ
наноса	n a n o s a
цедишь	t͡s e dʲ i ʂ
охраняетесь	a x r a nʲ a j i tʲ i sʲ
околёсицах	a k a lʲ o sʲ i t͡s a x
отозваться	a t a z v a t͡s a
бризантностях	b rʲ i z a n t n a sʲ tʲ a x
коллажах	k a ɫ a ʐ a x
табличку	t a b lʲ i t͡ɕ k u
анализирует	a n a lʲ i zʲ i r u j i t
свешивайте	s vʲ e ʂ i v a j tʲ e
коренившись	k a rʲ i nʲ i f ʂ i sʲ
поносят	p a n o sʲ a t
затемняла	z a tʲ i m nʲ a ɫ a
защитим	z a ɕː i tʲ i m
администраторах	a d mʲ i nʲ i s t r a t a r a x
поднимали	p a dʲ nʲ i m a lʲ i
фурфуролу	f u r f u r o ɫ u
тойтерьер	t a j t i rʲ j e r
предостерегать	p rʲ i d a sʲ tʲ i rʲ i ɡ a tʲ
заговаривайтесь	z a ɡ a v a rʲ i v a j tʲ i sʲ
пелеринами	pʲ i lʲ i rʲ i n a mʲ i
обводивши	a b v a dʲ i f ʂ i
проверив	p r a vʲ e rʲ i f
прогреть	p r a ɡ rʲ e tʲ
опушалась	a p u ʂ a ɫ a sʲ
оперативностью	a pʲ i r a tʲ i v n a sʲ tʲ j u
выводкам	v i v a t k a m
неповторимостях	nʲ i p a f t a rʲ i m a sʲ tʲ a x
эмиграциям	i mʲ i ɡ r a t͡s i j a m
отрецензированный	a t rʲ i t͡s i n ⁽ʲ ⁾ zʲ i r a v a n i j
вздорожании	v z d a r a ʐ a nʲ i i
аблаутов	a b ɫ a u t a f
репликою	rʲ e p lʲ i k a j u
сочувствовала	s a t͡ɕ u s t v a v a ɫ a
хвалимся	x v a lʲ i m sʲ a
впоследствии	f p a s ⁽ʲ ⁾ lʲ e t͡s t vʲ i i
обросший	a b r o ʂ i j
нарвусь	n a r v u sʲ
аврелий	a v rʲ e lʲ i j
натянешься	n a tʲ a nʲ i ʂ sʲ a
плавкою	p ɫ a f k a j u
рогоносце	r a ɡ a n o s t͡s i
опушив	a p u ʂ i f
завешивайте	z a vʲ e ʂ i v a j tʲ e
родильный	r a dʲ i lʲ n i j
бельму	bʲ i lʲ m u
нынешний	n i nʲ i ʂ nʲ i j
стремительно	s t rʲ i mʲ i tʲ i lʲ n a
брезгают	b rʲ e z ɡ a j u t
померещишься	p a mʲ i rʲ e ɕː i ʂ sʲ a
крылышке	k r i ɫ i ʂ kʲ e
сироты	sʲ i r o t i
понудит	p a n u dʲ i t
тарантулом	t a r a n t u ɫ a m
буферах	b u fʲ i r a x
дозволение	d a z v a lʲ e nʲ i j e
выкрасило	v i k r a sʲ i ɫ a
печатанием	pʲ i t͡ɕ a t a nʲ i j i m
сюрреализм	sʲ u rʲ i a lʲ i z m
похищавший	p a xʲ i ɕː a f ʂ i j
гастрит	ɡ a s t rʲ i t
дизентериею	dʲ i zʲ i nʲ tʲ i rʲ i j i j u
сердцебиениях	sʲ i r t͡s i bʲ i j e nʲ i j a x
нанизывает	n a nʲ i z i v a j i t
заворачивающийся	z a v a r a t͡ɕ i v a j u ɕː i j sʲ a
монотонность	m a n a t o n a sʲ tʲ
очертанию	a t͡ɕ i r t a nʲ i j u
отчаливала	a t͡ɕ a lʲ i v a ɫ a
поставщиков	p a s t a f ɕː i k o f
доулах	d o u ɫ a x
остужав	a s t u ʐ a f
поблагодарим	p a b ɫ a ɡ a d a rʲ i m
взламывавший	v z ɫ a m i v a f ʂ i j
устремив	u s t rʲ i mʲ i f
разгласят	r a z ɡ ɫ a sʲ a t
поджигательницы	p a d͡ʐ ʐ i ɡ a tʲ i lʲ nʲ i t͡s i
просвещай	p r a s vʲ i ɕː a j
клавдия	k ɫ a v dʲ i j a
мантиями	m a nʲ tʲ i j a mʲ i
прожидях	p r o ʐ i dʲ a x
промокавший	p r a m a k a f ʂ i j
уделах	u dʲ e ɫ a x
рогачу	r a ɡ a t͡ɕ u
изольются	i z a lʲ j u t͡s a
воздействуют	v a zʲ dʲ e j s t v u j u t
трахнуть	t r a x n u tʲ
гармоники	ɡ a r m o nʲ i kʲ i
обусловили	a b u s ɫ o vʲ i lʲ i
горестно	ɡ o rʲ i s n a
гудела	ɡ u dʲ e ɫ a
угрожающий	u ɡ r a ʐ a j u ɕː i j
синтетику	sʲ i n t e tʲ i k u
подчёркивали	p a t͡ɕ o r kʲ i v a lʲ i
электростанциям	i lʲ e k t r a s t a n t͡s i j a m
каске	k a s kʲ e
узлом	u z ɫ o m
атласов	a t ɫ a s a f
выловят	v i ɫ a vʲ a t
изготовителями	i z ɡ a t a vʲ i tʲ i lʲ a mʲ i
ойкнувший	o j k n u f ʂ i j
непрофессионализмов	nʲ i p r a fʲ i sʲ i a n a lʲ i z m a f
корням	k a r nʲ a m
опрокидываем	a p r a kʲ i d i v a j i m
вскидывалась	f s kʲ i d i v a ɫ a sʲ
избиения	i z bʲ i j e nʲ i j a
светиться	s vʲ i tʲ i t͡s a
аввой	a v a j
присчитывай	p rʲ i ɕː i t i v a j
лосьонам	ɫ a sʲ j o n a m
ринусь	rʲ i n u sʲ
консолидацией	k a n s a lʲ i d a t͡s i j i j
коуче	k o u t͡ɕ e
отвесим	a t vʲ e sʲ i m
остригавшись	a s t rʲ i ɡ a f ʂ i sʲ
нахальничаете	n a x a lʲ nʲ i t͡ɕ i j i tʲ e
своровавший	s v a r a v a f ʂ i j
сетованию	sʲ e t a v a nʲ i j u
доводящий	d a v a dʲ a ɕː i j
обрести	a b rʲ i sʲ tʲ i
оживляйтесь	a ʐ i v lʲ a j tʲ i sʲ
погреетесь	p a ɡ rʲ e j i tʲ i sʲ
конку	k o n k u
конопаченный	k a n a p a t͡ɕ i n i j
пестуйте	pʲ e s t u j tʲ e
причитывайте	p rʲ i t͡ɕ i t i v a j tʲ e
складен	s k ɫ a dʲ i n
шайбах	ʂ a j b a x
сбербанки	z bʲ i r b a n kʲ i
усопла	u s o p ɫ a
вдохнули	v d a x n u lʲ i
облеплять	a b lʲ i p lʲ a tʲ
заела	z a j e ɫ a
вметут	v mʲ i t u t
взяточничеством	v zʲ a t a t͡ɕ nʲ i t͡ɕ i s t v a m
гобеленами	ɡ a bʲ i lʲ e n a mʲ i
гривам	ɡ rʲ i v a m
сердцебиениями	sʲ i r t͡s i bʲ i j e nʲ i j a mʲ i
спокойствии	s p a k o j s t vʲ i i
должку	d a ɫ ʂ k u
высвобождавший	v i s v a b a ʐ d a f ʂ i j
парижане	p a rʲ i ʐ a nʲ e
облупливаются	a b ɫ u p lʲ i v a j u t͡s a
маркировками	m a r kʲ i r o f k a mʲ i
заняло	z a nʲ i ɫ a
кличьте	k lʲ i t͡ɕ tʲ e
пейджер	p e j d͡ʐ ʐ i r
чинодралы	t͡ɕ i n a d r a ɫ i
мигаешь	mʲ i ɡ a j i ʂ
пойл	p o j ɫ
субъективностью	s u b j i k tʲ i v n a sʲ tʲ j u
благоустрой	b ɫ a ɡ a u s t r o j
покупающий	p a k u p a j u ɕː i j
поживавший	p a ʐ i v a f ʂ i j
сослагаете	s a s ɫ a ɡ a j i tʲ e
доводят	d a v o dʲ a t
рукоположивший	r u k a p a ɫ a ʐ i f ʂ i j
товаропроизводителе	t a v a r a p r a i z v a dʲ i tʲ i lʲ e
появиться	p a j i vʲ i t͡s a
фарисеями	f a rʲ i sʲ e j a mʲ i
застревать	z a s t rʲ i v a tʲ
стремянку	s t rʲ i mʲ a n k u
явственно	j a f s t vʲ i n a
карайте	k a r a j tʲ e
пружинит	p r u ʐ i nʲ i t
изъехало	i z j e x a ɫ a
печататься	pʲ i t͡ɕ a t a t͡s a
бутафорией	b u t a f o rʲ i j i j
преуспеете	p rʲ i u s pʲ e j i tʲ e
намудри	n a m u d rʲ i
долготе	d a ɫ ɡ a tʲ e
дугу	d u ɡ u
содрогавшийся	s a d r a ɡ a f ʂ i j sʲ a
саунам	s a u n a m
бесило	bʲ i sʲ i ɫ a
сходит	s x o dʲ i t
осмысляем	a s m i s ⁽ʲ ⁾ lʲ a j i m
дополнивший	d a p o ɫ nʲ i f ʂ i j
председательствовавши	p rʲ i t͡sʲ sʲ i d a tʲ i lʲ s t v a v a f ʂ i
припарка	p rʲ i p a r k a
изобретая	i z a b rʲ i t a j a
причинить	p rʲ i t͡ɕ i nʲ i tʲ
увезёшь	u vʲ i zʲ o ʂ
готовностью	ɡ a t o v n a sʲ tʲ j u
выдачею	v i d a t͡ɕ i j u
библиотекарша	bʲ i b lʲ i a tʲ e k a r ʂ a
сколиоза	s k a lʲ i o z a
испуган	i s p u ɡ a n
ломись	ɫ a mʲ i sʲ
ошарашиваете	a ʂ a r a ʂ i v a j i tʲ e
оплатим	a p ɫ a tʲ i m
склеило	s k lʲ e i ɫ a
кольчугами	k a lʲ t͡ɕ u ɡ a mʲ i
выдаст	v i d a s t
убиенному	u bʲ i j e n a m u
энергоносители	i n e r ɡ a n a sʲ i tʲ i lʲ i
поруководи	p a r u k a v a dʲ i
эйсом	e j s a m
предводителя	p rʲ i d v a dʲ i tʲ i lʲ a
призмой	p rʲ i z m a j
воздевший	v a zʲ dʲ e f ʂ i j
эпифизах	i pʲ i fʲ i z a x
ремешкам	rʲ i mʲ i ʂ k a m
строителю	s t r a i tʲ i lʲ u
папирусах	p a pʲ i r u s a x
отдохнувший	a d a x n u f ʂ i j
расселив	r a sʲ i lʲ i f
уползаете	u p a ɫ z a j i tʲ e
толщами	t o ɫ ɕː a mʲ i
корзна	k o r z n a
исписывало	i s pʲ i s i v a ɫ a
текилах	tʲ i kʲ i ɫ a x
именуй	i mʲ i n u j
промашкам	p r a m a ʂ k a m
опаску	a p a s k u
районах	r a j o n a x
мнений	m nʲ e nʲ i j
выпрямлявшийся	v i p rʲ i m lʲ a f ʂ i j sʲ a
паркуюсь	p a r k u j u sʲ
недолюбливайте	nʲ i d a lʲ u b lʲ i v a j tʲ e
осияваешь	a sʲ i j i v a j i ʂ
садит	s a dʲ i t
углядите	u ɡ lʲ i dʲ i tʲ e
врезаешься	v rʲ i z a j i ʂ sʲ a
эконометриками	i k a n a mʲ e t rʲ i k a mʲ i
нелепиц	nʲ i lʲ e pʲ i t͡s
романистике	r a m a nʲ i sʲ tʲ i kʲ e
вуй	v u j
кинолентами	kʲ i n a lʲ e n t a mʲ i
подъявши	p a d j a f ʂ i
инкубацией	i n k u b a t͡s i j i j
запретам	z a p rʲ e t a m
усиках	u sʲ i k a x
просрочке	p r a s r o t͡ɕ kʲ e
мыслителях	m i s ⁽ʲ ⁾ lʲ i tʲ i lʲ a x
потирать	p a tʲ i r a tʲ
ознакомляем	a z n a k a m lʲ a j i m
вклинивавшийся	f k lʲ i nʲ i v a f ʂ i j sʲ a
пощёлкали	p a ɕː o ɫ k a lʲ i
черкать	t͡ɕ i r k a tʲ
патриарший	p a t rʲ i a r ʂ i j
бодрствованиями	b o d r s t v a v a nʲ i j a mʲ i
козырнёт	k a z i r nʲ o t
кусаем	k u s a j i m
выдают	v i d a j u t
позавтракаю	p a z a f t r a k a j u
входивши	f x a dʲ i f ʂ i
теребейчук	tʲ i rʲ i bʲ i j t͡ɕ u k
англицизациею	a n ɡ lʲ i t͡s i z a t͡s i j i j u
рельефам	rʲ i lʲ j e f a m
смешались	s mʲ i ʂ a lʲ i sʲ
распахиваясь	r a s p a xʲ i v a j i sʲ
дарвиниста	d a r vʲ i nʲ i s t a
отсечений	a t͡sʲ sʲ i t͡ɕ e nʲ i j
апофизою	a p a fʲ i z a j u
проведши	p r a vʲ e t͡ʂ ʂ i
поварят	p a v a rʲ a t
обнажите	a b n a ʐ i tʲ e
приписываемый	p rʲ i pʲ i s i v a j i m i j
испустить	i s p u sʲ tʲ i tʲ
ошарашить	a ʂ a r a ʂ i tʲ
неприкасаемом	nʲ i p rʲ i k a s a j i m a m
полегай	p a lʲ i ɡ a j
капиталовложениями	k a pʲ i t a ɫ a v ɫ a ʐ e nʲ i j a mʲ i
стачкой	s t a t͡ɕ k a j
лётов	lʲ o t a f
основе	a s n o vʲ e
трудовой	t r u d a v o j
гарда	ɡ a r d a
позволяла	p a z v a lʲ a ɫ a
разрознивши	r a z r o zʲ nʲ i f ʂ i
болтали	b a ɫ t a lʲ i
покрышка	p a k r i ʂ k a
сосною	s a s n o j u
попадётся	p a p a dʲ o t͡s a
эрекциею	i r e k t͡s i j i j u
восточный	v a s t o t͡ɕ n i j
фотокарточками	f a t a k a r t a t͡ɕ k a mʲ i
постигнувший	p a sʲ tʲ i ɡ n u f ʂ i j
разгадкам	r a z ɡ a t k a m
повысите	p a v i sʲ i tʲ e
костницей	k o sʲ nʲ i t͡s i j
вкладывают	f k ɫ a d i v a j u t
матрон	m a t r o n
полился	p a lʲ i ɫ s ⁽ʲ ⁾ a
растило	r a sʲ tʲ i ɫ a
прапорщик	p r a p a r ɕː i k
оттянешь	a tʲː a nʲ i ʂ
чохой	t͡ɕ i x o j
активизируете	a k tʲ i vʲ i zʲ i r u j i tʲ e
ощетинила	a ɕː i tʲ i nʲ i ɫ a
елям	j e lʲ a m
вытряхивает	v i t rʲ a xʲ i v a j i t
сокращало	s a k r a ɕː a ɫ a
затащу	z a t a ɕː u
замарывай	z a m a r i v a j
обуславливаем	a b u s ɫ a v lʲ i v a j i m
акцепторы	a k t͡s e p t a r i
священстве	s vʲ i ɕː e n s t vʲ e
приглядываем	p rʲ i ɡ lʲ a d i v a j i m
душевыми	d u ʂ i v i mʲ i
закачал	z a k a t͡ɕ a ɫ
толщах	t o ɫ ɕː a x
насытило	n a s i tʲ i ɫ a
бенгальский	bʲ i n ɡ a lʲ s kʲ i j
безмолвиями	bʲ i z m o ɫ vʲ i j a mʲ i
угощениях	u ɡ a ɕː e nʲ i j a x
пирофорами	pʲ i r a f o r a mʲ i
антидоте	a nʲ tʲ i d o tʲ e
примеряйтесь	p rʲ i mʲ e rʲ i j tʲ i sʲ
фонами	f o n a mʲ i
взмолились	v z m a lʲ i lʲ i sʲ
равнодушию	r a v n a d u ʂ i j u
просвире	p r a s vʲ i rʲ e
хрестоматий	x rʲ i s t a m a tʲ i j
кончали	k a nʲ t͡ɕ a lʲ i
пиздючествах	pʲ i zʲ dʲ u t͡ɕ i s t v a x
заявительнице	z a j i vʲ i tʲ i lʲ nʲ i t͡s i
фейсконтролей	f e j s k a n t r o lʲ i j
умиришь	u mʲ i rʲ i ʂ
тупишь	t u pʲ i ʂ
передохши	pʲ i rʲ i d o x ʂ i
поженить	p a ʐ i nʲ i tʲ
кроет	k r o j i t
экспансия	i k s p a n ⁽ʲ ⁾ sʲ i j a
фальшивите	f a lʲ ʂ i vʲ i tʲ e
сгрудись	z ɡ r u dʲ i sʲ
отпраздновал	a t p r a z n a v a ɫ
училкой	u t͡ɕ i ɫ k a j
видывали	vʲ i d i v a lʲ i
недомогания	nʲ i d a m a ɡ a nʲ i j a
наклонности	n a k ɫ o n a sʲ tʲ i
ранетки	r a nʲ e t kʲ i
разветвляешь	r a z vʲ i t v lʲ a j i ʂ
прокладывающий	p r a k ɫ a d i v a j u ɕː i j
снадобьями	s n a d a b ⁽ʲ ⁾ j a mʲ i
мыслятся	m i s ⁽ʲ ⁾ lʲ a t͡s a
пионеров	pʲ i a nʲ e r a f
красив	k r a sʲ i f
вляпался	v lʲ a p a ɫ s ⁽ʲ ⁾ a
выхаживаем	v i x a ʐ i v a j i m
одиннадцатилетиям	a dʲ i n a t͡s i tʲ i lʲ e tʲ i j a m
дынями	d i nʲ a mʲ i
усугубляйте	u s u ɡ u b lʲ a j tʲ e
гранитный	ɡ r a nʲ i t n i j
старцы	s t a r t͡s i
инфраструктурами	i n f r a s t r u k t u r a mʲ i
видеозапись	vʲ i dʲ i o z a pʲ i sʲ
токсичный	t a k sʲ i t͡ɕ n i j
исказится	i s k a zʲ i t͡s a
разразились	r a z r a zʲ i lʲ i sʲ
увольняющий	u v a lʲ nʲ a j u ɕː i j
кипите	kʲ i pʲ i tʲ e
щитках	ɕː i t k a x
бандеролью	b a n d i r o lʲ j u
привескам	p rʲ i vʲ e s k a m
шиберов	ʂ i bʲ i r o f
погрешу	p a ɡ rʲ i ʂ u
растревоживают	r a s t rʲ i v o ʐ i v a j u t
промахах	p r o m a x a x
инактивирую	i n a k tʲ i vʲ i r u j u
киноплёнках	kʲ i n a p lʲ o n k a x
слёзы	s ⁽ʲ ⁾ lʲ o z i
блумфонтейн	b ɫ u m f a n t i j n
увозов	u v o z a f
накачавший	n a k a t͡ɕ a f ʂ i j
расползайся	r a s p a ɫ z a j sʲ a
утопят	u t o pʲ a t
мочевина	m a t͡ɕ i vʲ i n a
заслушиваться	z a s ɫ u ʂ i v a t͡s a
петрушевский	pʲ i t r u ʂ e f s kʲ i j
заглохший	z a ɡ ɫ o x ʂ i j
патрульному	p a t r u lʲ n a m u
подводники	p a d v o dʲ nʲ i kʲ i
чревоугодиям	t͡ɕ rʲ i v a u ɡ o dʲ i j a m
вводимся	v o dʲ i m sʲ a
виноделам	vʲ i n a dʲ e ɫ a m
хозяева	x a zʲ a j i v a
врачах	v r a t͡ɕ a x
предъявится	p rʲ i d j a vʲ i t͡s a
голье	ɡ a lʲ j e
кардане	k a r d a nʲ e
дорожавши	d a r a ʐ a f ʂ i
направляющий	n a p r a v lʲ a j u ɕː i j
балдел	b a ɫ dʲ e ɫ
надколеннике	n a t k a lʲ e nʲ i kʲ e
сертификата	sʲ i r tʲ i fʲ i k a t a
сгруппировалась	z ɡ r u pʲ i r a v a ɫ a sʲ
ревел	rʲ i vʲ e ɫ
властолюбия	v ɫ a s t a lʲ u bʲ i j a
тропинок	t r a pʲ i n a k
паприках	p a p rʲ i k a x
обобщить	a b a p ɕː i tʲ
попрыгало	p a p r i ɡ a ɫ a
шагни	ʂ a ɡ nʲ i
сконфузитесь	s k a n f u zʲ i tʲ i sʲ
закатывавшись	z a k a t i v a f ʂ i sʲ
картинно	k a r tʲ i n a
огорчав	a ɡ a r t͡ɕ a f
наклеит	n a k lʲ e i t
охнувший	o x n u f ʂ i j
укутывающий	u k u t i v a j u ɕː i j
сынок	s i n o k
списаний	s pʲ i s a nʲ i j
раздумывал	r a z d u m i v a ɫ
истеки	i sʲ tʲ i kʲ i
вытряхнешь	v i t rʲ i x nʲ i ʂ
упираюсь	u pʲ i r a j u sʲ
возвышенно	v a z v i ʂ i n a
дивимый	dʲ i vʲ i m i j
учует	u t͡ɕ u j i t
нахлынувший	n a x ɫ i n u f ʂ i j
кустарям	k u s t a rʲ a m
замахивались	z a m a xʲ i v a lʲ i sʲ
учугов	u t͡ɕ u ɡ a f
сигналю	sʲ i ɡ n a lʲ u
додумаешься	d a d u m a j i ʂ sʲ a
шампуня	ʂ a m p u nʲ a
всматриваешься	f s m a t rʲ i v a j i ʂ sʲ a
хлебнул	x lʲ i b n u ɫ
образчиком	a b r a ɕː i k a m
засверкайте	z a s vʲ i r k a j tʲ e
диктор	dʲ i k t a r
зачарует	z a t͡ɕ i r u j i t
жжёшь	ʐ o ʂ
извиняли	i z vʲ i nʲ a lʲ i
вертишейке	vʲ i r tʲ i ʂ e j kʲ e
пупсиков	p u p sʲ i k a f
загораживала	z a ɡ a r a ʐ i v a ɫ a
рожью	r o ʐ j u
лесоустройством	lʲ e s a u s t r o j s t v a m
дорожкою	d a r o ʂ k a j u
здесь	zʲ dʲ e sʲ
разживалась	r a ʐ i v a ɫ a sʲ
переносиц	pʲ i rʲ i n o sʲ i t͡s
задыхаясь	z a d i x a j i sʲ
растревоживая	r a s t rʲ i v o ʐ i v a j a
перепивав	pʲ i rʲ i pʲ i v a f
толка	t o ɫ k a
ликбезам	lʲ i ɡ bʲ e z a m
выдумками	v i d u m k a mʲ i
хиты	xʲ i t i
отмахавши	a t m a x a f ʂ i
обстригаемый	a p s t rʲ i ɡ a j i m i j
мейтнериев	mʲ i j tʲ nʲ e rʲ i j i f
мановении	m a n a vʲ e nʲ i i
вырыв	v i r i f
печатании	pʲ i t͡ɕ a t a nʲ i i
перигея	pʲ i rʲ i ɡʲ e j a
путепроводам	p u tʲ i p r a v o d a m
четвёртый	t͡ɕ i t vʲ o r t i j
оттащила	a t a ɕː i ɫ a
крошкою	k r o ʂ k a j u
дымили	d i mʲ i lʲ i
маузеры	m a u z i r i
сморкая	s m a r k a j a
йоттабайтах	j o t a b a j t a x
поразите	p a r a zʲ i tʲ e
наместника	n a mʲ e sʲ nʲ i k a
сдвинутся	z d vʲ i n u t͡s a
покладая	p a k ɫ a d a j a
иволгою	i v a ɫ ɡ a j u
топазу	t a p a z u
монтажника	m a n t a ʐ nʲ i k a
занято	z a nʲ i t a
закусила	z a k u sʲ i ɫ a
зачитывайся	z a t͡ɕ i t i v a j sʲ a
категоричностей	k a tʲ i ɡ a rʲ i t͡ɕ n a sʲ tʲ i j
размазывая	r a z m a z i v a j a
увезённый	u vʲ i zʲ o n i j
возобновись	v a z a b n a vʲ i sʲ
уплачивать	u p ɫ a t͡ɕ i v a tʲ
выплачивавшийся	v i p ɫ a t͡ɕ i v a f ʂ i j sʲ a
взбегав	v z bʲ i ɡ a f
придавливало	p rʲ i d a v lʲ i v a ɫ a
мытарствами	m i t a r s t v a mʲ i
отвалишься	a t v a lʲ i ʂ sʲ a
знаменованный	z n a mʲ i n o v a n i j
выучиваясь	v i u t͡ɕ i v a j i sʲ
черемшах	t͡ɕ i rʲ i m ʂ a x
фурункулами	f u r u n k u ɫ a mʲ i
летный	lʲ e t n i j
потребностях	p a t rʲ e b n a sʲ tʲ a x
секта	sʲ e k t a
проработав	p r a r a b o t a f
рябинам	rʲ a bʲ i n a m
капотажами	k a p a t a ʐ a mʲ i
киноаппаратом	kʲ i n a a p a r a t a m
понимаетесь	p a nʲ i m a j i tʲ i sʲ
штурмовой	ʂ t u r m a v o j
алебастр	a lʲ i b a s t r
унимался	u nʲ i m a ɫ s ⁽ʲ ⁾ a
командиров	k a m a nʲ dʲ i r a f
переливает	pʲ i rʲ i lʲ i v a j i t
отдалась	a d a ɫ a sʲ
сковород	s k a v a r o t
уславший	u s ɫ a f ʂ i j
осушал	a s u ʂ a ɫ
пакистанцы	p a kʲ i s t a n t͡s i
силиконы	sʲ i lʲ i k o n i
амбарный	a m b a r n i j
фальцету	f a lʲ t͡s e t u
аскетом	a s kʲ e t a m
влеклась	v lʲ i k ɫ a sʲ
заржаветь	z a r ʐ a vʲ i tʲ
теряет	tʲ i rʲ a j i t
кинофестивалям	kʲ i n a fʲ i sʲ tʲ i v a lʲ a m
левизною	lʲ i vʲ i z n o j u
подставке	p a t͡s s t a f kʲ e
напряжённа	n a p rʲ i ʐ o n a
твой	t v o j
отыгрывалось	a t i ɡ r i v a ɫ a sʲ
киножурналами	kʲ i n a ʐ u r n a ɫ a mʲ i
компрометирующий	k a m p r a mʲ i tʲ i r u j u ɕː i j
халатикам	x a ɫ a tʲ i k a m
родимся	r a dʲ i m sʲ a
опечатывали	a pʲ i t͡ɕ a t i v a lʲ i
недомыслиям	nʲ i d a m i s ⁽ʲ ⁾ lʲ i j a m
наладимся	n a ɫ a dʲ i m sʲ a
писателями	pʲ i s a tʲ i lʲ a mʲ i
взяточниках	v zʲ a t a t͡ɕ nʲ i k a x
сушатся	s u ʂ a t͡s a
сокрушаясь	s a k r u ʂ a j i sʲ
воспроизводивший	v a s p r a i z v a dʲ i f ʂ i j
табу	t a b u
виолончелях	vʲ i a ɫ a nʲ t͡ɕ e lʲ a x
смущал	s m u ɕː a ɫ
афрофобиею	a f r a f o bʲ i j i j u
выпрямлявший	v i p rʲ i m lʲ a f ʂ i j
разыгрывайся	r a z i ɡ r i v a j sʲ a
доработавши	d a r a b o t a f ʂ i
открестившись	a t k rʲ i sʲ tʲ i f ʂ i sʲ
дождливый	d a ʐ d lʲ i v i j
плацента	p ɫ a t͡s e n t a
прыщавый	p r i ɕː a v i j
поручительством	p a r u t͡ɕ i tʲ i lʲ s t v a m
анофелесом	a n o fʲ i lʲ i s a m
возглавляемый	v a z ɡ ɫ a v lʲ a j i m i j
щипая	ɕː i p a j a
дозванивайтесь	d a z v a nʲ i v a j tʲ i sʲ
кровавленный	k r a v a v lʲ i n i j
искалечило	i s k a lʲ e t͡ɕ i ɫ a
отношению	a t n a ʂ e nʲ i j u
кирпич	kʲ i r pʲ i t͡ɕ
транслитерацией	t r a n s ⁽ʲ ⁾ lʲ i tʲ i r a t͡s i j i j
отповедь	o t p a vʲ i tʲ
жидкостями	ʐ i t k a sʲ tʲ a mʲ i
тенёта	tʲ i nʲ o t a
очаг	a t͡ɕ a k
епархия	j i p a r xʲ i j a
обговаривает	a b ɡ a v a rʲ i v a j i t
ломаку	ɫ a m a k u
агатом	a ɡ a t a m
приписало	p rʲ i pʲ i s a ɫ a
удавливают	u d a v lʲ i v a j u t
нюхальщики	nʲ u x a lʲ ɕː i kʲ i
жанров	ʐ a n r a f
ручьёв	r u t͡ɕ j o f
дотаскаешь	d a t a s k a j i ʂ
захаживавший	z a x a ʐ i v a f ʂ i j
наследстве	n a s ⁽ʲ ⁾ lʲ e t͡s t vʲ e
десерты	dʲ i sʲ e r t i
обгрызаем	a b ɡ r i z a j i m
всовавши	f s a v a f ʂ i
благодарностью	b ɫ a ɡ a d a r n a sʲ tʲ j u
наскребавший	n a s k rʲ i b a f ʂ i j
плешь	p lʲ e ʂ
отваживаемся	a t v a ʐ i v a j i m sʲ a
тварях	t v a rʲ a x
заверещать	z a vʲ i rʲ i ɕː a tʲ
сроднивший	s r a dʲ nʲ i f ʂ i j
подъезжавши	p a d j i ʐ a f ʂ i
анфилады	a n fʲ i ɫ a d i
корпусом	k o r p u s a m
назначит	n a z n a t͡ɕ i t
бузотёрами	b u z a tʲ o r a mʲ i
сливами	s ⁽ʲ ⁾ lʲ i v a mʲ i
воевод	v a j i v o t
лярве	lʲ a r vʲ e
аватаре	a v a t a rʲ e
нанимает	n a nʲ i m a j i t
механизатор	mʲ i x a nʲ i z a t a r
лагуну	ɫ a ɡ u n u
взгромождавши	v z ɡ r a m a ʐ d a f ʂ i
поджидала	p a d͡ʐ ʐ i d a ɫ a
гобелене	ɡ a bʲ i lʲ e nʲ e
разбушевались	r a z b u ʂ i v a lʲ i sʲ
множится	m n o ʐ i t͡s a
разбувшись	r a z b u f ʂ i sʲ
обветшалый	a b vʲ i t͡ʂ ʂ a ɫ i j
поведываете	p a vʲ e d i v a j i tʲ e
бабахал	b a b a x a ɫ
соборяне	s a b a rʲ a nʲ e
обретайтесь	a b rʲ i t a j tʲ i sʲ
разговляются	r a z ɡ a v lʲ a j u t͡s a
хлебцем	x lʲ e p t͡s i m
пердеть	pʲ i r dʲ e tʲ
одинока	a dʲ i n o k a
промокай	p r a m a k a j
расквитается	r a s k vʲ i t a j i t͡s a
полетать	p a lʲ i t a tʲ
чуме	t͡ɕ u mʲ e
замечается	z a mʲ i t͡ɕ a j i t͡s a
подворотне	p a d v a r o tʲ nʲ e
семнадцатиугольника	sʲ i m n a t͡s i tʲ i u ɡ o lʲ nʲ i k a
волокит	v a ɫ a kʲ i t
подвыло	p a d v i ɫ a
надрезы	n a d rʲ e z i
куркумой	k u r k u m a j
вкрадывалась	f k r a d i v a ɫ a sʲ
приблизятся	p rʲ i b lʲ i zʲ a t͡s a
светилось	s vʲ i tʲ i ɫ a sʲ
сослуживший	s a s ɫ u ʐ i f ʂ i j
челнок	t͡ɕ i ɫ n o k
труни	t r u nʲ i
скелеты	s kʲ i lʲ e t i
метафизику	mʲ i t a fʲ i zʲ i k u
засаживались	z a s a ʐ i v a lʲ i sʲ
смыкал	s m i k a ɫ
отягощавши	a tʲ i ɡ a ɕː a f ʂ i
накрахмальте	n a k r a x m a lʲ tʲ e
хмыкнут	x m i k n u t
скалишь	s k a lʲ i ʂ
асинхронный	a sʲ i n x r o n i j
мораторий	m a r a t o rʲ i j
привяжу	p rʲ i vʲ i ʐ u
мироточцами	mʲ i r a t o t͡ɕ t͡s a mʲ i
разрастался	r a z r a s t a ɫ s ⁽ʲ ⁾ a
провайдеры	p r a v a j d i r i
уладим	u ɫ a dʲ i m
выправляйте	v i p r a v lʲ a j tʲ e
ушибитесь	u ʂ i bʲ i tʲ i sʲ
базаря	b a z a rʲ a
представлений	p rʲ i t͡s t a v lʲ e nʲ i j
семяизвержении	sʲ i mʲ i i z vʲ i r ʐ e nʲ i i
тучности	t u t͡ɕ n a sʲ tʲ i
выдвигался	v i d vʲ i ɡ a ɫ s ⁽ʲ ⁾ a
съязвил	s j i z vʲ i ɫ
харчем	x a r t͡ɕ i m
стелили	sʲ tʲ i lʲ i lʲ i
спортивны	s p a r tʲ i v n i
терапии	tʲ i r a pʲ i i
борющийся	b o rʲ u ɕː i j sʲ a
клипа	k lʲ i p a
выпустимся	v i p u sʲ tʲ i m sʲ a
завернуть	z a vʲ i r n u tʲ
плошкою	p ɫ o ʂ k a j u
струй	s t r u j
абсорбироваться	a p s a r bʲ i r a v a t͡s a
комик	k o mʲ i k
наворачивает	n a v a r a t͡ɕ i v a j i t
закалывала	z a k a ɫ i v a ɫ a
швартуете	ʂ v a r t u j i tʲ e
отдаляемый	a d a lʲ a j i m i j
шайтану	ʂ a j t a n u
рулями	r u lʲ a mʲ i
сплавы	s p ɫ a v i
отчисляем	a t͡ɕ i s ⁽ʲ ⁾ lʲ a j i m
флотский	f ɫ o t͡s kʲ i j
промолвлю	p r a m o ɫ v lʲ u
дозоров	d a z o r a f
анахоретов	a n a x a rʲ e t a f
дымились	d i mʲ i lʲ i sʲ
поморщимся	p a m o r ɕː i m sʲ a
абстрактам	a p s t r a k t a m
пионеркам	pʲ i a nʲ e r k a m
сравнивая	s r a v nʲ i v a j a
высосали	v i s a s a lʲ i
нидерландского	nʲ i dʲ i r ɫ a n t s k a v a
самосвалами	s a m a s v a ɫ a mʲ i
затаптывающий	z a t a p t i v a j u ɕː i j
увещавший	u vʲ i ɕː a f ʂ i j
облюю	a b lʲ u j u
пирожник	pʲ i r o ʐ nʲ i k
каннибалами	k a nʲ i b a ɫ a mʲ i
отойдите	a t a j dʲ i tʲ e
отборы	a d b o r i
оцепеней	a t͡s i pʲ i nʲ e j
наносекундах	n a n a sʲ i k u n d a x
марева	m a rʲ i v a
дурной	d u r n o j
продержится	p r a dʲ e r ʐ i t͡s a
юлиана	j u lʲ i a n a
святою	s vʲ i t o j u
покрученный	p a k r u t͡ɕ i n i j
обуздывают	a b u z d i v a j u t
эмигранты	i mʲ i ɡ r a n t i
редакция	rʲ i d a k t͡s i j a
сподвижник	s p a d vʲ i ʐ nʲ i k
довлело	d a v lʲ e ɫ a
хлопоты	x ɫ o p a t i
всклокоченный	f s k ɫ a k o t͡ɕ i n i j
возобновите	v a z a b n a vʲ i tʲ e
аравитянина	a r a vʲ i tʲ a nʲ i n a
интерферометра	i n t i r fʲ i r o mʲ i t r a
привстающий	p rʲ i f s t a j u ɕː i j
понадеются	p a n a dʲ e j u t͡s a
колыхав	k a ɫ i x a f
сладкое	s ɫ a t k a j a
затворять	z a t v a rʲ a tʲ
отрезаю	a t rʲ i z a j u
бяках	bʲ a k a x
успокаиваем	u s p a k a i v a j i m
бомбардировка	b a m b a r dʲ i r o f k a
лосося	ɫ a s o sʲ a
опоражнивала	a p a r a ʐ nʲ i v a ɫ a
абсорбатам	a p s a r b a t a m
колеблющий	k a lʲ e b lʲ u ɕː i j
питомце	pʲ i t o m t͡s i
ромашкою	r a m a ʂ k a j u
гонореи	ɡ a n a rʲ e i
утончи	u t a nʲ t͡ɕ i
перебираться	pʲ i rʲ i bʲ i r a t͡s a
коллективизацией	k a lʲ i k tʲ i vʲ i z a t͡s i j i j
отекаю	a tʲ i k a j u
вокале	v a k a lʲ e
расчёсывалась	r a ɕ t͡ɕ o s i v a ɫ a sʲ
панграммами	p a n ɡ r a m a mʲ i
умеет	u mʲ e j i t
прерывавши	p rʲ i r i v a f ʂ i
ошибётесь	a ʂ i bʲ o tʲ i sʲ
вжимались	v ʐ i m a lʲ i sʲ
укреплений	u k rʲ i p lʲ e nʲ i j
кружениях	k r u ʐ e nʲ i j a x
холостяке	x a ɫ a sʲ tʲ i kʲ e
решавши	rʲ i ʂ a f ʂ i
опьянивший	a p ⁽ʲ ⁾ j i nʲ i f ʂ i j
шутим	ʂ u tʲ i m
вступлениях	f s t u p lʲ e nʲ i j a x
атеромы	a t i r o m i
чернуху	t͡ɕ i r n u x u
заклейте	z a k lʲ e j tʲ e
сшибавши	ʂ i b a f ʂ i
пиздить	pʲ i zʲ dʲ i tʲ
военнослужащих	v a j e n a s ɫ u ʐ a ɕː i x
сластён	s ɫ a sʲ tʲ o n
вместишь	v mʲ i sʲ tʲ i ʂ
сделаешься	zʲ dʲ e ɫ a j i ʂ sʲ a
потаскушки	p a t a s k u ʂ kʲ i
прочитываемый	p r a t͡ɕ i t i v a j i m i j
граничила	ɡ r a nʲ i t͡ɕ i ɫ a
озари	a z a rʲ i
ангстрем	a n k s t r i m
конденсаторами	k a n d i n s a t a r a mʲ i
сосуществованиях	s a s u ɕː i s t v a v a nʲ i j a x
простыней	p r o s t i nʲ i j
гвардейца	ɡ v a r dʲ e j t͡s a
пропитайтесь	p r a pʲ i t a j tʲ i sʲ
нику	nʲ i k u
кувшинку	k u f ʂ i n k u
тюфяком	tʲ u fʲ i k o m
кьят	kʲ j a t
обгорают	a b ɡ a r a j u t
подданству	p o d a n s t v u
обогните	a b a ɡ nʲ i tʲ e
изъянами	i z j a n a mʲ i
отказались	a t k a z a lʲ i sʲ
переливало	pʲ i rʲ i lʲ i v a ɫ a
противоположу	p r o tʲ i v a p a ɫ a ʐ u
туземцами	t u zʲ e m t͡s a mʲ i
зарядный	z a rʲ a d n i j
зарёк	z a rʲ o k
курируйте	k u rʲ i r u j tʲ e
разъяряете	r a z j i rʲ a j i tʲ e
откалибровывавшую	a t k a lʲ i b r o v i v a f ʂ u j u
разработалась	r a z r a b o t a ɫ a sʲ
перельются	pʲ i rʲ i lʲ j u t͡s a
подсолнухе	p a t͡s s o ɫ n u xʲ e
гнобите	ɡ n a bʲ i tʲ e
салфеточкам	s a ɫ fʲ e t a t͡ɕ k a m
добывайся	d a b i v a j sʲ a
упокоении	u p a k a j e nʲ i i
агорафобиею	a ɡ a r a f o bʲ i j i j u
пустякам	p u sʲ tʲ i k a m
экзамены	i ɡ z a mʲ i n i
волокут	v a ɫ a k u t
проложивши	p r a ɫ a ʐ i f ʂ i
опоссумом	a p o s u m a m
алкинов	a ɫ kʲ i n a f
сенокосец	sʲ i n a k o sʲ i t͡s
бомбистах	b a m ⁽ʲ ⁾ bʲ i s t a x
кормёжками	k a r mʲ o ʂ k a mʲ i
просматриваете	p r a s m a t rʲ i v a j i tʲ e
переубеди	pʲ i rʲ i u bʲ i dʲ i
превозмогаешь	p rʲ i v a z m a ɡ a j i ʂ
заставав	z a s t a v a f
окошечек	a k o ʂ i t͡ɕ i k
продуцировать	p r a d u t͡s i r a v a tʲ
пихтами	pʲ i x t a mʲ i
весёлостью	vʲ i sʲ o ɫ a sʲ tʲ j u
совершал	s a vʲ i r ʂ a ɫ
пагубах	p a ɡ u b a x
алгоритмам	a ɫ ɡ a rʲ i t m a m
недоступностью	nʲ i d a s t u p n a sʲ tʲ j u
красавчик	k r a s a f t͡ɕ i k
трактуете	t r a k t u j i tʲ e
расхлёбываем	r a s x lʲ o b i v a j i m
растянутся	r a sʲ tʲ a n u t͡s a
владислава	v ɫ a dʲ i s ɫ a v a
прихватизацией	p rʲ i x v a tʲ i z a t͡s i j i j
выясняешь	v i j i sʲ nʲ a j i ʂ
умудрит	u m u d rʲ i t
населяв	n a sʲ i lʲ a f
политологиям	p a lʲ i t a ɫ o ɡʲ i j a m
обсуждением	a p s u ʐ dʲ e nʲ i j i m
спрячьтесь	s p rʲ a t͡ɕ tʲ i sʲ
соломами	s a ɫ o m a mʲ i
нуворишам	n u v a rʲ i ʂ a m
вялостей	vʲ a ɫ a sʲ tʲ i j
дружила	d r u ʐ i ɫ a
транспортам	t r a n s p a r t a m
отъедешь	a t j e dʲ i ʂ
клюсям	k lʲ u sʲ a m
адмотделом	a d m a dʲ e ɫ a m
княжества	k nʲ a ʐ i s t v a
кататься	k a t a t͡s a
абсолютистах	a p s a lʲ u tʲ i s t a x
суммируешь	s u mʲ i r u j i ʂ
полуторку	p a ɫ u t a r k u
отворачивай	a t v a r a t͡ɕ i v a j
пристрастимся	p rʲ i s t r a sʲ tʲ i m sʲ a
уставившись	u s t a vʲ i f ʂ i sʲ
накапливаем	n a k a p lʲ i v a j i m
украшу	u k r a ʂ u
тору	t o r u
мистера	mʲ i s t i r a
пригодность	p rʲ i ɡ o d n a sʲ tʲ
подмечавший	p a d mʲ i t͡ɕ a f ʂ i j
узрю	u z rʲ u
зачислявши	z a t͡ɕ i s ⁽ʲ ⁾ lʲ a f ʂ i
близнецу	b lʲ i zʲ nʲ i t͡s u
тезисов	t e zʲ i s a f
буквам	b u k v a m
хадиса	x a dʲ i s a
аневризм	a nʲ i v rʲ i z m
старое	s t a r a j a
талый	t a ɫ i j
втиснуть	f tʲ i s n u tʲ
верёвке	vʲ i rʲ o f kʲ e
кликала	k lʲ i k a ɫ a
орешь	o rʲ i ʂ
насаждавши	n a s a ʐ d a f ʂ i
сузила	s u zʲ i ɫ a
разведка	r a z vʲ e t k a
сшили	ʂ i lʲ i
осатанеешь	a s a t a nʲ e j i ʂ
цыплятами	t͡s i p lʲ a t a mʲ i
раздельно	r a zʲ dʲ e lʲ n a
грузанёте	ɡ r u z a nʲ o tʲ e
резюмировал	rʲ i zʲ u mʲ i r a v a ɫ
пневмонии	p nʲ i v m a nʲ i i
запечатывая	z a pʲ i t͡ɕ a t i v a j a
синкансэном	sʲ i n k a n s e n a m
мадьярами	m a dʲ j a r a mʲ i
брехлом	b rʲ i x ɫ o m
заутрень	z a u t rʲ i nʲ
добивается	d a bʲ i v a j i t͡s a
отгадывай	a d ɡ a d i v a j
соус	s o u s
палантине	p a ɫ a nʲ tʲ i nʲ e
запрыгать	z a p r i ɡ a tʲ
заблагорассудил	z a b ɫ a ɡ a r a s u dʲ i ɫ
баскетболистом	b a s kʲ i d b a lʲ i s t a m
хаяли	x a j i lʲ i
зонтами	z a n t a mʲ i
неверными	nʲ i vʲ e r n i mʲ i
расстилавши	r a sʲ tʲ i ɫ a f ʂ i
багажниках	b a ɡ a ʐ nʲ i k a x
нарды	n a r d i
междуречьям	mʲ i ʐ d u rʲ e t͡ɕ j a m
епитрахилей	j i pʲ i t r a xʲ i lʲ i j
телетекстах	tʲ e lʲ i tʲ e k s t a x
заносу	z a n o s u
патронажах	p a t r a n a ʐ a x
устремлённостей	u s t rʲ i m lʲ o n a sʲ tʲ i j
сигнализаций	sʲ i ɡ n a lʲ i z a t͡s i j
гранит	ɡ r a nʲ i t
тихвинский	tʲ i x vʲ i n s kʲ i j
сопела	s a pʲ e ɫ a
завалитесь	z a v a lʲ i tʲ i sʲ
экспериментировавший	i k s pʲ i rʲ i mʲ i nʲ tʲ i r a v a f ʂ i j
доросли	d a r a s ⁽ʲ ⁾ lʲ i
предъявись	p rʲ i d j i vʲ i sʲ
катафалке	k a t a f a ɫ kʲ e
наносивший	n a n a sʲ i f ʂ i j
изъяснят	i z j i sʲ nʲ a t
атавизмов	a t a vʲ i z m a f
обесчещивает	a bʲ i ɕ t͡ɕ e ɕː i v a j i t
пропитывав	p r a pʲ i t i v a f
чуланчиков	t͡ɕ u ɫ a nʲ t͡ɕ i k a f
осмотримся	a s m o t rʲ i m sʲ a
обхватов	a p x v a t a f
сачкуйте	s a t͡ɕ k u j tʲ e
насыщаюсь	n a s i ɕː a j u sʲ
маскируетесь	m a s kʲ i r u j i tʲ i sʲ
заявляешь	z a j i v lʲ a j i ʂ
нагревают	n a ɡ rʲ i v a j u t
радары	r a d a r i
повадились	p a v a dʲ i lʲ i sʲ
апсидой	a p sʲ i d a j
подстраховал	p a t͡s s t r a x a v a ɫ
котёночек	k a tʲ o n a t͡ɕ i k
туловищем	t u ɫ a vʲ i ɕː i m
милитаризируя	mʲ i lʲ i t a rʲ i zʲ i r u j a
уповать	u p a v a tʲ
манипуляция	m a nʲ i p u lʲ a t͡s i j a
оподельдока	a p a d i lʲ d o k a
флейтами	f lʲ e j t a mʲ i
курский	k u r s kʲ i j
систола	sʲ i s t a ɫ a
ведавший	vʲ e d a f ʂ i j
матёрый	m a tʲ o r i j
модернизированный	m a d i r nʲ i zʲ i r a v a n i j
башке	b a ʂ kʲ e
продержим	p r a dʲ e r ʐ i m
антенною	a n t e n a j u
резнями	rʲ i zʲ nʲ a mʲ i
поучаствуете	p a u t͡ɕ a s t v u j i tʲ e
растопила	r a s t a pʲ i ɫ a
дамиан	d a mʲ i a n
дубком	d u p k o m
мимикрий	mʲ i mʲ i k rʲ i j
обречённостью	a b rʲ i t͡ɕ o n a sʲ tʲ j u
просветлевший	p r a s vʲ i t lʲ e f ʂ i j
полутьмах	p a ɫ u tʲ m a x
инкубациям	i n k u b a t͡s i j a m
мобилизовав	m a bʲ i lʲ i z a v a f
найдёнышей	n a j dʲ o n i ʂ i j
нечеловеческий	nʲ i t͡ɕ i ɫ a vʲ e t͡ɕ i s kʲ i j
сформулировал	s f a r m u lʲ i r a v a ɫ
еловый	j i ɫ o v i j
резалась	rʲ e z a ɫ a sʲ
плантациях	p ɫ a n t a t͡s i j a x
загремишь	z a ɡ rʲ i mʲ i ʂ
выменивавши	v i mʲ e nʲ i v a f ʂ i
присмотревши	p rʲ i s m a t rʲ e f ʂ i
больнаи	b a lʲ n a i
какую	k a k u j u
объевший	a b j e f ʂ i j
тыква	t i k v a
держава	dʲ i r ʐ a v a
завываете	z a v i v a j i tʲ e
урону	u r o n u
колбасить	k a ɫ b a sʲ i tʲ
перелистает	pʲ i rʲ i lʲ i s t a j i t
провернуть	p r a vʲ i r n u tʲ
анграпа	a n ɡ r a p a
воздадите	v a z d a dʲ i tʲ e
разговорчиками	r a z ɡ a v o r t͡ɕ i k a mʲ i
обугливала	a b u ɡ lʲ i v a ɫ a
природе	p rʲ i r o dʲ e
санитары	s a nʲ i t a r i
перечтём	pʲ i rʲ i t͡ɕ tʲ o m
стихаем	sʲ tʲ i x a j i m
умыслив	u m i s ⁽ʲ ⁾ lʲ i f
дрожанию	d r a ʐ a nʲ i j u
сраженью	s r a ʐ e nʲ j u
администрациях	a d mʲ i nʲ i s t r a t͡s i j a x
отворачиваюсь	a t v a r a t͡ɕ i v a j u sʲ
чунями	t͡ɕ u nʲ a mʲ i
переделываю	pʲ i rʲ i dʲ e ɫ i v a j u
вскинул	f s kʲ i n u ɫ
назначении	n a z n a t͡ɕ e nʲ i i
производительности	p r a i z v a dʲ i tʲ i lʲ n a sʲ tʲ i
створяло	s t v a rʲ a ɫ a
приземлявшийся	p rʲ i zʲ i m lʲ a f ʂ i j sʲ a
распевавший	r a s pʲ i v a f ʂ i j
булавкой	b u ɫ a f k a j
напротив	n a p r o tʲ i f
эполетом	i p a lʲ e t a m
одиссеями	a dʲ i sʲ e j a mʲ i
разгоняете	r a z ɡ a nʲ a j i tʲ e
нелепицею	nʲ i lʲ e pʲ i t͡s i j u
слобода	s ɫ a b a d a
царевна	t͡s a rʲ e v n a
сглотнутый	z ɡ ɫ o t n u t i j
поведениям	p a vʲ i dʲ e nʲ i j a m
просияло	p r a sʲ i j a ɫ a
обакш	a b a k ʂ
куркумы	k u r k u m i
выкорчёвывайте	v i k a r t͡ɕ o v i v a j tʲ e
краба	k r a b a
дубу	d u b u
реек	rʲ e j i k
накачиваешь	n a k a t͡ɕ i v a j i ʂ
санфранцисца	s a n f r a n t͡s i s t͡s a
затешешь	z a tʲ e ʂ i ʂ
выразителям	v i r a zʲ i tʲ i lʲ a m
сумасброды	s u m a z b r o d i
дураков	d u r a k o f
разразившись	r a z r a zʲ i f ʂ i sʲ
кудесу	k u dʲ e s u
рубки	r u p kʲ i
затирая	z a tʲ i r a j a
вставило	f s t a vʲ i ɫ a
выправлять	v i p r a v lʲ a tʲ
виадуке	vʲ i a d u kʲ e
плюхайтесь	p lʲ u x a j tʲ i sʲ
созвать	s a z v a tʲ
новосельем	n a v a sʲ e lʲ j i m
выливался	v i lʲ i v a ɫ s ⁽ʲ ⁾ a
вмазывай	v m a z i v a j
благословимся	b ɫ a ɡ a s ɫ a vʲ i m sʲ a
выкапывали	v i k a p i v a lʲ i
буржуазны	b u r ʐ u a z n i
зимовав	zʲ i m a v a f
причиталась	p rʲ i t͡ɕ i t a ɫ a sʲ
прокурору	p r a k u r o r u
подставила	p a t͡s s t a vʲ i ɫ a
бороздим	b a r a zʲ dʲ i m
воображаем	v a a b r a ʐ a j i m
бекасу	bʲ i k a s u
сровняйте	s r a v nʲ a j tʲ e
заторов	z a t o r a f
ростовой	r a s t a v o j
постукивающий	p a s t u kʲ i v a j u ɕː i j
разраставшись	r a z r a s t a f ʂ i sʲ
лженаука	ɫ ʐ i n a u k a
спор	s p o r
