croate	k r o a t e
omniprezențele	o m n i p r e z e n t s e l e
pălămidă	p ə l ə m i d ə
alterat	a l t e r a t
limitase	l i m i t a s e
numitele	n u m i t e l e
regine	r e d͡ʒ i n e
plictisească	p l i k t i s e̯ a s k ə
protejat	p r o t e ʒ a t
bumbac	b u m b a k
pregătitul	p r e ɡ ə t i t u
ceramico	t͡ʃ e r a m i k o
delimitează	d e l i m i t e̯ a z ə
farfurie	f a r f u r i e
pornesc	p o r n e s k
epistole	e p i s t o l e
mulțumitul	m u l t͡s u m i t u
masturbatele	m a s t u r b a t e l e
controlași	k o n t r o l a ʃʲ
cântărețelor	k ɨ n t ə r e t͡s e l o r
violai	v i o l a j
cântărețului	k ɨ n t ə r e t͡s u l u j
buze	b u z e
fumez	f u m e z
simpla	s i m p l a
fumasem	f u m a s e m
vorbiră	v o r b i r ə
fututei	f u t u t e j
răpirăm	r ə p i r ə m
făcusem	f ə k u s e m
nemort	n e m o r t
slovene	s l o v e n e
despre	d e s p r e
boli	b o l i
somase	s o m a s e
respire	r e s p i r e
distingi	d i s t i n d͡ʒʲ
hidrogenam	h i d r o d͡ʒ e n a m
spui	s p u j
limitezi	l i m i t e zʲ
dușmănea	d u ʃ m ə n j a
colorai	k o l o r a j
gândiseși	ɡ ɨ n d i s e ʃʲ
excitai	e k s t͡ʃ i t a j
delira	d e l i r a
proclami	p r o k l a mʲ
aspir	a s p i r
haotic	h a o t i k
fese	f e s e
armăsari	a r m ə s a rʲ
protejaserăm	p r o t e ʒ a s e r ə m
trepidat	t r e p i d a t
vorbea	v o r bʲ æ
daneze	d a n e z e
forjase	f o r ʒ a s e
furi	f u rʲ
îmbunătățiseși	ɨ m b u n ə t ə t s i s e ʃʲ
mediem	m e d i e m
scrotalele	s k r o t a l e l e
orientează	o r i e n t e̯ a z ə
prietenelor	p r i e t e n e l o r
celebrase	t͡ʃ e l e b r a s e
sperme	s p e r m e
câștig	k ɨ ʃ t i ɡ
oală	w a l ə
probat	p r o b a t
vaci	v a t͡ʃʲ
furăm	f u r ə m
abandonaserăm	a b a n d o n a s e r ə m
speculai	s p e k u l a j
coardă	k o̯ a r d ə
anexam	a n e k s a m
cenzurase	t͡ʃ e n z u r a s e
fantasme	f a n t a s m e
crispai	k r i s p a j
răpise	r ə p i s e
mărturisiți	m ə r t u r i s i t͡sʲ
copleșitoarei	k o p l e ʃ i t o̯ a r e j
masturbaserăm	m a s t u r b a s e r ə m
secase	s e k a s e
șantajiste	ʃ a n t a ʒ i s t e
avui	a v u j
erați	j e r a t͡sʲ
cânți	k ɨ n t͡sʲ
botez	b o t e z
tai	t a j
înzestraserăți	ɨ n z e s t r a s e r ə t sʲ
alte	a l t e
regele	r e d͡ʒ e l e
cărticică	k ɘ̯ʳ t i t͡ʃ i k ə
lumini	l u m i nʲ
ger	d͡ʒ e r
române	r o m ɨ n e
mediase	m e d i a s e
congelai	k o n d͡ʒ e l a j
faptelor	f a p t e l o r
necăjitului	n e k ə ʒ i t u l u j
delirat	d e l i r a t
asurzitului	a s u r z i t u l u j
dublam	d u b l a m
delimitau	d e l i m i t a w
feminin	f e m i n i n
cumnat	k u m n a t
deranjași	d e r a n ʒ a ʃʲ
designase	d e s i ɡ n a s e
somară	s o m a r ə
veștejește	v e ʃ t e ʒ e ʃ t e
incriminez	i n k r i m i n e z
hora	h o r a
îmbunătățisem	ɨ m b u n ə t ə t s i s e m
stupiditate	s t u p i d i t a t e
sacrificam	s a k r i f i k a m
informase	i n f o r m a s e
amici	a m i t͡ʃʲ
informatico	i n f o r m a t i k o
masau	m a s a w
preparai	p r e p a r a j
justificai	ʒ u s t i f i k a j
diminuam	d i m i n u a m
porniți	p o r n i t͡sʲ
tatuajele	t a t u a ʒ e l e
sălbatic	s ə l b a t i k
oară	w a ɾ ə
fuseși	f u s e ʃʲ
horei	h o r e j
ferme	f e r m e
caprina	k a p r i n a
deliberam	d e l i b e r a m
găsea	ɡ ə s e̯ a
formase	f o r m a s e
crema	k r e m a
îmbunătățește	ɨ m b u n ə t ə t s e ʃ t e
dușmănește	d u ʃ m ə n e ʃ t e
îmbunătățiții	ɨ m b u n ə t ə t͡s i t͡s iː
grăbeam	ɡ r ə b e̯ a m
vizibilitate	v i z i b i l i t a t e
locui	l o k u i
Florin	f l o r i n
pizde	p i z d e
explicase	e k s p l i k a s e
anarhistă	a n a r h i s t ə
necăjiserăm	n e k ə ʒ i s e r ə m
fantezii	f a n t e z iː
abolim	a b o l i m
mulțumite	m u l t͡s u m i t e
profesase	p r o f e s a s e
Coreei	k o r eː j
limită	l i m i t ə
juisa	ʒ u i s a
plecam	p l e k a m
feline	f e l i n e
biofizician	b i o f i z i t͡ʃ j a n
bifurcase	b i f u r k a s e
fututele	f u t u t e l e
crunt	k r u n t
veștejit	v e ʃ t e ʒ i t
vomitai	v o m i t a j
hiperbolizase	h i p e r b o l i z a s e
șantaje	ʃ a n t a ʒ e
excitase	e k s t͡ʃ i t a s e
adorm	a d o r m
repetat	r e p e t a t
complexități	c o m p l e k s i t ə t͡sʲ
misterioaselor	m i s t e r i o̯ a s e l o r
recunoscut	r e k u n o s k u t
comandam	k o m a n d a m
probam	p r o b a m
danez	d a n e z
folosiseși	f o l o s i s e ʃʲ
indignam	i n d i ɡ n a m
nominale	n o m i n a l e
visez	v i s e z
vodcă	v o d k ə
circulase	t͡ʃ i r k u l a s e
întâlnitelor	ɨ n t ɨ l n i t e l o r
pitoresc	p i t o r e s k
abandonaseși	a b a n d o n a s e ʃʲ
asurzirăți	a s u r z i r ə t sʲ
pornească	p o r n e̯ a s k ə
poșetă	p o ʃ e t ə
dispare	d i s p a r e
protestai	p r o t e s t a j
somă	s o m ə
sau	s a w
invalidez	i n v a l i d e z
irite	i r i t e
clădim	k l ə d i m
necăjea	n e k ə ʒ e̯ a
șopti	ʃ o p t i
străluc	s t r ə l u k
spovediții	s p o v e d i t͡s iː
biserică	b i s e r i k ə
provocam	p r o v o k a m
sandviș	s a n d v i ʃ
separai	s e p a r a j
năluciră	n ə l u t ʃ i r ə
remarcase	r e m a r k a s e
mâncau	m ɨ n k a w
cream	k r e a m
realitate	r e a l i t a t e
ani	a nʲ
cunoscu	k u n o s k u
scrotal	s k r o t a l
plictisitele	p l i k t i s i t e l e
halucinație	h a l u t͡ʃ i n a t͡s i e
fremete	f r e m e t e
susure	s u s u r e
foca	f o k a
grinda	ɡ r i n d a
pap	p a p
neîmbunătățit	n e ɨ m b u n ə t ə t͡s i t
puțoi	p u t s o j
pulei	p u l e j
pornind	p o r n i n d
dorințe	d o r i n t͡s e
coste	k o s t e
conjugai	k o n ʒ u ɡ a j
dormitase	d o r m i t a s e
gravitase	ɡ r a v i t a s e
erou	e ɾ o w
opritului	o p r i t u l u j
caos	k a o s
oier	o j e r
mâncând	m ɨ n k ɨ n d
gazela	ɡ a z e l a
distrarăți	d i s t r a r ə t sʲ
controlaseră	k o n t r o l a s e r ə
opriserăți	o p r i s e r ə t͡sʲ
călătorită	k ə l ə t o r i t ə
barba	b a r b a
numisem	n u m i s e m
columne	k o l u m n e
nălucisem	n ə l u t ʃ i s e m
substanțe	s u b s t a n t͡s e
mulțumești	m u l t͡s u m e ʃ tʲ
frica	f r i k a
buco	b u k o
prieten	p r i e t e n
numiseși	n u m i s e ʃʲ
elevei	e l e v e j
zăcea	z ə t ʃ e̯ a
stimulat	s t i m u l a t
falei	f a l e j
deranjarăm	d e r a n ʒ a r ə m
barat	b a r a t
figurina	f i ɡ u r i n a
devin	d e v i n
acid	a t͡ʃ i d
întâlnit	ɨ n t ɨ l n i t
călătoream	k ə l ə t o r j a m
injectez	i n ʒ e k t e z
sodomizam	s o d o m i z a m
simplifica	s i m p l i f i k a
glume	ɡ l u m e
zăpușise	z ə p u ʃ i s e
funcționez	f u n k t͡s i o n e z
estoniană	e s t o n i a n ə
Varujan	v a r u ʒ a n
pneumonoultramicroscopicsilicovolcaniconiozele	p n e u m o n o u l t r a m i k r o s k o p i k s i l i k o v o l k a n i k o n i o z e l e
numeam	n u m e̯ a m
augmentai	a u ɡ m e n t a j
tocai	t o k a j
azeri	a z e rʲ
jaleo	ʒ a l e̯ o
sprânceană	s p r ɨ n t ʃ e̯ a n ə
analizaserăm	a n a l i z a s e r ə m
îngeri	ɨ n d ʒ e rʲ
comuna	k o m u n a
năluciserăți	n ə l u t ʃ i s e r ə t͡sʲ
deranjasem	d e r a n ʒ a s e m
ejaculasem	e ʒ a k u l a s e m
distrează	d i s t r e̯ a z ə
tatuează	t a t u e̯ a z ə
clăditei	k l ə d i t e j
arme	a r m e
delimitezi	d e l i m i t e zʲ
vocală	v o k a l ə
ptru	ʙ̥ː u
recuperai	r e k u p e r a j
gravitai	ɡ r a v i t a j
balcanic	b a l k a n i k
torturau	t o r t u r a w
zăpușită	z ə p u ʃ i t ə
terminase	t e r m i n a s e
modificase	m o d i f i k a s e
spumai	s p u m a j
fumam	f u m a m
plantez	p l a n t e z
dictez	d i k t e z
hotele	h o t e l e
chitare	k i t a r e
delirară	d e l i r a r ə
plictisim	p l i k t i s i m
odată	o d a t ə
fumară	f u m a r ə
formaseși	f o r m a s e ʃʲ
funcționaseră	f u n k t͡s i o n a s e r ə
fapte	f a p t e
neprotejat	n e p r o t e ʒ a t
mănânci	m ə n ɨ n t͡ʃʲ
comun	k o m u n
fraza	f r a z a
îmbunătățiși	ɨ m b u n ə t ə t s i ʃʲ
iezi	j e zʲ
place	p l a t͡ʃ e
mulțumi	m u l t͡s u m i
misteriosului	m i s t e r i o s u l u j
lipseai	l i p s e̯ a j
delimitarăți	d e l i m i t a r ə t sʲ
conjugi	k o n ʒ u d͡ʒʲ
sângeraseră	s ɨ n d͡ʒ e r a s e r ə
fabrice	f a b r i t͡ʃ e
pornita	p o r n i t a
vergi	v e r d͡ʒʲ
analogie	a n a l o d͡ʒ i e
slobozi	s l o b o z i
sfârșirăți	s f ɨ r ʃ i r ə t͡sʲ
gândită	ɡ ɨ n d i t ə
nenorocitule	n e n o ɾ o t͡ʃ i t u l e
expediam	e k s p e d i a m
divinizase	d i v i n i z a s e
dușmăneam	d u ʃ m ə n j a m
pornografii	p o r n o ɡ r a f iː
sunau	s u n a w
visat	v i s a t
discutai	d i s k u t a j
delirez	d e l i r e z
găsit	ɡ ə s i t
gorila	ɡ o r i l a
estoniano	e s t o n i a n o
folosiși	f o l o s i ʃʲ
protestat	p r o t e s t a t
protejaseră	p r o t e ʒ a s e r ə
logat	l o ɡ a t
oprise	o p r i s e
soarte	s o̯ a r t e
seducție	s e d u k t͡s i e
vampir	v a m p i r
serbai	s e r b a j
răpii	r ə p iː
popularitate	p o p u l a r i t a t e
gravitație	ɡ ɾ a v i t a t͡s i e
albeam	a l b e̯ a m
iudaism	j u d a i s m
ignorase	i ɡ n o r a s e
designat	d e s i ɡ n a t
armez	a r m e z
delirași	d e l i r a ʃʲ
sperai	s p e r a j
mărturisita	m ə r t u r i s i t a
somași	s o m a ʃʲ
lubrifiant	l u b r i f i a n t
estimai	e s t i m a j
accelerarăm	a k t͡ʃ e l e r a r ə m
gravitași	ɡ r a v i t a ʃʲ
somaserăm	s o m a s e r ə m
penisurile	p e n i s u r i l e
celebrez	t͡ʃ e l e b r e z
fixam	f i k s a m
indignai	i n d i ɡ n a j
futuților	f u t u t͡s i l o r
brâncă	b r ɨ n k ə
călătorie	k ə l ə t o r i e
întâia	ɨ n t ɨ j a
simulez	s i m u l e z
păcat	p ə k a t
curam	k u r a m
avem	a v e m
poruncă	p o r u n k ə
ideologia	i d e o l o d͡ʒ i a
formula	f o r m u l a
prepoziție	p r e p o z i t͡s i e
astupe	a s t u p e
umani	u m a nʲ
strigai	s t r i ɡ a j
pământești	p ə m ɨ n t e ʃ tʲ
întâlniși	ɨ n t ɨ l n i ʃʲ
abandonași	a b a n d o n a ʃʲ
scoli	s k o lʲ
fabric	f a b r i k
balene	b a l e n e
anțărț	a n t s ə r t s
saturam	s a t u r a m
haltera	h a l t e r a
dimineții	d i m i n e t s iː
analizând	a n a l i z ɨ n d
gravita	ɡ r a v i t a
ejacula	e ʒ a k u l a
resurse	r e s u r s e
Ceaușescu	t͡ʃ e̯ a u ʃ e s k u
acceleraserăm	a k t͡ʃ e l e r a s e r ə m
ție	t s i e
organizase	o r ɡ a n i z a s e
necăjitul	n e k ə ʒ i t u
Cataloniei	k a t a l o n i e j
câștigat	k ɨ ʃ t i ɡ a t
mărturisirăm	m ə r t u r i s i r ə m
serilor	s e r i l o r
augmentase	a u ɡ m e n t a s e
umana	u m a n a
murmuram	m u r m u r a m
imputai	i m p u t a j
opriră	o p r i r ə
proteja	p r o t e ʒ a
găseau	ɡ ə s e̯ a w
boram	b o r a m
aventurai	a v e n t u r a j
stimularăți	s t i m u l a r ə t sʲ
copilului	k o p i l u l u j
oprite	o p r i t e
tentaseși	t e n t a s e ʃʲ
citiți	t͡ʃ i t i t͡sʲ
ceri	t ʃ e rʲ
nude	n u d e
acceleram	a k t͡ʃ e l e r a m
sexualei	s e k s u a l e j
valsam	v a l s a m
limitaseră	l i m i t a s e r ə
juisezi	ʒ u i s e zʲ
deranjă	d e r a n ʒ ə
masturbate	m a s t u r b a t e
cepe	t͡ʃ e p e
aveți	a v e t sʲ
bombe	b o m b e
perciunat	p e r t͡ʃ j u n a t
nor	n o r
anihilase	a n i h i l a s e
tem	t e m
anusurile	a n u s u r i l e
perineului	p e r i n e u l
geantă	d͡ʒ e̯ a n t ə
iubit	j u b i t
cenzurară	t͡ʃ e n z u r a r ə
franțuzește	f r a n t͡s u z e ʃ t e
testosteron	t e s t o s t e r o n
bulgar	b u l ɡ a r
potabili	p o t a b i lʲ
laptele	l a p t e l e
fluxuri	f l u k s u rʲ
iubisem	j u b i s e m
preludiu	p r e l u d j u
Madalina	m a d a l i n a
catule	k a t u l e
erotică	e r o t i k ə
ruinam	r u i n a m
păianjenului	p ə j a n ʒ e n u l u j
sugem	s u d͡ʒ e m
tentase	t e n t a s e
memorie	m e m o r i e
deranjarăți	d e r a n ʒ a r ə t sʲ
cingi	t͡ʃ i n d͡ʒʲ
biomasa	b i o m a s a
creasem	k r e a s e m
torturați	t o r t u r a t͡sʲ
faci	f a t͡ʃʲ
provoc	p r o v o k
chei	k e j
piure	p j u r e
imaginai	i m a d͡ʒ i n a j
oprești	o p r e ʃ tʲ
conspiram	k o n s p i r a m
gândite	ɡ ɨ n d i t e
rășină	r ə ʃ i n ə
mân	m ɨ n
iubirilor	j u b i r i l o r
focule	f o k u l e
analizași	a n a l i z a ʃʲ
blasfemam	b l a s f e m a m
drăgălaș	d r ə ɡ ə l a ʃ
răpit	r ə p i t
respir	r e s p i r
mâncaserăm	m ɨ n k a s e r ə m
comparat	k o m p a r a t
dușmănitele	d u ʃ m ə n i t e l e
formo	f o r m o
pornografului	p o r n o ɡ r a f u l u j
înzestram	ɨ n z e s t r a m
diminuai	d i m i n u a j
ejaculație	e ʒ a k u l a t͡s i e
analizaserăți	a n a l i z a s e r ə t sʲ
undam	u n d a m
homosexualul	h o m o s e k s u a l u
șoptise	ʃ o p t i s e
ejaculară	e ʒ a k u l a r ə
lacrimi	l a k r i mʲ
pliez	p l i e z
fugim	f u d͡ʒ i m
întâlnise	ɨ n t ɨ l n i s e
canicule	k a n i k u l e
degerat	d e d͡ʒ e r a t
burete	b u r e t e
nominalizase	n o m i n a l i z a s e
formeze	f o r m e z e
caraghios	k a r a ɡ j o s
sănătos	s ə n ə t o s
țară	t s a r ə
îmbunătățim	ɨ m b u n ə t ə t s i m
contase	k o n t a s e
limitați	l i m i t a t͡sʲ
pulilor	p u l i l o r
intimidam	i n t i m i d a m
oprit	o p r i t
delimităm	d e l i m i t ə m
vocale	v o k a l e
întărite	ɨ n t ə r i t e
meritat	m e r i t a t
somnifer	s o m n i f e ɾ
protestez	p r o t e s t e z
amu	a m u
inspirat	i n s p i r a t
perineul	p e r i n e u l
capsulase	k a p s u l a s e
cocori	k o k o rʲ
numiții	n u m i t͡s iː
melanj	m e l a n ʒ
fugii	f u d͡ʒ iː
clădească	k l ə d j a s k ə
mărturisească	m ə r t u r i s e̯ a s k ə
frec	f r e k
nălucesc	n ə l u t ʃ e s k
întrebare	ɨ n t r e b a r e
haina	h a j n a
indiscret	i n d i s k r e t
perseveram	p e r s e v e r a m
spovedi	s p o v e d i
zahărului	z a h ə r u l u j
misterioasa	m i s t e r i o̯ a s a
nălucească	n ə l u t ʃ e̯ a s k ə
băga	b ə ɡ a
fosa	f o s a
mulțumiserăți	m u l t͡s u m i s e r ə t͡sʲ
triste	t r i s t e
genetica	d͡ʒ e n e t i k a
lubrifiai	l u b r i f i a j
hămesi	h ə m e s i
Macedonia	m a t͡ʃ e d o n i a
absorbim	a b s o r b i m
animalitate	a n i m a l i t a t e
spectru	s p e k t r u
gravitară	ɡ r a v i t a r ə
apele	a p e l e
omniprezenți	o m n i p r e z e n t͡sʲ
întâlneai	ɨ n t ɨ l n e̯ a j
haos	h a o s
promisiuni	p r o m i s i u nʲ
opriții	o p r i t͡s iː
acumulai	a k u m u l a j
flaute	f l a u t e
întristați	ɨ n t r i s t a t͡sʲ
evoluție	e v o l u t͡s i e
deranjăm	d e r a n ʒ ə m
fundamentale	f u n d a m e n t a l e
martirizai	m a r t i r i z a j
Cosmin	k o s m i n
șantajul	ʃ a n t a ʒ u
primiți	p r i m i t͡sʲ
reformam	r e f o r m a m
caci	k a t͡ʃʲ
sfârșiseși	s f ɨ r ʃ i s e ʃʲ
tatuezi	t a t u e zʲ
pornim	p o r n i m
sexualelor	s e k s u a l e l o r
bombez	b o m b e z
misterioasei	m i s t e r i o̯ a s e j
gândiții	ɡ ɨ n d i t͡s iː
felațiile	f e l a t s iː l e
banda	b a n d a
futuse	f u t u s e
sexual	s e k s u a l
activam	a k t i v a m
veștejeam	v e ʃ t e ʒ e̯ a m
satisfac	s a t i s f a k
durase	d u r a s e
simulat	s i m u l a t
Coreea	k o r e j a
anonimi	a n o n i mʲ
culturii	k u l t u r iː
șoptiserăți	ʃ o p t i s e r ə t sʲ
fuseseră	f u s e s e r ə
literă	l i t e r ə
dacă	d a k ə
anatemele	a n a t e m e l e
ejaculare	e ʒ a k u l a r e
determinase	d e t e r m i n a s e
întristaseși	ɨ n t r i s t a s e ʃʲ
iluminam	i l u m i n a m
mii	m iː
sufletelor	s u f l e t e l o r
distilase	d i s t i l a s e
balcoane	b a l k o̯ a n e
deliruri	d e l i r u rʲ
pulsez	p u l s e z
împărătească	ɨ m p ə r ə t e̯ a s k ə
scade	s k a d e
lingurilor	l i ŋ ɡ u r i l o r
regulase	r e ɡ u l a s e
tentă	t e n t ə
aducător	a d u k ə t o r
funcționasem	f u n k t͡s i o n a s e m
pregătit	p r e ɡ ə t i t
apere	a p e r e
condensai	k o n d e n s a j
lingi	l i n d ʒʲ
observat	o b s e r v a t
misterioase	m i s t e r i o̯ a s e
alunga	a l u ŋ ɡ a
folosiserăți	f o l o s i s e r ə t sʲ
masturbase	m a s t u r b a s e
separase	s e p a r a s e
procedat	p r o t͡ʃ e d a t
bigo	b i ɡ o
violam	v i o l a m
esență	e s e n t s ə
mâncam	m ɨ n k a m
dominam	d o m i n a m
inspire	i n s p i r e
seduse	s e d u s e
adormim	a d o r m i m
nălucea	n ə l u t ʃ e̯ a
curso	k u r s o
sfârșisem	s f ɨ r ʃ i s e m
bucă	b u k ə
deranjează	d e r a n ʒ e̯ a z ə
gravită	ɡ r a v i t ə
mulțumeai	m u l t͡s u m e̯ a j
Sorin	s o r i n
formezi	f o r m e zʲ
iacule	j a k u l e
congelez	k o n d͡ʒ e l e z
calitate	k a l i t a t e
susur	s u s u r
Ștefănescu	ʃ t e f ə n e s k u
fumaserăm	f u m a s e r ə m
iau	j a w
Scurtești	s k u r t ɛ ʃ tʲ
vrei	v r e j
urâm	u r ɨ m
atacat	a t a k a t
răpiră	r ə p i r ə
ignorez	i ɡ n o r e z
deducem	d e d u t͡ʃ e m
Bogdan	b o ɡ d a n
trepidez	t r e p i d e z
puloși	p u l o ʃʲ
sfârșește	s f ɨ r ʃ e ʃ t e
consider	k o n s i d e r
hiperbola	h i p e r b o l a
baie	b a j e
LSD	e l e s d e
controlam	k o n t r o l a m
cercam	t͡ʃ e r k a m
jonco	ʒ o ŋ k o
iubim	j u b i m
ghiuj	ɡ j u ʒ
oblige	o b l i d͡ʒ e
grăbitei	ɡ r ə b i t e j
deformase	d e f o r m a s e
deliram	d e l i r a m
deranjaseși	d e r a n ʒ a s e ʃʲ
fumegam	f u m e ɡ a m
sfânta	s f ɨ n t a
penisul	p e n i s u
eroticului	e r o t i k u l u j
iluzii	i l u z iʲ
revino	r e v i n o
contesa	k o n t e s a
delirase	d e l i r a s e
salute	s a l u t e
atac	a t a k
spovedisem	s p o v e d i s e m
greva	ɡ r e v a
baco	b a k o
perfectaserăți	p e r f e k t a s e r ə t͡sʲ
larme	l a r m e
iluzoriilor	i l u z o r iː l o r
fundai	f u n d a j
Beniamin	b e n j a m i n
întristarăm	ɨ n t r i s t a r ə m
tatuarăm	t a t u a r ə m
homosexualilor	h o m o s e k s u a l i l o r
clădiserăți	k l ə d i s e r ə t sʲ
animai	a n i m a j
pălincă	p ə l i ŋ k ə
furio	f u r i o
aspiram	a s p i r a m
neomenește	n e o m e n e ʃ t e
funcționai	f u n k t͡s i o n a j
necăjii	n e k ə ʒ iː
contribuție	k o n t r i b u t͡s i e
gazam	ɡ a z a m
provocase	p r o v o k a s e
abdicase	a b d i k a s e
plictisitei	p l i k t i s i t e j
boiai	b o j a j
dumneavoastră	d u m n e̯ a v o̯ a s t r ə
macedonean	m a t͡ʃ e d o n e̯ a n
înzestrau	ɨ n z e s t r a w
punctam	p u n k t a m
rugase	r u ɡ a s e
găsiserăm	ɡ ə s i s e r ə m
veștejirăm	v e ʃ t e ʒ i r ə m
palatalizase	p a l a t a l i z a s e
abandonam	a b a n d o n a m
întristat	ɨ n t r i s t a t
studia	s t u d i a
folosim	f o l o s i m
clădit	k l ə d i t
țării	t͡s ə r i
eczema	e k z e m a
ocupam	o k u p a m
tentam	t e n t a m
mulțumitei	m u l t͡s u m i t e j
porniseși	p o r n i s e ʃʲ
veștejitei	v e ʃ t e ʒ i t e j
băiețelului	b ə j e t͡s e l u l u j
controlarăți	k o n t r o l a r ə t sʲ
creste	k r e s t e
torturează	t o r t u r e̯ a z ə
fabricat	f a b r i k a t
deschis	d e s k i s
orientezi	o r i e n t e zʲ
clădiți	k l ə d i t͡sʲ
acceptat	a k t͡ʃ e p t a t
harpă	h a r p ə
juisează	ʒ u i s e̯ a z ə
Bănescu	b ɘ n e s k u
forjam	f o r ʒ a m
astruc	a s t r u k
delirai	d e l i r a j
intimidez	i n t i m i d e z
alarmam	a l a r m a m
sufocat	s u f o k a t
macabrelor	m a k a b r e l o r
anateme	a n a t e m e
cetățene	t͡ʃ e t ə t͡s e n e
capro	k a p r o
primiserăm	p r i m i s e r ə m
anulase	a n u l a s e
scald	s k a l d
dușmăniseși	d u ʃ m ə n i s e ʃʲ
democratic	d e m o k r a t i k
vede	v e d e
înfiere	ɨ n f i e r e
necăjești	n e k ə ʒ e ʃ tʲ
sodomit	s o d o m i t
coloram	k o l o r a m
tari	t a rʲ
cocota	k o k o t a
grăbit	ɡ r ə b i t
folosea	f o l o s e̯ a
polonez	p o l o n e z
familii	f a m i l i j
gemem	d͡ʒ e m e m
pasase	p a s a s e
protejați	p r o t e ʒ a t͡sʲ
sângerară	s ɨ n d͡ʒ e r a r ə
consoană	k o n s w a n ə
clarificam	k l a r i f i k a m
gravitezi	ɡ r a v i t e zʲ
masturbați	m a s t u r b a t͡sʲ
grăbea	ɡ r ə b e̯ a
fracturam	f r a k t u r a m
asurziseră	a s u r z i s e r ə
orientase	o r i e n t a s e
somasem	s o m a s e m
prietenos	p r i e t e n o s
pion	p i o n
fosto	f o s t o
pornitului	p o r n i t u l u j
creaseși	k r e a s e ʃʲ
protejarăți	p r o t e ʒ a r ə t͡sʲ
abandonați	a b a n d o n a t sʲ
susurare	s u s u r a r e
fute	f u t e
dea	d e̯ a
abdici	a b d i t͡ʃʲ
cruste	k r u s t e
acumulat	a k u m u l a t
masturbaseși	m a s t u r b a s e ʃʲ
onorai	o n o r a j
pasat	p a s a t
cusu	k u s u
confundam	k o n f u n d a m
torturaserăți	t o r t u r a s e r ə t sʲ
urase	u r a s e
nălucim	n ə l u t ʃ i m
mărturisit	m ə r t u r i s i t
spovediră	s p o v e d i r ə
ejaculând	e ʒ a k u l ɨ n d
memorizam	m e m o r i z a m
publicitate	p u b l i t͡ʃ i t a t e
șantajatului	ʃ a n t a ʒ a t u l u j
ubicuei	u b i k u e j
implicai	i m p l i k a j
creangă	k r e̯ a ŋ ɡ ə
genetic	d͡ʒ e n e t i k
pilotat	p i l o t a a t
Franța	f r a n t͡s a
întristează	ɨ n t r i s t e̯ a z ə
erogen	e r o d͡ʒ e n
socializa	s o t͡ʃ i a l i z a
observam	o b s e r v a m
lucru	l u k r u
pese	p e s e
Lucian	l u t͡ʃ j a n
stimulară	s t i m u l a r ə
macabru	m a k a b r u
introduci	i n t r o d u t͡ʃʲ
făceau	f ə t͡ʃ e̯ a w
plictisita	p l i k t i s i t a
delimitai	d e l i m i t a j
șopteau	ʃ o p t j a w
protejam	p r o t e ʒ a m
cercai	t͡ʃ e r k a j
iubeai	j u b e̯ a j
ejaculă	e ʒ a k u l ə
probase	p r o b a s e
sunete	s u n e t e
agitai	a d͡ʒ i t a j
analizau	a n a l i z a w
gândise	ɡ ɨ n d i s e
veștejiseră	v e ʃ t e ʒ i s e r ə
pilotau	p i l o t a w
ipocrite	i p o k r i t e
deranjai	d e r a n ʒ a j
mulțumiți	m u l t͡s u m i t͡sʲ
bărbatul	b ə r b a t u
paradox	p a r a d o k s
întristase	ɨ n t r i s t a s e
tentând	t e n t ɨ n d
reduci	r e d u t͡ʃʲ
ubicuilor	u b i k u i l o r
pilotarăm	p i l o t a r ə m
damnai	d a m n a j
organizație	o r ɡ a n i z a t͡s i e
ancoram	a n k o r a m
agitam	a d͡ʒ i t a m
sacrificai	s a k r i f i k a j
funcționat	f u n k t͡s i o n a t
ajutor	a ʒ u t o r
inventase	i n v e n t a s e
vom	v o m
fuseserăți	f u s e s e r ə t͡sʲ
îmbunătățiserăți	ɨ m b u n ə t ə t s i s e r ə t sʲ
grenade	ɡ r e n a d e
baca	b a k a
sfârșitului	s f ɨ r ʃ i t u l u j
asurzească	a s u r z j a s k ə
agent	a d ʒ e n t
considerai	k o n s i d e r a j
creăm	k r e ə m
Păltineni	p ɘ l t i n ɛ nʲ
extern	e k s t e r n
formulo	f o r m u l o
castrez	k a s t r e z
frecai	f r e k a j
fibra	f i b r a
numirăm	n u m i r ə m
porneai	p o r n e̯ a j
intensificat	i n t e n s i f i k a t
îmbunătățeați	ɨ m b u n ə t ə t s e̯ a t sʲ
sângerăm	s ɨ n d͡ʒ e r ə m
lovim	l o v i m
româneștile	r o m ɨ n e ʃ t i l e
observase	o b s e r v a s e
husa	h u s a
avansat	a v a n s a t
mutai	m u t a j
mulțumeau	m u l t͡s u m e̯ a w
insistam	i n s i s t a m
baltic	b a l t i k
crearăm	k r e a r ə m
sacra	s a k r a
bombai	b o m b a j
ejacularăm	e ʒ a k u l a r ə m
îs	ɨ s
completat	k o m p l e t a t
luxez	l u k s e z
compuse	k o m p u s e
plictisiți	p l i k t i s i t͡sʲ
reducem	r e d u t͡ʃ e m
stimulaserăm	s t i m u l a s e r ə m
spermelor	s p e r m e l o r
cazi	k a zʲ
simpli	s i m p l i
vieți	v j e t sʲ
rozmarin	r o z m a r i n
stinse	s t i n s e
prezervativului	p r e z e r v a t i v u l u j
bucule	b u k u l e
sodomizau	s o d o m i z a w
intensificam	i n t e n s i f i k a m
sfârșea	s f ɨ r ʃ e̯ a
cuvântul	k u v ɨ n t u
necăjise	n e k ə ʒ i s e
funcționase	f u n k t͡s i o n a s e
capitulai	k a p i t u l a j
evanghelie	e v a n ɡ e l i e
condamnai	k o n d a m n a j
futu	f u t u
tați	t a t͡sʲ
abolii	a b o l i j
eliminai	e l i m i n a j
excavaserăți	e k s k a v a s e r ə t sʲ
sedu	s e d u
necăjeau	n e k ə ʒ e̯ a w
imprimam	i m p r i m a m
sunet	s u n e t
călătorirăm	k ə l ə t o r i r ə m
familie	f a m i l i e
stimulasem	s t i m u l a s e m
sloveni	s l o v e n i
excit	e k s t͡ʃ i t
sfârșeai	s f ɨ r ʃ e̯ a j
busolă	b u s o l ə
hibernam	h i b e r n a m
cititelor	t͡ʃ i t i t e l o r
cerii	t͡ʃ e r i j
comandat	k o m a n d a t
torturase	t o r t u r a s e
latină	l a t i n ə
exemplele	e ɡ z e m p l e l e
afinitate	a f i n i t a t e
întărită	ɨ n t ə r i t ə
citii	t ʃ i t iː
spovedii	s p o v e d iː
vutcă	v u t k ə
pornitelor	p o r n i t e l o r
hanuri	h a n u rʲ
industrializase	i n d u s t r i a l i z a s e
anatema	a n a t e m a
controlau	k o n t r o l a w
coline	k o l i n e
analizarăm	a n a l i z a r ə m
pregătii	p r e ɡ ə t iː
sodomizaseră	s o d o m i z a s e r ə
pedeapsă	p e d e̯ a p s ə
masturbezi	m a s t u r b e zʲ
macabră	m a k a b r ə
alterase	a l t e r a s e
mărturisitul	m ə r t u r i s i t u
humo	h u m o
vampiri	v a m p i rʲ
excavaseși	e k s k a v a s e ʃʲ
lipsiți	l i p s i t͡sʲ
apocaliptic	a p o k a l i p t i k
dedam	d e d a m
privatizase	p r i v a t i z a s e
finalizam	f i n a l i z a m
speli	s p e lʲ
fantome	f a n t o m e
întristez	ɨ n t r i s t e z
fiare	f j a r e
cadă	k a d ə
grăbiserăți	ɡ r ə b i s e r ə t sʲ
gene	d͡ʒ e n e
compare	k o m p a r e
ejaculaserăm	e ʒ a k u l a s e r ə m
disputa	d i s p u t a
suferi	s u f e r i
lavro	l a v r o
asurziți	a s u r z i t͡sʲ
lavrei	l a v r e j
fistule	f i s t u l e
cloroformizase	k l o r o f o r m i z a s e
fumă	f u m ə
întâiul	ɨ n t ɨ j u l
ostaș	o s t a ʃ
Slovenia	s l o v e n i a
adaptabilitate	a d a p t a b i l i t a t e
ere	e r e
necăjim	n e k ə ʒ i m
frumosului	f r u m o s u l u j
tatuăm	t a t u ə m
opriserăm	o p r i s e r ə m
primitului	p r i m i t u l u j
sfârșeați	s f ɨ r ʃ e̯ a t͡sʲ
pilotară	p i l o t a r ə
întărirăți	ɨ n t ə r i r ə t sʲ
stric	s t r i k
detonai	d e t o n a j
neglijez	n e ɡ l i ʒ e z
aerai	a e r a j
virgulă	v i r ɡ u l ə
facilitate	f a t ʃ i l i t a t e
investii	i n v e s t i j
șoptiră	ʃ o p t i r ə
analizează	a n a l i z e̯ a z ə
decade	d e k a d e
futute	f u t u t e
Cărtărescu	k ə r t ə r e s k u
iudaic	j u d a i k
murmurat	m u r m u r a t
biomaso	b i o m a s o
hibe	h i b e
funcționaseși	f u n k t͡s i o n a s e ʃʲ
iubești	j u b e ʃ tʲ
dușmăniră	d u ʃ m ə n i r ə
iluzorii	i l u z o r iː
regulez	r e ɡ u l e z
înzestrași	ɨ n z e s t r a ʃʲ
îmbunătățeam	ɨ m b u n ə t ə t s e̯ a m
estimam	e s t i m a m
bage	b a d͡ʒ e
bengalez	b e ŋ ɡ a l e z
vargă	v a r ɡ ə
injectai	i n ʒ e k t a j
forjai	f o r ʒ a j
donez	d o n e z
dușmăniserăm	d u ʃ m ə n i s e r ə m
găsiților	ɡ ə s i t͡s i l o r
oprea	o p r e̯ a
deranjau	d e r a n ʒ a w
întristaserăm	ɨ n t r i s t a s e r ə m
Finlanda	f i n l a n d a
sodomiza	s o d o m i z a
excavaserăm	e k s k a v a s e r ə m
computez	k o m p u t e z
acumulase	a k u m u l a s e
uzez	u z e z
șoptită	ʃ o p t i t ə
mediat	m e d i a t
sfârși	s f ɨ r ʃ i
poloneză	p o l o n e z ə
perineele	p e r i n eː l e
perineu	p e r i n e w
suscitase	s u s t͡ʃ i t a s e
copleșitorului	k o p l e ʃ i t o r u l u j
educase	e d u k a s e
mărturisește	m ə r t u r i s e ʃ t e
ceasornic	t͡ʃ e̯ a s o r n i k
consolidat	k o n s o l i d a t
fundamentală	f u n d a m e n t a l ə
simplificai	s i m p l i f i k a j
torturaseși	t o r t u r a s e ʃʲ
tratase	t r a t a s e
gura	ɡ u r a
ginta	ɡ i n t a
catarg	k a t a r ɡ
șantajaserăți	ʃ a n t a ʒ a s e r ə t͡sʲ
adoptat	a d o p t a t
haite	h a j t e
accelerai	a k t͡ʃ e l e r a j
boul	b o u l
trăi	t r ə i
spor	s p o r
orienta	o r i e n t a
numește	n u m e ʃ t e
abundam	a b u n d a m
cernui	t͡ʃ e r n u j
gânditului	ɡ ɨ n d i t u l u j
primesc	p r i m e s k
congelam	k o n d͡ʒ e l a m
părintește	p ə r i n t e ʃ t e
slovena	s l o v e n a
Șabat	ʃ a b a t
adoptase	a d o p t a s e
buh	b u h
deranjezi	d e r a n ʒ e zʲ
numită	n u m i t ə
vorbisem	v o r b i s e m
crapule	k r a p u l e
paraziți	p a r a z i t͡sʲ
foci	f o t͡ʃʲ
primitele	p r i m i t e l e
ejaculează	e ʒ a k u l e̯ a z ə
frumoși	f r u m o ʃʲ
tipe	t i p e
destupe	d e s t u p e
crispase	k r i s p a s e
ușile	u ʃ i l e
lebădă	l e b ə d ə
anule	a n u l e
urâți	u r ɨ t͡sʲ
perfectași	p e r f e k t a ʃʲ
veștejesc	v e ʃ t e ʒ e s k
editai	e d i t a j
numii	n u m iː
distraseși	d i s t r a s e ʃʲ
clădiserăm	k l ə d i s e r ə m
lucrurilor	l u k r u r i l o r
istoria	i s t o r i a
paupertate	p a u p e r t a t e
pungă	p u n ɡ ə
urez	u r e z
analizam	a n a l i z a m
incriminase	i n k r i m i n a s e
sângerasem	s ɨ n d͡ʒ e r a s e m
răsfoi	r ə s f o i
sodomizatele	s o d o m i z a t e l e
coagulam	k o a ɡ u l a m
înzestrai	ɨ n z e s t r a j
iluminase	i l u m i n a s e
tentantă	t e n t a n t ə
sfârșitelor	s f ɨ r ʃ i t e l o r
șansă	ʃ a n s ə
ceramica	t͡ʃ e r a m i k a
mascul	m a s k u l
ramură	r a m u r ə
gugiuman	ɡ u d͡ʒʲ u m a n
deranjară	d e r a n ʒ a r ə
larma	l a r m a
gemu	d͡ʒ e m u
ultime	u l t i m e
apocaliptici	a p o k a l i p t i t͡ʃʲ
perete	p e r e t e
morcov	m o r k o v
replicam	r e p l i k a m
temelie	t e m e l i e
glicina	ɡ l i t͡ʃ i n a
caracter	k a r a k t e r
molie	m o l i e
întărește	ɨ n t ə r e ʃ t e
plictisiserăți	p l i k t i s i s e r ə t͡sʲ
declare	d e k l a r e
numiseră	n u m i s e r ə
fiică	f i j k ə
deliberai	d e l i b e r a j
cenzurează	t͡ʃ e n z u r e̯ a z ə
Ionuț	j o n u t͡s
sarcastic	s a r k a s t i k
sufletele	s u f l e t e l e
afix	a f i k s
Buzărnescu	b u z ə r n e s k u
inundam	i n u n d a m
imprimai	i m p r i m a j
frecaseră	f r e k a s e r ə
confunde	k o n f u n d e
boș	b o ʃ
pape	p a p e
prietenii	p r i e t e n iː
adu	a d u
întristam	ɨ n t r i s t a m
compensam	k o m p e n s a m
întâlniserăți	ɨ n t ɨ l n i s e r ə t sʲ
tatuez	t a t u e z
penisuri	p e n i s u rʲ
adoptai	a d o p t a j
crucificat	k r u t͡ʃ i f i k a t
artificializai	a r t i f i t͡ʃ i a l i z a j
zăpușiseși	z ə p u ʃ i s e ʃʲ
pleci	p l e t͡ʃʲ
năluciții	n ə l u t͡ʃ i t͡s iː
bulgărește	b u l ɡ ə r e ʃ t e
fețelor	f e t s e l o r
călătorite	k ə l ə t o r i t e
beat	b e̯ a t
foloseai	f o l o s e̯ a j
pulile	p u l i l e
promise	p r o m i s e
lacrămă	l a k r ə m ə
generație	d͡ʒ e n e r a t͡s i e
sodomizatelor	s o d o m i z a t e l o r
hidrogenat	h i d r o d͡ʒ e n a t
activez	a k t i v e z
avansă	a v a n s ə
catalane	k a t a l a n e
foso	f o s o
decid	d e t͡ʃ i d
sper	s p e r
abandonaserăți	a b a n d o n a s e r ə t sʲ
sfârșiți	s f ɨ r ʃ i t͡sʲ
violez	v i o l e z
seducem	s e d u t͡ʃ e m
muri	m u r i
comutam	k o m u t a m
răpeai	r ə p e̯ a j
deranjase	d e r a n ʒ a s e
oprească	o p r e̯ a s k ə
asurzitelor	a s u r z i t e l o r
florista	f l o r i s t a
călătoriți	k ə l ə t o r i t͡sʲ
pliai	p l i a j
deranjat	d e r a n ʒ a t
fabricase	f a b r i k a s e
moartă	m o̯ a r t ə
facilități	f a t ʃ i l i t ə t sʲ
stupidități	s t u p i d i t ə t͡sʲ
fumăm	f u m ə m
delirul	d e l i r u
sfârșiră	s f ɨ r ʃ i r ə
accelereze	a k t͡ʃ e l e r e z e
creară	k r e a r ə
coada	k o̯ a d a
necăjiră	n e k ə ʒ i r ə
asurzitei	a s u r z i t e j
supsesem	s u p s e s e m
lavine	l a v i n e
boașelor	b o̯ a ʃ e l o ɾ
bifurcam	b i f u r k a m
cace	k a t͡ʃ e
grota	ɡ r o t a
trimite	t r i m i t e
argumentat	a r ɡ u m e n t a t
oficial	o f i t ʃ i a l
deduc	d e d u k
cerni	t͡ʃ e r nʲ
ubicua	u b i k u a
glonte	ɡ l o n t e
orientez	o r i e n t e z
picase	p i k a s e
iubesc	j u b e s k
primiții	p r i m i t͡s iː
articulat	a r t i k u l a t
excavasem	e k s k a v a s e m
salte	s a l t e
dicționarul	d i k t͡s i o n a r u
amarilisului	a m a r i l i s u l u j
cerere	t͡ʃ e r e r e
castrai	k a s t r a j
răpitului	r ə p i t u l u j
Năstăsescu	n ə s t ə s e s k u
apocaliptica	a p o k a l i p t i k a
atrocitate	a t r o t͡ʃ i t a t e
ejaculași	e ʒ a k u l a ʃʲ
folosiră	f o l o s i r ə
șantajistă	ʃ a n t a ʒ i s t ə
ador	a d o r
sacrificat	s a k r i f i k a t
joci	ʒ o t͡ʃʲ
enigma	e n i ɡ m a
urșinic	u r ʃ i n i k
găsitelor	ɡ ə s i t e l o r
numite	n u m i t e
negam	n e ɡ a m
comandase	k o m a n d a s e
căldare	k ə l d a r e
misterioasele	m i s t e r i o̯ a s e l e
clăditelor	k l ə d i t e l o r
protejez	p r o t e ʒ e z
mâncăm	m ɨ n k ə m
culminam	k u l m i n a m
achiu	a k i w
opriseși	o p r i s e ʃʲ
văi	v ə j
abstract	a p s t r a k t
fuge	f u d͡ʒ e
șantajații	ʃ a n t a ʒ a t͡s iː
pneumonoultramicroscopicsilicovolcaniconiozelor	p n e u m o n o u l t r a m i k r o s k o p i k s i l i k o v o l k a n i k o n i o z e l o r
determinat	d e t e r m i n a t
analizez	a n a l i z e z
faceți	f a t͡ʃ e t͡sʲ
Tătărușanu	t ə t ə r u ʃ a n u
expirai	e k s p i r a j
grece	ɡ r e t͡ʃ e
eroticii	e r o t i t͡ʃ iː
accelerară	a k t͡ʃ e l e r a r ə
astup	a s t u p
rugam	r u ɡ a m
abandonez	a b a n d o n e z
lavando	l a v a n d o
compensase	k o m p e n s a s e
masturbator	m a s t u r b a t o r
oprirăm	o p r i r ə m
Câmpina	k ɨ̯ m p i n a
tatuă	t a t u ə
călătoresc	k ə l ə t o r e s k
obligase	o b l i ɡ a s e
lacuno	l a k u n o
futurăm	f u t u r ə m
runc	r u ŋ k
cercuri	t͡ʃ e r k u rʲ
primeam	p r i m e̯ a m
bată	b a t ə
frecaserăm	f r e k a s e r ə m
detonez	d e t o n e z
furnic	f u r n i k
zăpușind	z ə p u ʃ i n d
narcotizase	n a r k o t i z a s e
personaje	p e r s o n a ʒ e
hibernase	h i b e r n a s e
grăbesc	ɡ r ə b e s k
preparam	p r e p a r a m
revigoram	r e v i ɡ o r a m
domini	d o m i nʲ
folosirăm	f o l o s i r ə m
masturbând	m a s t u r b ɨ n d
Croația	k r o a t͡s i a
futeai	f u t e̯ a j
clădesc	k l ə d e s k
formau	f o r m a w
grăbind	ɡ r ə b i n d
senzualitate	s e n z u a l i t a t e
jumela	ʒ u m e l a
sodomizasem	s o d o m i z a s e m
clar	k l a r
abandonase	a b a n d o n a s e
introduce	i n t r o d u t͡ʃ e
fuseseși	f u s e s e ʃʲ
mulțumii	m u l t͡s u m iː
brunei	b r u n e j
gestionase	d͡ʒ e s t i o n a s e
scrii	s k r i j
mănânce	m ə n ɨ n t͡ʃ e
ubicui	u b i k u j
grăbiții	ɡ r ə b i t͡s iː
dușmăniși	d u ʃ m ə n i ʃʲ
valsez	v a l s e z
bile	b i l e
lea	l e̯ a
abandonară	a b a n d o n a r ə
sufletești	s u f l e t e ʃ tʲ
știe	ʃ t i e
transpiram	t r a n s p i r a m
murmuri	m u r m u rʲ
formai	f o r m a j
cina	t͡ʃ i n a
salutat	s a l u t a t
susuri	s u s u rʲ
banca	b a n k a
împărăteasă	ɨ m p ə r ə t e̯ a s ə
veștejiserăți	v e ʃ t e ʒ i s e r ə t͡sʲ
gânduri	ɡ ɨ n d u rʲ
invalidam	i n v a l i d a m
suplicase	s u p l i k a s e
figuri	f i ɡ u rʲ
pornii	p o r n iː
marcam	m a r k a m
conspirase	k o n s p i r a s e
certe	t͡ʃ e r t e
tace	t a t͡ʃ e
sângerând	s ɨ n d͡ʒ e r ɨ n d
găsita	ɡ ə s i t a
frățească	f r ə t͡s e̯ a s k ə
suedezi	s u e d e zʲ
induci	i n d u t͡ʃʲ
copleșitor	k o p l e ʃ i t o r
aventurase	a v e n t u r a s e
sângerase	s ɨ n d͡ʒ e r a s e
frontiere	f r o n t i e r e
formez	f o r m e z
contat	k o n t a t
șantajăm	ʃ a n t a ʒ ə m
frumoasa	f r u m o̯ a s a
răpim	r ə p i m
foise	f o i s e
termen	t e r m e n
gemi	d͡ʒ e mʲ
capacitate	k a p a t ʃ i t a t e
sodomizând	s o d o m i z ɨ n d
numească	n u m e̯ a s k ə
pizdă	p i z d ə
orgastic	o r ɡ a s t i k
turbai	t u r b a j
asurzită	a s u r z i t ə
saturi	s a t u rʲ
ejaculez	e ʒ a k u l e z
depene	d e p e n e
sune	s u n e
înzestrez	ɨ n z e s t r e z
brodat	b r o d a t
gândiților	ɡ ɨ n d i t͡s i l o r
declarai	d e k l a r a j
distrase	d i s t r a s e
plictisea	p l i k t i s e̯ a
beregată	b e r e ɡ a t ə
delimitaseși	d e l i m i t a s e ʃʲ
greve	ɡ r e v e
dauna	d a u n a
ling	l i ŋ ɡ
batem	b a t e m
subjugat	s u b ʒ u ɡ a t
fuse	f u s e
lipsirăți	l i p s i r ə t sʲ
îți	ɨ t sʲ
necăjind	n e k ə ʒ i n d
saturai	s a t u r a j
șantajistei	ʃ a n t a ʒ i s t e j
torturai	t o r t u r a j
explica	e k s p l i k a
răpeați	r ə p e̯ a t͡sʲ
sacră	s a k r ə
năluciseși	n ə l u t ʃ i s e ʃʲ
opritele	o p r i t e l e
bifurce	b i f u r t͡ʃ e
declarat	d e k l a r a t
prea	p r e̯ a
scrotalii	s k r o t a l iː
efecte	e f e k t e
folositor	f o l o s i t o r
coreean	k o r e e̯ a n
pisam	p i s a m
îmbunătățitul	ɨ m b u n ə t ə t͡s i t u
conjugat	k o n ʒ u ɡ a t
soli	s o lʲ
înjurături	ɨ n ʒ u r ə t u rʲ
tatuând	t a t u ɨ n d
valsai	v a l s a j
miri	m i rʲ
obrăznicie	o b r ə z n i t ʃ i e
extenuase	e k s t e n u a s e
cepuri	t͡ʃ e p u rʲ
producem	p r o d u t͡ʃ e m
acopăr	a k o p ə r
expune	e k s p u n e
asurziserăm	a s u r z i s e r ə m
șopteai	ʃ o p t j a j
ataraxic	a t a r a k s i k
funcționezi	f u n k t͡s i o n e zʲ
înghețată	ɨ ŋ ɡ e t s a t ə
condensat	k o n d e n s a t
gaze	ɡ a z e
combine	k o m b i n e
mânecuță	m ɨ n e k u t͡s ə
citologa	t͡ʃ i t o l o ɡ a
ruta	r u t a
creau	k r e a w
mărturisitului	m ə r t u r i s i t u l u j
imai	i m a j
excavași	e k s k a v a ʃʲ
grăbeați	ɡ r ə b e̯ a t sʲ
lingurii	l i ŋ ɡ u r iː
ales	a l e s
bigi	b i d͡ʒʲ
ignorat	i ɡ n o r a t
mirandeză	m i r a n d e z ə
macabrele	m a k a b r e l e
fulgere	f u l d͡ʒ e r e
crease	k r e a s e
intervino	i n t e r v i n o
zbieram	z b j e r a m
aici	a i t͡ʃʲ
Călinescu	k ə l i n e s k u
dejunat	d e ʒ u n a t
testat	t e s t a t
găsii	ɡ ə s iː
caso	k a s o
imaturitate	i m a t u r i t a t e
mamaie	m a m a j e
gravitate	ɡ r a v i t a t e
merit	m e r i t
nălucit	n ə l u t ʃ i t
insult	i n s u l t
repete	r e p e t e
lacune	l a k u n e
virilitate	v i r i l i t a t e
șantajară	ʃ a n t a ʒ a r ə
Dunărea	d u n ə r e̯ a
citim	t ʃ i t i m
compari	k o m p a rʲ
proiect	p r o j ɛ k t
secai	s e k a j
macabra	m a k a b r a
modificam	m o d i f i k a m
îmbunătățesc	ɨ m b u n ə t ə t s e s k
funcționam	f u n k t͡s i o n a m
mingi	m i n d͡ʒʲ
dermatologa	d e r m a t o l o ɡ a
amarilișii	a m a r i l i ʃ iː
apare	a p a r e
clădite	k l ə d i t e
gânditei	ɡ ɨ n d i t e j
întristăm	ɨ n t r i s t ə m
barai	b a r a j
asurziseși	a s u r z i s e ʃʲ
hieno	h i e n o
ignoram	i ɡ n o r a m
repari	r e p a rʲ
necăjiserăți	n e k ə ʒ i s e r ə t͡sʲ
ultimi	u l t i mʲ
cântăreței	k ɨ n t ə r e t͡s e j
bombat	b o m b a t
admirase	a d m i r a s e
insulte	i n s u l t e
lipsea	l i p s e̯ a
ocupat	o k u p a t
șoptit	ʃ o p t i t
protejezi	p r o t e ʒ e zʲ
perineal	p e r i n e a l
sângeră	s ɨ n d͡ʒ e r ə
șoptitele	ʃ o p t i t e l e
masturbaseră	m a s t u r b a s e r ə
declinam	d e k l i n a m
documentase	d o k u m e n t a s e
arau	a r a w
curase	k u r a s e
legea	l e d͡ʒ e̯ a
exprimat	e k s p r i m a t
ari	a rʲ
culturi	k u l t u rʲ
murmurai	m u r m u r a j
sodomizaserăm	s o d o m i z a s e r ə m
prietenele	p r i e t e n e l e
Dănuț	d ə n u t͡s
memorizase	m e m o r i z a s e
reginei	r e d͡ʒ i n e j
salvat	s a l v a t
făceați	f ə t͡ʃ e̯ a t͡sʲ
visase	v i s a s e
palme	p a l m e
rânduri	r ɨ n d u rʲ
sfârșii	s f ɨ r ʃ iː
capsase	k a p s a s e
Crăciun	k r ə t͡ʃ u n
răpind	r ə p i n d
zăpușitului	z ə p u ʃ i t u l u j
elizeelor	e l i z eː l o r
bună	b u n ə
necăjirăți	n e k ə ʒ i r ə t͡sʲ
zăpușite	z ə p u ʃ i t e
Siberia	s i b e r i a
urinarăți	u r i n a r ə t sʲ
Mujdei	m u ʒ d e j
lăbar	l ə b a r
avid	a v i d
mărturisitei	m ə r t u r i s i t e j
somarăți	s o m a r ə t sʲ
hibernai	h i b e r n a j
aprob	a p r o b
stimula	s t i m u l a
coagulez	k o a ɡ u l e z
erogene	e r o d͡ʒ e n e
implicam	i m p l i k a m
multiplicai	m u l t i p l i k a j
reformase	r e f o r m a s e
promițând	p r o m i t s ɨ n d
excavam	e k s k a v a m
remușcare	r e m u ʃ k a r e
undat	u n d a t
călătorească	k ə l ə t o r j a s k ə
dezavantaja	d e z a v a n t a ʒ a
figura	f i ɡ u r a
imprimat	i m p r i m a t
fie	f i e
narcotici	n a ɾ k o t i t͡ʃʲ
dușmănit	d u ʃ m ə n i t
cravata	k r a v a t a
clădiții	k l ə d i t͡s iː
fută	f u t ə
Canada	k a n a d a
distrând	d i s t r ɨ n d
accelerăm	a k t͡ʃ e l e r ə m
contese	k o n t e s e
larva	l a r v a
palma	p a l m a
zăpușirăți	z ə p u ʃ i r ə t sʲ
tată	t a t ə
vadă	v a d ə
gemui	d͡ʒ e m u j
anini	a n i nʲ
porneam	p o r n e̯ a m
slovenului	s l o v e n u l u j
zăpușiții	z ə p u ʃ i t͡s iː
frate	f r a t e
trebuie	t r e b u j e
întâlnisem	ɨ n t ɨ l n i s e m
lipsim	l i p s i m
imat	i m a t
mâni	m ɨ nʲ
plictisește	p l i k t i s e ʃ t e
nălucitei	n ə l u t͡ʃ i t e j
sufăr	s u f ə r
zăpușească	z ə p u ʃ j a s k ə
tastatură	t a s t a t u r ə
fraternitate	f r a t e r n i t a t e
înzestrați	ɨ n z e s t r a t͡sʲ
pești	p e ʃ tʲ
prefere	p r e f e r e
rozi	r o zʲ
hidrogenai	h i d r o d͡ʒ e n a j
întâlnirăm	ɨ n t ɨ l n i r ə m
futui	f u t u j
cuvânt	k u v ɨ n t
descrie	d e s k r i j e
trip	t r i p
marchez	m a r k e z
accelerezi	a k t͡ʃ e l e r e zʲ
spoveditelor	s p o v e d i t e l o r
redu	r e d u
pornografilor	p o r n o ɡ r a f i l o r
langusta	l a ŋ ɡ u s t a
animam	a n i m a m
primul	p r i m u l
îmbunătățiseră	ɨ m b u n ə t ə t s i s e r ə
românești	r o m ɨ n e ʃ tʲ
Reghin	r e ɡ i n
băiețașilor	b ə j e t s a ʃ i l o r
funicular	f u n i k u l aʳ
motiv	m o t i v
contai	k o n t a j
atrocității	a t r o t ʃ i t ə t s iː
băiat	b ə j a t
înzestraseră	ɨ n z e s t r a s e r ə
Ungaria	u n ɡ a r i a
finalizase	f i n a l i z a s e
prefer	p r e f e r
beata	b e̯ a t a
constai	k o n s t a j
republicase	r e p u b l i k a s e
îmbunătățească	ɨ m b u n ə t ə t s e̯ a s k ə
fracturez	f r a k t u r e z
șantajai	ʃ a n t a ʒ a j
iluzoria	i l u z o r i a
felino	f e l i n o
seduce	s e d u t ʃ e
abandonau	a b a n d o n a w
cheie	k e j e
spovediserăți	s p o v e d i s e r ə t͡sʲ
omniprezentului	o m n i p r e z e n t u l u j
comande	k o m a n d e
foram	f o r a m
insultat	i n s u l t a t
imaginat	i m a d͡ʒ i n a t
asurzeam	a s u r z j a m
primite	p r i m i t e
stăpân	s t ə p ɨ n
grăbita	ɡ r ə b i t a
amorțit	a m o r t s i t
indignase	i n d i ɡ n a s e
urăști	u r ə ʃ tʲ
crucifica	k r u t͡ʃ i f i k a
lucrului	l u k r u l u j
protestam	p r o t e s t a m
sistam	s i s t a m
gumei	ɡ u m e j
turcească	t u r t͡ʃ e̯ a s k ə
dormii	d o r m i j
excaveze	e k s k a v e z e
tatuau	t a t u a w
orientă	o r i e n t ə
zăpușitele	z ə p u ʃ i t e l e
plictisirăți	p l i k t i s i r ə t͡sʲ
educi	e d u t͡ʃʲ
furăți	f u r ə t͡sʲ
basco	b a s k o
masturbă	m a s t u r b ə
ii	i j i
cenzurarăți	t͡ʃ e n z u r a r ə t sʲ
repar	r e p a r
răpea	r ə p e̯ a
mulțumeați	m u l t͡s u m e̯ a t͡sʲ
Finlandei	f i n l a n d e j
reintroduci	r e i n t r o d u t͡ʃʲ
vei	v e j
sugeai	s u d͡ʒ e̯ a j
instant	i n s t a n t
delimitez	d e l i m i t e z
torturat	t o r t u r a t
Radu	r a d u
cartilaj	k a r t i l a ʒ
huso	h u s o
fluture	f l u t u r e
limitaseși	l i m i t a s e ʃʲ
supseși	s u p s e ʃʲ
lup	l u p
funcționeze	f u n k t͡s i o n e z e
pregătiseră	p r e ɡ ə t i s e r ə
udam	u d a m
buzunar	b u z u n a r
omniprezentei	o m n i p r e z e n t e j
abandonează	a b a n d o n e̯ a z ə
spectre	s p e k t r e
sfârșim	s f ɨ r ʃ i m
răpisem	r ə p i s e m
cenzuram	t͡ʃ e n z u r a m
absorb	a b s o r b
conteso	k o n t e s o
vedeți	v e d e t͡sʲ
legi	l e d͡ʒʲ
absolutizase	a b s o l u t i z a s e
lupi	l u pʲ
numiților	n u m i t͡s i l o r
acceleră	a k t͡ʃ e l e r ə
sfârșirăm	s f ɨ r ʃ i r ə m
homosexualii	h o m o s e k s u a l iʲ
scrotale	s k r o t a l e
informai	i n f o r m a j
suferință	s u f e r i n t s ə
urdă	u r d ə
fulgerai	f u l d͡ʒ e r a j
nominali	n o m i n a lʲ
feminitate	f e m i n i t a t e
tineri	t i n e rʲ
orbit	o r b i t
căcat	k ə k a t
interveni	i n t e r v e n i
fosilo	f o s i l o
foarte	f o̯ a r t e
separe	s e p a r e
pregătitului	p r e ɡ ə t i t u l u j
urinasem	u r i n a s e m
chior	k j o r
pornirăți	p o r n i r ə t͡sʲ
sfârșit	s f ɨ r ʃ i t
lavo	l a v o
saturez	s a t u r e z
reduce	r e̞ d̪ u t ʃ e̞
gravitând	ɡ r a v i t ɨ n d
grăbiseră	ɡ r ə b i s e r ə
călătoreai	k ə l ə t o r j a j
traduci	t r a d u t͡ʃʲ
plictisitului	p l i k t i s i t u l u j
sodomizarăm	s o d o m i z a r ə m
protejă	p r o t e ʒ ə
pilotasem	p i l o t a s e m
vînt	v ɨ n t
Transilvania	t r a n s i l v a n i a
mulțumesc	m u l t͡s u m e s k
sângeros	s ɨ n d͡ʒ e r o s
somai	s o m a j
misterioși	m i s t e r i o ʃʲ
mărturisind	m ə r t u r i s i n d
pregătitele	p r e ɡ ə t i t e l e
poziție	p o z i t͡s i e
fota	f o t a
rece	r e t͡ʃ e
eroticele	e r o t i t͡ʃ e l e
deliră	d e l i r ə
gravitaserăm	ɡ r a v i t a s e r ə m
dormitai	d o r m i t a j
năluceai	n ə l u t ʃ e̯ a j
muista	m u i s t a
lipsise	l i p s i s e
merite	m e r i t e
mănuși	m ə n u ʃʲ
urinaseși	u r i n a s e ʃʲ
vrem	v r e m
clădești	k l ə d e ʃ tʲ
copleșitoarelor	k o p l e ʃ i t o̯ a r e l o r
revine	r e v i n e
terminaserăm	t e r m i n a s e r ə m
crezut	c r e z u t
anatemă	a n a t e m ə
boule	b o u l e
enigmatici	e n i ɡ m a t i t͡ʃʲ
torturaserăm	t o r t u r a s e r ə m
sistat	s i s t a t
donat	d o n a t
primea	p r i m e̯ a
lactama	l a k t a m a
caprino	k a p r i n o
veștejisem	v e ʃ t e ʒ i s e m
admiri	a d m i rʲ
analizezi	a n a l i z e zʲ
fumarăți	f u m a r ə t sʲ
urinarăm	u r i n a r ə m
lipsiră	l i p s i r ə
consideram	k o n s i d e r a m
borta	b o r t a
aștepta	a ʃ t e p t a
declari	d e k l a rʲ
sorilor	s o r i l o r
ubicue	u b i k u e
controlează	k o n t r o l e̯ a z ə
spovedită	s p o v e d i t ə
futuseră	f u t u s e r ə
cititului	t͡ʃ i t i t u l u j
hidrogenase	h i d r o d͡ʒ e n a s e
asurzisem	a s u r z i s e m
protejarăm	p r o t e ʒ a r ə m
primita	p r i m i t a
necăjește	n e k ə ʒ e ʃ t e
propun	p r o p u n
dezavantaj	d e z a v a n t a ʒ
acceptam	a k t͡ʃ e p t a m
spovedite	s p o v e d i t e
declinai	d e k l i n a j
gazelo	ɡ a z e l o
belim	b e l i m
verb	v e r b
pornograficelor	p o r n o ɡ r a f i t͡ʃ e l o r
acestui	a t͡ʃ e s t u j
activitate	a k t i v i t a t e
zona	z o n a
salvam	s a l v a m
pupe	p u p e
freacă	f r e̯ a k ə
produc	p r o d u k
găsiții	ɡ ə s i t͡s iː
sapi	s a pʲ
hai	h a j
furtună	f u r t u n ə
anonima	a n o n i m a
hamace	h a m a t͡ʃ e
șoptiseși	ʃ o p t i s e ʃʲ
fose	f o s e
dignitate	d i ɡ n i t a t e
tentăm	t e n t ə m
mulțumind	m u l t͡s u m i n d
vomit	v o m i t
firida	f i r i d a
castrase	k a s t r a s e
apropiase	a p r o p i a s e
înzestraserăm	ɨ n z e s t r a s e r ə m
umiditate	u m i d i t a t e
pula	p u l a
sufla	s u f l a
șantajatele	ʃ a n t a ʒ a t e l e
grabo	ɡ r a b o
fundam	f u n d a m
cotidian	k o t i d i a n
unul	u n u l
dame	d a m e
globule	ɡ l o b u l e
decapitase	d e k a p i t a s e
vulvă	v u l v ə
exclamam	e k s k l a m a m
boteza	b o t e z a
nevăzut	n e v ə z u t
opritei	o p r i t e j
determinam	d e t e r m i n a m
voise	v o i s e
analiza	a n a l i z a
așteptat	a ʃ t e p t a t
futut	f u t u t
despice	d e s p i t͡ʃ e
sexualii	s e k s u a l i j
găsească	ɡ ə s e̯ a s k ə
stimulați	s t i m u l a t͡sʲ
frumoșii	f r u m o ʃ i j
asurzește	a s u r z e ʃ t e
argintiu	a ɾ d͡ʒ i n t i w
frumoaselor	f r u m o̯ a s e l o r
argumentase	a r ɡ u m e n t a s e
grăbiți	ɡ r ə b i t͡sʲ
răpiți	r ə p i t͡sʲ
studiez	s t u d j e z
răstigni	r ə s t i ɡ n i
acolada	a k o l a d a
genetică	d͡ʒ e n e t i k ə
formaseră	f o r m a s e r ə
jerbo	ʒ e r b o
foaie	f o̯ a j e
opriți	o p r i t͡sʲ
trotez	t r o t e z
monocrom	m o n o k r o m
juisez	ʒ u i s e z
decapitai	d e k a p i t a j
intensificase	i n t e n s i f i k a s e
mâncă	m ɨ n k ə
numea	n u m e̯ a
reintra	r e i n t r a
vexam	v e k s a m
rupi	r u pʲ
întărita	ɨ n t ə r i t a
remarcat	r e m a r k a t
masturbat	m a s t u r b a t
agentă	a d͡ʒ e n t ə
vedem	v e d e m
șoptiți	ʃ o p t i t͡sʲ
turbat	t u r b a t
labe	l a b e
sexuale	s e k s u a l e
găsise	ɡ ə s i s e
găsitului	ɡ ə s i t u l u j
Dunăre	d u n ə r e
tentante	t e n t a n t e
totalitate	t o t a l i t a t e
frico	f r i k o
făcuse	f ə k u s e
perfectează	p e r f e k t e̯ a z ə
faze	f a z e
hrană	x r a n ə
deranjate	d e r a n ʒ a t e
sexologie	s e k s o l o d ʒ i e
canicula	k a n i k u l a
sodomizeze	s o d o m i z e z e
gramatica	ɡ r a m a t i k a
mulțumita	m u l t͡s u m i t a
dezechilibru	d e z e k i l i b r u
asurzit	a s u r z i t
români	r o m ɨ nʲ
tentezi	t e n t e zʲ
perinee	p e r i n eː
spermă	s p ɛ r m ə
plictisiseși	p l i k t i s i s e ʃʲ
asurzii	a s u r z iː
bulgărească	b u l ɡ ə r e̯ a s k ə
inventam	i n v e n t a m
știm	ʃ t i m
juisăm	ʒ u i s ə m
releu	r e l e u
eligibilitate	e l i d͡ʒ i b i l i t a t e
oarecare	w a ɾ e k a ɾ e
ejaculai	e ʒ a k u l a j
dușmănite	d u ʃ m ə n i t e
dorință	d o r i n t͡s ə
firii	f i r i j
mărturisiserăți	m ə r t u r i s i s e r ə t sʲ
rulase	r u l a s e
custase	k u s t a s e
înzestrează	ɨ n z e s t r e̯ a z ə
întăream	ɨ n t ə r e̯ a m
normalitate	n o r m a l i t a t e
ordoni	o r d o nʲ
cânta	k ɨ n t a
pavai	p a v a j
primiși	p r i m i ʃʲ
copleșitoare	k o p l e ʃ i t o̯ a r e
comparase	k o m p a r a s e
părintești	p ə r i n t e ʃ tʲ
fracturat	f r a k t u r a t
masturba	m a s t u r b a
formează	f o r m e̯ a z ə
pun	p u n
unghi	u ŋ ɡʲ
fuma	f u m a
păcurar	p ə k u r a r
curvei	k u r v e j
blasfeme	b l a s f e m e
clădiților	k l ə d i t͡s i l o r
veștejiseși	v e ʃ t e ʒ i s e ʃʲ
pizda	p i z d a
clăditului	k l ə d i t u l u j
discute	d i s k u t e
cumva	k u m v a
șoaptă	ʃ o̯ a p t ə
mumu	m u m u
gravez	ɡ r a v e z
fata	f a t a
peștilor	p e ʃ t i l o r
funcționând	f u n k t͡s i o n ɨ n d
prepare	p r e p a r e
coci	k o t͡ʃʲ
storci	s t o r t͡ʃʲ
ușa	u ʃ a
ordon	o r d o n
gândim	ɡ ɨ n d i m
urinaserăm	u r i n a s e r ə m
sacoșă	s a k o ʃ ə
culpe	k u l p e
înzestrarăți	ɨ n z e s t r a r ə t sʲ
cântărețe	k ɨ n t ə r e t͡s e
lipsit	l i p s i t
frecam	f r e k a m
răpiților	r ə p i t͡s i l o r
fumarăm	f u m a r ə m
îmbunătățit	ɨ m b u n ə t ə t s i t
lipsiții	l i p s i t͡s iː
întăritele	ɨ n t ə r i t e l e
janta	ʒ a n t a
fanteziei	f a n t e z i e j
grăbeau	ɡ r ə b e̯ a w
sedus	s e d u s
fraudam	f r a u d a m
ejaculau	e ʒ a k u l a w
saturase	s a t u r a s e
mâncasem	m ɨ n k a s e m
decad	d e k a d
vorbit	v o r b i t
linge	l i n d ʒ e
suplicat	s u p l i k a t
pecunie	p e k u n i e
iubite	j u b i t e
sexy	s e k s i
iubirile	j u b i r i l e
mulțumise	m u l t͡s u m i s e
alfabetele	a l f a b e t e l e
delicioase	d e l i t͡ʃ j o̯ a s e
necăjirăm	n e k ə ʒ i r ə m
creând	k r e ɨ n d
iubiși	j u b i ʃʲ
simulare	s i m u l a r e
vreți	v r e t sʲ
revoluție	r e v o l u t͡s i e
sfânt	s f ɨ n t
gali	ɡ a lʲ
cânt	k ɨ n t
admiram	a d m i r a m
gravitarăți	ɡ r a v i t a r ə t sʲ
analizeze	a n a l i z e z e
invidiai	i n v i d i a j
presar	p r e s a r
omorî	o m o r ɨ
giaca	d͡ʒ j a k a
beai	b e̯ a j
mor	m o r
violat	v i o l a t
formei	f o r m e j
futuserăți	f u t u s e r ə t͡sʲ
ridic	r i d i k
falca	f a l k a
mănâncă	m ə n ɨ n k ə
delimită	d e l i m i t ə
spovedirăți	s p o v e d i r ə t͡sʲ
pipi	p i p i
retrase	r e t r a s e
focilor	f o t͡ʃ i l o r
asurzirăm	a s u r z i r ə m
elevo	e l e v o
inovai	i n o v a j
localitate	l o k a l i t a t e
America	a m e r i k a
gnostici	ɡ n o s t i t͡ʃʲ
fracturase	f r a k t u r a s e
dorme	d o r m e
străluci	s t r ə l u t ʃ i
abandonarăm	a b a n d o n a r ə m
giace	d͡ʒ j a t͡ʃ e
aprobi	a p r o bʲ
creaseră	k r e a s e r ə
adiase	a d i a s e
homofobie	h o m o f o b i e
simple	s i m p l e
necăjesc	n e k ə ʒ e s k
poftim	p o f ↗︎ t i m
combinase	k o m b i n a s e
ime	i m e
celebram	t͡ʃ e l e b r a m
aligator	a l i ɡ a t o r
genunchieră	d ʒ e n u n k j e r ə
perturbam	p e r t u r b a m
ataraxia	a t a r a k s i a
Eurovision	e u r o v i z j o n
palmă	p a l m ə
plantai	p l a n t a j
distrau	d i s t r a w
foloseau	f o l o s e̯ a w
primeau	p r i m e̯ a w
anus	a n u s
armonizase	a r m o n i z a s e
zăpușii	z ə p u ʃ iː
gambo	ɡ a m b o
caleo	k a l e̯ o
pornograficei	p o r n o ɡ r a f i t͡ʃ e j
circumcide	t͡ʃ i r k u m t͡ʃ i d e
delas	d e l a s
asurziși	a s u r z i ʃʲ
masturbatelor	m a s t u r b a t e l o r
deranjaserăm	d e r a n ʒ a s e r ə m
răpiserăm	r ə p i s e r ə m
pule	p u l e
înzestrată	ɨ n z e s t r a t ə
limitasem	l i m i t a s e m
oarecând	w a ɾ e̞ k ɨ n d
controlară	k o n t r o l a r ə
complicam	k o m p l i k a m
creez	k r e e z
delimiteze	d e l i m i t e z e
întâlneați	ɨ n t ɨ l n e̯ a t sʲ
transformai	t r a n s f o r m a j
locvace	l o k v a t͡ʃ e
spovediși	s p o v e d i ʃʲ
cicade	t͡ʃ i k a d e
creează	k r e e̯ a z ə
supseră	s u p s e r ə
denaturat	d e n a t u r a t
bulbuca	b u l b u k a
egali	e ɡ a lʲ
făcurăți	f ə k u r ə t͡sʲ
iubeam	j u b e̯ a m
oaspeți	w a s p e t͡sʲ
răpeau	r ə p e̯ a w
tatuase	t a t u a s e
rodie	r o d i e
autoritate	a u t o r i t a t e
fraudai	f r a u d a j
dușmănirăm	d u ʃ m ə n i r ə m
fale	f a l e
masturbatului	m a s t u r b a t u l u j
pulsase	p u l s a s e
lexem	l e k s e m
copilărește	k o p i l ə r e ʃ t e
făcuseși	f ə k u s e ʃʲ
necăjitelor	n e k ə ʒ i t e l o r
șoptirăți	ʃ o p t i r ə t sʲ
lovea	l o v e̯ a
oprita	o p r i t a
congelase	k o n d͡ʒ e l a s e
evlavioasei	e v l a v i o̯ a s e j
vexez	v e k s e z
voi	v o i
tratam	t r a t a m
gripei	ɡ r i p e j
cenzurași	t͡ʃ e n z u r a ʃʲ
ardem	a r d e m
grăbisem	ɡ r ə b i s e m
vorbeai	v o r bʲ æ j
distrasem	d i s t r a s e m
reviste	r e v i s t e
damnez	d a m n e z
dușmăneau	d u ʃ m ə n e̯ a w
ejacularăți	e ʒ a k u l a r ə t sʲ
doare	d o̯ a r e
văd	v ə d
adjective	a d ʒ e k t i v e
anatemei	a n a t e m e j
citești	t ʃ i t e ʃ tʲ
lavina	l a v i n a
digitalizai	d i d͡ʒ i t a l i z a j
urinam	u r i n a m
întărise	ɨ n t ə r i s e
îmbunătăți	ɨ m b u n ə t ə t s i
latri	l a t r i
gândeai	ɡ ɨ n d e̯ a j
smârc	s m ɨ r k
șurubelniță	ʃ u r u b e l n i t s ə
freci	f r e t͡ʃʲ
deranjaserăți	d e r a n ʒ a s e r ə t sʲ
controla	k o n t r o l a
întăriții	ɨ n t ə r i t͡s iː
somnambulist	s o m n a m b u l i s t
dezbrăcat	d e z b r ə k a t
bardou	b a r d o w
transformat	t r a n s f o r m a t
administrez	a d m i n i s t r e z
ictere	i k t e r e
ivorian	i v o r i a n
maturitate	m a t u r i t a t e
concretizase	k o n k r e t i z a s e
citeai	t ʃ i t j a j
colinde	k o l i n d e
numesc	n u m e s k
viezure	v j e z u r e
gânditul	ɡ ɨ n d i t u
tatuați	t a t u a t͡sʲ
tatuajul	t a t u a ʒ u l
accelerând	a k t͡ʃ e l e r ɨ n d
știu	ʃ t i u
decidem	d e t͡ʃ i d e m
pneumonoultramicroscopicsilicovolcaniconioze	p n e u m o n o u l t r a m i k r o s k o p i k s i l i k o v o l k a n i k o n i o z e
audacie	a u d a t͡ʃ i e
vedea	v e̞ d e̯ a
bag	b a ɡ
formă	f o r m ə
dușmănitului	d u ʃ m ə n i t u l u j
negau	n e ɡ a w
scrumieră	s k r u m i e r ə
complexe	k o m p l e k s e
șantajam	ʃ a n t a ʒ a m
întăritului	ɨ n t ə r i t u l u j
negre	n e ɡ r e
guta	ɡ u t a
introduc	i n t r o d u k
acestor	a t͡ʃ e s t o r
amintește	a m i n t e ʃ t e
asurzi	a s u r z i
iubită	j u b i t ə
artificializam	a r t i f i t͡ʃ i a l i z a m
acestei	a t͡ʃ e s t e j
burai	b u r a j
specificitate	s p e t͡ʃ i f i t͡ʃ i t a t e
guro	ɡ u r o
veștejim	v e ʃ t e ʒ i m
reglat	r e ɡ l a t
șantajau	ʃ a n t a ʒ a w
aspiri	a s p i rʲ
primită	p r i m i t ə
pregătitei	p r e ɡ ə t i t e j
determini	d e t e r m i nʲ
controlase	k o n t r o l a s e
buca	b u k a
umanitate	u m a n i t a t e
sature	s a t u r e
înzestrând	ɨ n z e s t r ɨ n d
tentat	t e n t a t
distracție	d i s t r a k t͡s i e
tatuară	t a t u a r ə
neamț	n e̯ a m t͡s
educe	e d u t͡ʃ e
albanez	a l b a n e z
epistola	e p i s t o l a
apropie	a p r o p j e
pregătește	p r e ɡ ə t e ʃ t e
șantajatei	ʃ a n t a ʒ a t e j
urinași	u r i n a ʃʲ
dreaptă	d r e̯ a p t ə
scrisoare	s k r i s o̯ a r e
avivai	a v i v a j
sexualilor	s e k s u a l i l o r
îmbunătățești	ɨ m b u n ə t ə t s e ʃ tʲ
pa	p a
mardii	m a r d i j
digitalizase	d i d͡ʒ i t a l i z a s e
frecați	f r e k a t͡sʲ
șoptisem	ʃ o p t i s e m
părintească	p ə r i n t e̯ a s k ə
industrializai	i n d u s t r i a l i z a j
frago	f r a ɡ o
controlai	k o n t r o l a j
timpul	t i m p u l
călătoriserăți	k ə l ə t o r i s e r ə t sʲ
respiram	r e s p i r a m
iubise	j u b i s e
necăjeam	n e k ə ʒ e̯ a m
citologo	t͡ʃ i t o l o ɡ o
formarăm	f o r m a r ə m
gripo	ɡ r i p o
combinam	k o m b i n a m
săptămâni	s ə p t ə m ɨ nʲ
gravitat	ɡ r a v i t a t
mulțumisem	m u l t͡s u m i s e m
crezi	k r e zʲ
animi	a n i mʲ
cazan	k a z a n
dimineți	d i m i n e t sʲ
exprimam	e k s p r i m a m
fantoma	f a n t o m a
crapi	k r a pʲ
compar	k o m p a r
buna	b u n a
prevesti	p r e v e s t i
sângerezi	s ɨ n d͡ʒ e r e zʲ
visului	v i s u l u j
enervam	e n e r v a m
filozofia	f i l o z o f i a
pici	p i t͡ʃʲ
vorbeați	v o r bʲ æ t͡sʲ
viam	v i a m
omniprezență	o m n i p r e z e n t s ə
elogiu	e l o d͡ʒ i w
cașto	k a ʃ t o
argumentam	a r ɡ u m e n t a m
delimitat	d e l i m i t a t
mulțumea	m u l t͡s u m e̯ a
sunetului	s u n e t u l u j
reverse	r e v e r s e
Popescu	p o p e s k u
cetățence	t͡ʃ e t ə t͡s e n t͡ʃ e
necăjită	n e k ə ʒ i t ə
amuzi	a m u zʲ
spovedit	s p o v e d i t
copiez	k o p i e z
zăpușeai	z ə p u ʃ j a j
citita	t͡ʃ i t i t a
erotice	e r o t i t͡ʃ e
fesa	f e s a
citi	t͡ʃ i t i
iubiseră	j u b i s e r ə
alung	a l u ŋ ɡ
nativa	n a t i v a
sângerez	s ɨ n d͡ʒ e r e z
boală	b o̯ a l ə
culturalizase	k u l t u r a l i z a s e
copleși	k o p l e ʃ i
delimitași	d e l i m i t a ʃʲ
mărturiseai	m ə r t u r i s e̯ a j
câștige	k ɨ ʃ t i d͡ʒ e
gravitau	ɡ r a v i t a w
evlaviosului	e v l a v i o s u l u j
murmure	m u r m u r e
sodomizară	s o d o m i z a r ə
scrot	s k r o t
legase	l e ɡ a s e
abandonarăți	a b a n d o n a r ə t sʲ
fuși	f u ʃʲ
șantajurile	ʃ a n t a ʒ u r i l e
culorile	k u l o r i l e
răpirăți	r ə p i r ə t sʲ
părinți	p ə r i n t͡sʲ
prezice	p r e z i t͡ʃ e
felație	f e l a t s i e
primeați	p r i m e̯ a t͡sʲ
declaram	d e k l a r a m
anonim	a n o n i m
noroc	n o r o k
arase	a r a s e
foco	f o k o
azeră	a z e r ə
editase	e d i t a s e
fund	f u n d
reparam	r e p a r a m
futuși	f u t u ʃʲ
supun	s u p u n
futem	f u t e m
inundai	i n u n d a j
satur	s a t u r
tricot	t r i k o t
arșiță	a r ʃ i t s ə
vorbirăm	v o r b i r ə m
analiză	a n a l i z ə
petrece	p e t r e t ʃ e
alcoolice	a l k o o l i t͡ʃ e
jante	ʒ a n t e
paralizam	p a r a l i z a m
fluvial	f l u v i a l
girafe	d͡ʒ i r a f e
spere	s p e r e
formatului	f o r m a t u l u j
aurea	a u r e̯ a
articulase	a r t i k u l a s e
omenească	o m e n e̯ a s k ə
exclamat	e k s k l a m a t
omenesc	o m e n e s k
orientări	o r i e n t ə rʲ
scol	s k o l
dinte	d i n t e
spovediți	s p o v e d i t͡sʲ
perseverai	p e r s e v e r a j
frumusețile	f r u m u s e t s i l e
existai	e ɡ z i s t a j
călătoreau	k ə l ə t o r j a w
real	r e a l
analizasem	a n a l i z a s e m
ubicuă	u b i k u ə
gândind	ɡ ɨ n d i n d
protejăm	p r o t e ʒ ə m
femeiește	f e m e j e ʃ t e
veștejiți	v e ʃ t e ʒ i t͡sʲ
administram	a d m i n i s t r a m
pornograficii	p o r n o ɡ r a f i t͡ʃ i j
Mioveni	m i o v ɛ nʲ
juiseze	ʒ u i s e z e
plictisirăm	p l i k t i s i r ə m
homosexualului	h o m o s e k s u a l u l u j
croato	k r o a t o
nori	n o rʲ
pornit	p o r n i t
liberai	l i b e r a j
pederastie	p e d e r a s t i j e
grapa	ɡ r a p a
discreție	d i s k r e t͡s i e
găsită	ɡ ə s i t ə
asexualitate	a s e k s u a l i t a t e
mâncarăți	m ɨ n k a r ə t͡sʲ
scrotală	s k r o t a l ə
cari	k a rʲ
iubiserăți	j u b i s e r ə t͡sʲ
centrale	t͡ʃ e n t ɾ a l e
delicioasă	d e l i t͡ʃ j o̯ a s ə
cenzurai	t͡ʃ e n z u r a j
controlaserăm	k o n t r o l a s e r ə m
latura	l a t u r a
întristezi	ɨ n t r i s t e zʲ
capitulase	k a p i t u l a s e
declinat	d e k l i n a t
munți	m u n t sʲ
puneți	p u n e t͡sʲ
forma	f o r m a
frumuseților	f r u m u s e t s i l o r
comit	k o m i t
clădeau	k l ə d j a w
somnambuliști	s o m n a m b u l i ʃ tʲ
studie	s t u d j e
distrat	d i s t r a t
eliminase	e l i m i n a s e
teatru	t e̯ a t r u
flexibilitate	f l e k s i b i l i t a t e
colorez	k o l o r e z
lacuna	l a k u n a
îmbunătățiți	ɨ m b u n ə t ə t͡s i t͡sʲ
comunicam	k o m u n i k a m
culoare	k u l o̯ a r e
spovedească	s p o v e d e̯ a s k ə
formalitate	f o r m a l i t a t e
porniră	p o r n i r ə
facem	f a t͡ʃ e m
mâncaseră	m ɨ n k a s e r ə
absolutizam	a b s o l u t i z a m
limitai	l i m i t a j
delirurilor	d e l i r u r i l o r
mulgeam	m u l d͡ʒ e̯ a m
comparam	k o m p a r a m
harfa	h a r f a
cost	k o s t
discret	d i s k r e t
rupta	r u p t a
plictiseau	p l i k t i s e̯ a w
marcase	m a r k a s e
nicidecum	n i t ʃʲ d e k u m
educ	e d u k
capsulam	k a p s u l a m
serbam	s e r b a m
dedu	d e d u
excitat	e k s t ʃ i t a t
excavezi	e k s k a v e zʲ
capitulat	k a p i t u l a t
șanse	ʃ a n s e
ejaculeze	e ʒ a k u l e z e
distraserăm	d i s t r a s e r ə m
frățești	f r ə t͡s e ʃ tʲ
masturbară	m a s t u r b a r ə
sodomizatei	s o d o m i z a t e j
deranjând	d e r a n ʒ ɨ n d
întăreau	ɨ n t ə r e̯ a w
întâlnind	ɨ n t ɨ l n i n d
nălucitul	n ə l u t͡ʃ i t u
sacrifice	s a k r i f i t͡ʃ e
somează	s o m e̯ a z ə
distrași	d i s t r a ʃʲ
impute	i m p u t e
nălucirăm	n ə l u t ʃ i r ə m
suedeză	s u e d e z ə
opreați	o p r e̯ a t͡sʲ
transpire	t r a n s p i r e
aalenian	aː l e n i a n
culminai	k u l m i n a j
urinează	u r i n e̯ a z ə
spele	s p e l e
gândita	ɡ ɨ n d i t a
folosească	f o l o s e̯ a s k ə
nălucii	n ə l u t ʃ iː
distra	d i s t r a
salinizase	s a l i n i z a s e
dorințelor	d o r i n t͡s e l o r
leg	l e ɡ
geci	d͡ʒ e t͡ʃʲ
șoptirăm	ʃ o p t i r ə m
abunde	a b u n d e
cădea	k ə d e̯ a
bărbătește	b ə r b ə t e ʃ t e
diminețile	d i m i n e t s i l e
lacrima	l a k r i m a
compensai	k o m p e n s a j
mișcare	m i ʃ k a r e
slovenei	s l o v e n e j
grăbise	ɡ r ə b i s e
întâlniserăm	ɨ n t ɨ l n i s e r ə m
culte	k u l t e
exista	e ɡ z i s t a
