подивитися	p ɔ d ɪ ʋ ɪ t ɪ sʲ ɛ
маска	m ɑ s k ɛ
гібридний	ɦ i b r ɪ d n ɪ i
діагностика	dʲ i ɛ ɦ n ɔ s t ɪ k ɛ
град	ɦ r ɑ d
декларацію	d ɪ k ɫ ɛ r ɑ t͡sʲ i j u
хрін	x rʲ i n
скорочувати	s k ɔ r ɔ t͡ʃ u ʋ ɛ t ɪ
випроменити	ʋ ɪ p r ɔ m ɪ n ɪ t ɪ
індонезія	i n d ɔ n ɛ zʲ i j ɛ
перезаписати	p ɪ r ɪ z ɛ p ɪ s ɑ t ɪ
висіти	ʋ ɪ sʲ i t ɪ
федір	f ɛ dʲ i r
лихо	ɫ ɪ x ɔ
калюжа	k ɛ lʲ u ʒ ɛ
ключовий	k lʲ u t͡ʃ ɔ ʋ ɪ i
дитсадок	d ɪ t͡s ɛ d ɔ k
вирізнятися	ʋ ɪ rʲ i zʲ nʲ ɑ t ɪ sʲ ɛ
цукерка	t͡s u k ɛ r k ɛ
когнітивний	k ɔ ɦ nʲ i t ɪ u n ɪ i
авантюрниця	ɛ ʋ ɛ nʲ tʲ u r n ɪ t͡sʲ ɛ
щавель	ʃ t͡ʃ ɛ ʋ ɛ lʲ
ї	j i
шановний	ʃ ɛ n ɔ u n ɪ i
лише	ɫ ɪ ʃ ɛ
швидкістю	ʃ ʋ ɪ dʲ k i sʲ tʲ u
традиційно	t r ɛ d ɪ t͡sʲ i i n ɔ
беззубий	b ɪ z u b ɪ i
ідея	i d ɛ j ɛ
менеджмент	m ɛ n ɪ d͡ʒ m ɪ n t
номінальний	n ɔ m i n ɑ lʲ n ɪ i
естонський	ɪ s t ɔ nʲ sʲ k ɪ i
аврора	ɛ u r ɔ r ɛ
пожежа	p ɔ ʒ ɛ ʒ ɛ
рідна	rʲ i d n ɛ
абіогенез	ɛ b i ɔ ɦ ɪ n ɛ z
міжвоєнний	m i ʒ ʋ ɔ j ɛ n ɪ i
превентивний	p r ɪ ʋ ɪ n t ɪ u n ɪ i
команда	k ɔ m ɑ n d ɛ
ліберальний	lʲ i b ɪ r ɑ lʲ n ɪ i
судноплавство	s u d n ɔ p ɫ ɑ u s t ʋ ɔ
аварійний	ɛ ʋ ɛ rʲ i i n ɪ i
обшук	ɔ b ʃ u k
прислухування	p r ɪ s ɫ u x u ʋ ɛ nʲ ɛ
австрійський	ɛ u s tʲ rʲ i i sʲ k ɪ i
цегляний	t͡s ɪ ɦ lʲ ɛ n ɪ i
класовий	k ɫ ɑ s ɔ ʋ ɪ i
скидати	s k ɪ d ɑ t ɪ
мірою	m i r ɔ j u
толерантний	t ɔ ɫ ɪ r ɑ n t n ɪ i
рилам	r ɪ ɫ ɛ m
україно	u k r ɛ j i n ɔ
двосторонній	d ʋ ɔ s t ɔ r ɔ nʲ i i
абвер	ɑ b ʋ ɪ r
партнер	p ɛ r t n ɛ r
марний	m ɑ r n ɪ i
мороз	m ɔ r ɔ z
авіатраса	ɛ ʋ i ɛ t r ɑ s ɛ
аномалія	ɛ n ɔ m ɑ lʲ i j ɛ
поселення	p ɔ s ɛ ɫ ɪ nʲ ɛ
кучма	k u t͡ʃ m ɛ
кришка	k r ɪ ʃ k ɛ
зображати	z ɔ b r ɛ ʒ ɑ t ɪ
криголам	k r ɪ ɦ ɔ ɫ ɑ m
авіаучилище	ɛ ʋ i ɛ u t͡ʃ ɪ ɫ ɪ ʃ t͡ʃ ɪ
регулярно	r ɪ ɦ u lʲ ɑ r n ɔ
засновник	z ɛ s n ɔ u n ɪ k
підготовити	p i d ɦ ɔ t ɔ ʋ ɪ t ɪ
пришвидшити	p r ɪ ʃ ʋ ɪ d͡ʒ ʃ ɪ t ɪ
самоповага	s ɛ m ɔ p ɔ ʋ ɑ ɦ ɛ
ростити	r ɔ s t ɪ t ɪ
перевірити	p ɪ r ɪ ʋ i r ɪ t ɪ
чадо	t͡ʃ ɑ d ɔ
свіча	sʲ ʋ i t͡ʃ ɛ
позбавляти	p ɔ z b ɛ u lʲ ɑ t ɪ
абеткування	ɛ b ɪ t k u ʋ ɑ nʲ ɛ
неправди	n ɪ p r ɑ u d ɪ
щорічний	ʃ t͡ʃ ɔ rʲ i t͡ʃ n ɪ i
гординя	ɦ ɔ r d ɪ nʲ ɛ
збір	zʲ b i r
страйк	s t r ɑ i k
участь	u t͡ʃ ɛ sʲ tʲ
півстоліття	p i u s t ɔ lʲ i tʲ ɛ
парадигма	p ɛ r ɛ d ɪ ɦ m ɛ
передумувати	p ɪ r ɪ d u m u ʋ ɛ t ɪ
бутан	b u t ɑ n
полуниця	p ɔ ɫ u n ɪ t͡sʲ ɛ
паузу	p ɑ u z u
меланія	m ɪ ɫ ɑ nʲ i j ɛ
вечер	ʋ ɪ t͡ʃ ɛ r
мовчати	m ɔ u t͡ʃ ɑ t ɪ
спорожняти	s p ɔ r ɔ ʒ nʲ ɑ t ɪ
вівсу	ʋ i u s u
борщ	b ɔ r ʃ t͡ʃ
гуманістичний	ɦ u m ɛ nʲ i s t ɪ t͡ʃ n ɪ i
привітати	p r ɪ ʋ i t ɑ t ɪ
литка	ɫ ɪ t k ɛ
ірина	i r ɪ n ɛ
мовити	m ɔ ʋ ɪ t ɪ
цивілізаційний	t͡s ɪ ʋ i lʲ i z ɛ t͡sʲ i i n ɪ i
найдружелюбніший	n ɛ i d r u ʒ ɪ lʲ u b nʲ i ʃ ɪ i
пархоменко	p ɛ r x ɔ m ɪ n k ɔ
теоріями	t ɪ ɔ rʲ i j ɛ m ɪ
з'їдати	z j i d ɑ t ɪ
енергій	ɪ n ɛ r ɦ i i
аброгація	ɛ b r ɔ ɦ ɑ t͡sʲ i j ɛ
україною	u k r ɛ j i n ɔ j u
хуйло	x u i ɫ ɔ
м'ясо	m j ɑ s ɔ
совок	s ɔ ʋ ɔ k
мотоциклах	m ɔ t ɔ t͡s ɪ k ɫ ɛ x
лауреат	ɫ ɛ u r ɪ ɑ t
хава	x ɑ ʋ ɛ
медалі	m ɪ d ɑ lʲ i
інструкцією	i n s t r u k t͡sʲ i j ɪ j u
товар	t ɔ ʋ ɑ r
гусениця	ɦ u s ɪ n ɪ t͡sʲ ɛ
телеканал	t ɪ ɫ ɪ k ɛ n ɑ ɫ
мовознавець	m ɔ ʋ ɔ z n ɑ ʋ ɪ t͡sʲ
безперервний	b ɪ z p ɪ r ɛ r ʋ n ɪ i
центральний	t͡s ɪ n t r ɑ lʲ n ɪ i
недостатність	n ɪ d ɔ s t ɑ tʲ nʲ i sʲ tʲ
послідовник	p ɔ sʲ lʲ i d ɔ u n ɪ k
демократично	d ɪ m ɔ k r ɛ t ɪ t͡ʃ n ɔ
співзасновник	sʲ p i u z ɛ s n ɔ u n ɪ k
одержувачка	ɔ d ɛ r ʒ u ʋ ɛ t͡ʃ k ɛ
дріжджі	dʲ rʲ i ʒ d͡ʒ i
вами	ʋ ɑ m ɪ
лічити	lʲ i t͡ʃ ɪ t ɪ
авансування	ɛ ʋ ɛ n s u ʋ ɑ nʲ ɛ
активність	ɛ k t ɪ u nʲ i sʲ tʲ
попит	p ɔ p ɪ t
бюрократ	b u r ɔ k r ɑ t
трагедій	t r ɛ ɦ ɛ dʲ i i
кінці	k i nʲ t͡sʲ i
стіна	sʲ tʲ i n ɑ
охопити	ɔ x ɔ p ɪ t ɪ
кажучи	k ɑ ʒ u t͡ʃ ɪ
юшка	j u ʃ k ɛ
судно	s u d n ɔ
кріпкий	k rʲ i p k ɪ i
кайман	k ɛ i m ɑ n
ель	ɛ lʲ
варіантом	ʋ ɛ rʲ i ɑ n t ɔ m
темний	t ɛ m n ɪ i
маршрутка	m ɛ r ʃ r u t k ɛ
ісламський	i s ɫ ɑ m sʲ k ɪ i
жіночий	ʒʲ i n ɔ t͡ʃ ɪ i
мир	m ɪ r
подвоювати	p ɔ d ʋ ɔ j u ʋ ɛ t ɪ
волейболістка	ʋ ɔ ɫ ɪ i b ɔ lʲ i s t k ɛ
сьомий	sʲ ɔ m ɪ i
твар	t ʋ ɑ r
відпочивати	ʋ i d p ɔ t͡ʃ ɪ ʋ ɑ t ɪ
спадкоємиця	s p ɛ d k ɔ j ɛ m ɪ t͡sʲ ɛ
деталь	d ɪ t ɑ lʲ
відокремлювати	ʋ i d ɔ k r ɛ m lʲ u ʋ ɛ t ɪ
профіль	p r ɔ f i lʲ
дратувати	d r ɛ t u ʋ ɑ t ɪ
автоматично	ɛ u t ɔ m ɛ t ɪ t͡ʃ n ɔ
слухач	s ɫ u x ɑ t͡ʃ
дур	d u r
можна	m ɔ ʒ n ɛ
гриб	ɦ r ɪ b
перед	p ɪ r ɛ d
женитися	ʒ ɪ n ɪ t ɪ sʲ ɛ
бібліотекарка	b i b lʲ i ɔ t ɛ k ɛ r k ɛ
долонях	d ɔ ɫ ɔ nʲ ɛ x
священний	sʲ ʋ ɛ ʃ t͡ʃ ɛ n ɪ i
крихта	k r ɪ x t ɛ
термометричний	t ɪ r m ɔ m ɪ t r ɪ t͡ʃ n ɪ i
таємниця	t ɛ j ɪ m n ɪ t͡sʲ ɛ
бюро	b u r ɔ
гнати	ɦ n ɑ t ɪ
причинність	p r ɪ t͡ʃ ɪ nʲ i sʲ tʲ
метаболічний	m ɪ t ɛ b ɔ lʲ i t͡ʃ n ɪ i
слизький	s ɫ ɪ zʲ k ɪ i
хіба	x i b ɑ
фрагментах	f r ɛ ɦ m ɛ n t ɛ x
приготувати	p r ɪ ɦ ɔ t u ʋ ɑ t ɪ
прямокутний	p rʲ ɛ m ɔ k u t n ɪ i
тополям	t ɔ p ɔ lʲ ɛ m
значний	z n ɛ t͡ʃ n ɪ i
календаря	k ɛ ɫ ɪ n d ɛ rʲ ɑ
мотоциклом	m ɔ t ɔ t͡s ɪ k ɫ ɔ m
господинею	ɦ ɔ s p ɔ d ɪ n ɪ j u
давальний	d ɛ ʋ ɑ lʲ n ɪ i
друзів	d r u zʲ i u
автобіограф	ɛ u t ɔ b i ɔ ɦ r ɛ f
стовбур	s t ɔ u b u r
ящик	j ɑ ʃ t͡ʃ ɪ k
разі	r ɑ zʲ i
вечері	ʋ ɪ t͡ʃ ɛ rʲ i
погоди	p ɔ ɦ ɔ d ɪ
шаповал	ʃ ɛ p ɔ ʋ ɑ ɫ
оригінальний	ɔ r ɪ ɦ i n ɑ lʲ n ɪ i
прамова	p r ɛ m ɔ ʋ ɛ
інтенсивний	i n t ɪ n s ɪ u n ɪ i
ситуаціях	s ɪ t u ɑ t͡sʲ i j ɛ x
повстанець	p ɔ u s t ɑ n ɪ t͡sʲ
скумбрія	s k u m b rʲ i j ɛ
спланувати	s p ɫ ɛ n u ʋ ɑ t ɪ
секунда	s ɪ k u n d ɛ
притомність	p r ɪ t ɔ m nʲ i sʲ tʲ
абхазець	ɛ b x ɑ z ɪ t͡sʲ
формування	f ɔ r m u ʋ ɑ nʲ ɛ
автореференція	ɑ u t ɔ r ɪ f ɪ r ɛ nʲ t͡sʲ i j ɛ
телескоп	t ɪ ɫ ɪ s k ɔ p
гербата	ɦ ɪ r b ɑ t ɛ
мінімальний	m i nʲ i m ɑ lʲ n ɪ i
письменниці	p ɪ sʲ m ɛ n ɪ t͡sʲ i
поглядові	p ɔ ɦ lʲ ɛ d ɔ ʋ i
приданий	p r ɪ d ɛ n ɪ i
ленін	ɫ ɛ nʲ i n
бюст	b u s t
ступити	s t u p ɪ t ɪ
гроші	ɦ r ɔ ʃ i
рило	r ɪ ɫ ɔ
результат	r ɪ z u lʲ t ɑ t
виразний	ʋ ɪ r ɑ z n ɪ i
витерти	ʋ ɪ t ɪ r t ɪ
відокремити	ʋ i d ɔ k r ɛ m ɪ t ɪ
з'ясувати	z j ɛ s u ʋ ɑ t ɪ
сприймати	s p r ɪ i m ɑ t ɪ
битися	b ɪ t ɪ sʲ ɛ
момент	m ɔ m ɛ n t
передбачити	p ɪ r ɪ d b ɑ t͡ʃ ɪ t ɪ
солідарність	s ɔ lʲ i d ɑ r nʲ i sʲ tʲ
коктейль	k ɔ k t ɛ i lʲ
ярмо	j ɛ r m ɔ
ховати	x ɔ ʋ ɑ t ɪ
мілина	m i ɫ ɪ n ɑ
ілюзія	i lʲ u zʲ i j ɛ
сідниця	sʲ i d n ɪ t͡sʲ ɛ
зграя	z ɦ r ɑ j ɛ
обурення	ɔ b u r ɪ nʲ ɛ
промежина	p r ɔ m ɛ ʒ ɪ n ɛ
трава	t r ɛ ʋ ɑ
теорію	t ɪ ɔ rʲ i j u
багатокутник	b ɛ ɦ ɛ t ɔ k u t n ɪ k
варіанти	ʋ ɛ rʲ i ɑ n t ɪ
пшениця	p ʃ ɪ n ɪ t͡sʲ ɛ
дівча	dʲ i u t͡ʃ ɑ
ванна	ʋ ɑ n ɛ
шкатулка	ʃ k ɛ t u ɫ k ɛ
наступниця	n ɛ s t u p n ɪ t͡sʲ ɛ
ексгібіціоністський	ɪ ɡ zʲ ɦ i b i t͡sʲ i ɔ nʲ i sʲ k ɪ i
ствол	s t ʋ ɔ ɫ
кішка	k i ʃ k ɛ
прислухатися	p r ɪ s ɫ u x ɛ t ɪ sʲ ɛ
близький	b ɫ ɪ zʲ k ɪ i
мізерний	m i z ɪ r n ɪ i
письменність	p ɪ sʲ m ɛ nʲ i sʲ tʲ
маршрутів	m ɛ r ʃ r u tʲ i u
юрисдикція	j u r ɪ z d ɪ k t͡sʲ i j ɛ
видовище	ʋ ɪ d ɔ ʋ ɪ ʃ t͡ʃ ɪ
металобрухт	m ɪ t ɛ ɫ ɔ b r u x t
співбесідниця	sʲ p i u b ɪ sʲ i d n ɪ t͡sʲ ɛ
схематизувати	s x ɪ m ɛ t ɪ z u ʋ ɑ t ɪ
продавати	p r ɔ d ɛ ʋ ɑ t ɪ
завантажити	z ɛ ʋ ɛ n t ɑ ʒ ɪ t ɪ
вижлоктати	ʋ ɪ ʒ ɫ ɔ k t ɛ t ɪ
коштувати	k ɔ ʃ t u ʋ ɛ t ɪ
евакуація	ɪ ʋ ɛ k u ɑ t͡sʲ i j ɛ
половина	p ɔ ɫ ɔ ʋ ɪ n ɛ
креативний	k r ɪ ɛ t ɪ u n ɪ i
личинка	ɫ ɪ t͡ʃ ɪ n k ɛ
єгипет	j ɪ ɦ ɪ p ɪ t
принижувати	p r ɪ n ɪ ʒ u ʋ ɛ t ɪ
ліпший	lʲ i p ʃ ɪ i
посередник	p ɔ s ɪ r ɛ d n ɪ k
японію	j ɛ p ɔ nʲ i j u
ікло	i k ɫ ɔ
босоногий	b ɔ s ɔ n ɔ ɦ ɪ i
луг	ɫ u ɦ
станцією	s t ɑ nʲ t͡sʲ i j ɪ j u
авіарейд	ɛ ʋ i ɛ r ɛ i d
каштан	k ɛ ʃ t ɑ n
гомосексуалізм	ɦ ɔ m ɔ s ɪ k s u ɛ lʲ i z m
бета	b ɛ t ɛ
ефект	ɪ f ɛ k t
старання	s t ɛ r ɑ nʲ ɛ
поглинути	p ɔ ɦ ɫ ɪ n u t ɪ
сідницю	sʲ i d n ɪ t͡sʲ u
вівсах	ʋ i u s ɛ x
четвер	t͡ʃ ɪ t ʋ ɛ r
хмельницький	x m ɪ lʲ n ɪ t͡sʲ k ɪ i
геофізичний	ɦ ɪ ɔ f i z ɪ t͡ʃ n ɪ i
слов'янками	s ɫ ɔ ʋ j ɑ n k ɛ m ɪ
кутя	k u tʲ ɑ
вбивати	ʋ b ɪ ʋ ɑ t ɪ
тобою	t ɔ b ɔ j u
довгочасний	d ɔ u ɦ ɔ t͡ʃ ɑ s n ɪ i
доза	d ɔ z ɛ
виростати	ʋ ɪ r ɔ s t ɑ t ɪ
повіки	p ɔ ʋ i k ɪ
видра	ʋ ɪ d r ɛ
людина	lʲ u d ɪ n ɛ
маківка	m ɑ k i u k ɛ
шина	ʃ ɪ n ɛ
слова	s ɫ ɔ ʋ ɛ
нумограй	n u m ɔ ɦ r ɑ i
застрахувати	z ɛ s t r ɛ x u ʋ ɑ t ɪ
потворний	p ɔ t ʋ ɔ r n ɪ i
ланцюговий	ɫ ɛ nʲ t͡sʲ u ɦ ɔ ʋ ɪ i
уживати	u ʒ ɪ ʋ ɑ t ɪ
поліціях	p ɔ lʲ i t͡sʲ i j ɛ x
десертах	d ɪ s ɛ r t ɛ x
тренінг	t r ɛ nʲ i n ɦ
стрибати	s t r ɪ b ɑ t ɪ
довгий	d ɔ u ɦ ɪ i
румунський	r u m u nʲ sʲ k ɪ i
зоря	z ɔ rʲ ɑ
худнути	x u d n u t ɪ
десертові	d ɪ s ɛ r t ɔ ʋ i
благо	b ɫ ɑ ɦ ɔ
беззастережний	b ɪ z ɛ s t ɪ r ɛ ʒ n ɪ i
прислухуватися	p r ɪ s ɫ u x u ʋ ɛ t ɪ sʲ ɛ
шинок	ʃ ɪ n ɔ k
арфіст	ɛ r f i s t
авіста	ɛ ʋ i s t ɛ
одинадцять	ɔ d ɪ n ɑ d͡zʲ t͡sʲ ɛ tʲ
царство	t͡s ɑ r s t ʋ ɔ
таїландець	t ɛ j i ɫ ɑ n d ɪ t͡sʲ
нескладовий	n ɪ s k ɫ ɛ d ɔ ʋ ɪ i
день	d ɛ nʲ
важчий	ʋ ɑ ʒ t͡ʃ ɪ i
пристрій	p r ɪ s tʲ rʲ i i
руанда	r u ɑ n d ɛ
щитоподібна	ʃ t͡ʃ ɪ t ɔ p ɔ dʲ i b n ɛ
афганський	ɛ f ɦ ɑ nʲ sʲ k ɪ i
смоктати	s m ɔ k t ɑ t ɪ
фоб	f ɔ b
речі	r ɛ t͡ʃʲ i
білка	b i ɫ k ɛ
шкодити	ʃ k ɔ d ɪ t ɪ
ісус	i s u s
жила	ʒ ɪ ɫ ɑ
вибирати	ʋ ɪ b ɪ r ɑ t ɪ
неприйнятний	n ɪ p r ɪ i nʲ ɛ t n ɪ i
границя	ɦ r ɛ n ɪ t͡sʲ ɛ
снідати	sʲ nʲ i d ɛ t ɪ
баба	b ɑ b ɛ
сьодні	sʲ ɔ dʲ nʲ i
грязь	ɦ rʲ ɑ zʲ
папір	p ɛ p i r
критичний	k r ɪ t ɪ t͡ʃ n ɪ i
документувати	d ɔ k u m ɪ n t u ʋ ɑ t ɪ
регіональний	r ɪ ɦ i ɔ n ɑ lʲ n ɪ i
сором	s ɔ r ɔ m
зайнятий	z ɑ i nʲ ɛ t ɪ i
непокоїти	n ɪ p ɔ k ɔ j i t ɪ
печера	p ɪ t͡ʃ ɛ r ɛ
орбіти	ɔ r b i t ɪ
застосування	z ɛ s t ɔ s u ʋ ɑ nʲ ɛ
смутний	s m u t n ɪ i
заглядати	z ɛ ɦ lʲ ɛ d ɑ t ɪ
меморандум	m ɪ m ɔ r ɑ n d u m
двадцятиоднокутник	d ʋ ɛ d͡zʲ t͡sʲ ɛ t ɪ ɔ d n ɔ k u t n ɪ k
абстракція	ɛ b s t r ɑ k t͡sʲ i j ɛ
хрест	x r ɛ s t
організаціє	ɔ r ɦ ɛ nʲ i z ɑ t͡sʲ i j ɪ
десертам	d ɪ s ɛ r t ɛ m
оборонити	ɔ b ɔ r ɔ n ɪ t ɪ
чужина	t͡ʃ u ʒ ɪ n ɑ
демонстрація	d ɪ m ɔ n s t r ɑ t͡sʲ i j ɛ
їжа	j i ʒ ɛ
імперія	i m p ɛ rʲ i j ɛ
наталія	n ɛ t ɑ lʲ i j ɛ
новини	n ɔ ʋ ɪ n ɪ
обдаровувати	ɔ b d ɛ r ɔ ʋ u ʋ ɛ t ɪ
всесвітньовідомий	ʋ s ɪ sʲ ʋ i tʲ nʲ ɔ ʋ i d ɔ m ɪ i
яловичину	j ɑ ɫ ɔ ʋ ɪ t͡ʃ ɪ n u
мрію	m rʲ i j u
сприйняти	s p r ɪ i nʲ ɑ t ɪ
авіапасажир	ɛ ʋ i ɛ p ɛ s ɛ ʒ ɪ r
діаметрально	dʲ i ɛ m ɪ t r ɑ lʲ n ɔ
телеведуча	t ɪ ɫ ɪ ʋ ɪ d u t͡ʃ ɛ
менськ	m ɛ nʲ sʲ k
печивами	p ɛ t͡ʃ ɪ ʋ ɛ m ɪ
імунологічний	i m u n ɔ ɫ ɔ ɦ i t͡ʃ n ɪ i
маскат	m ɛ s k ɑ t
розвідати	r ɔ zʲ ʋ i d ɛ t ɪ
шестірня	ʃ ɪ sʲ tʲ i r nʲ ɑ
цією	t͡sʲ i j ɛ j u
невідкладний	n ɪ ʋ i d k ɫ ɑ d n ɪ i
пояснювальний	p ɔ j ɑ sʲ nʲ u ʋ ɛ lʲ n ɪ i
інтерактивний	i n t ɪ r ɛ k t ɪ u n ɪ i
оподатковувати	ɔ p ɔ d ɛ t k ɔ ʋ u ʋ ɛ t ɪ
сюрприз	sʲ u r p r ɪ z
піраміда	p i r ɛ m i d ɛ
гвінея	ɦ ʋ i n ɛ j ɛ
аболіціонізм	ɛ b ɔ lʲ i t͡sʲ i ɔ nʲ i z m
пара	p ɑ r ɛ
вниз	ʋ n ɪ z
гривням	ɦ r ɪ u nʲ ɛ m
садівниця	s ɛ dʲ i u n ɪ t͡sʲ ɛ
трок	t r ɔ k
почесть	p ɔ t͡ʃ ɪ sʲ tʲ
безстроковий	b ɪ z s t r ɔ k ɔ ʋ ɪ i
уособити	u ɔ s ɔ b ɪ t ɪ
краб	k r ɑ b
абортування	ɛ b ɔ r t u ʋ ɑ nʲ ɛ
попіл	p ɔ p i ɫ
прилад	p r ɪ ɫ ɛ d
смердіти	s m ɪ r dʲ i t ɪ
тунелю	t u n ɛ lʲ u
навігаційний	n ɛ ʋ i ɦ ɛ t͡sʲ i i n ɪ i
свідчити	sʲ ʋ i d͡ʒ t͡ʃ ɪ t ɪ
технічний	t ɪ x nʲ i t͡ʃ n ɪ i
театр	t ɪ ɑ t r
доброзичливий	d ɔ b r ɔ z ɪ t͡ʃ ɫ ɪ ʋ ɪ i
світлий	sʲ ʋ i t ɫ ɪ i
дисбаланс	d ɪ z b ɛ ɫ ɑ n s
красивий	k r ɛ s ɪ ʋ ɪ i
стабільний	s t ɛ b i lʲ n ɪ i
українських	u k r ɛ j i nʲ sʲ k ɪ x
чудій	t͡ʃ u dʲ i i
пекарні	p ɪ k ɑ r nʲ i
риба	r ɪ b ɛ
терем	t ɛ r ɪ m
парижанин	p ɛ r ɪ ʒ ɑ n ɪ n
образний	ɔ b r ɛ z n ɪ i
курити	k u r ɪ t ɪ
хобі	x ɔ b i
гіпотеза	ɦ i p ɔ t ɪ z ɛ
дошках	d ɔ ʃ k ɛ x
образливий	ɔ b r ɑ z ɫ ɪ ʋ ɪ i
виконати	ʋ ɪ k ɔ n ɛ t ɪ
плюш	p lʲ u ʃ
справами	s p r ɑ ʋ ɛ m ɪ
споживання	s p ɔ ʒ ɪ ʋ ɑ nʲ ɛ
кривавий	k r ɪ ʋ ɑ ʋ ɪ i
породілля	p ɔ r ɔ dʲ i lʲ ɛ
страх	s t r ɑ x
звертатися	z ʋ ɪ r t ɑ t ɪ sʲ ɛ
заборонити	z ɛ b ɔ r ɔ n ɪ t ɪ
змінити	zʲ m i n ɪ t ɪ
п'ятсот	p j ɛ t͡s ɔ t
законослухняний	z ɛ k ɔ n ɔ s ɫ u x nʲ ɑ n ɪ i
вимерти	ʋ ɪ m ɪ r t ɪ
воно	ʋ ɔ n ɔ
диплома	d ɪ p ɫ ɔ m ɛ
гуманістка	ɦ u m ɛ nʲ i s t k ɛ
замовник	z ɛ m ɔ u n ɪ k
спорядити	s p ɔ rʲ ɛ d ɪ t ɪ
вуглевод	ʋ u ɦ ɫ ɪ ʋ ɔ d
концепт	k ɔ n t͡s ɛ p t
принизити	p r ɪ n ɪ z ɪ t ɪ
розмова	r ɔ z m ɔ ʋ ɛ
артерію	ɛ r t ɛ rʲ i j u
власті	ʋ ɫ ɑ sʲ tʲ i
сингапур	s ɪ n ɦ ɛ p u r
аркуш	ɑ r k u ʃ
біль	b i lʲ
захист	z ɑ x ɪ s t
лавандовий	ɫ ɛ ʋ ɑ n d ɔ ʋ ɪ i
спроможність	s p r ɔ m ɔ ʒ nʲ i sʲ tʲ
правоохоронні	p r ɛ ʋ ɔ ɔ x ɔ r ɔ nʲ i
довг	d ɔ u ɦ
допустимий	d ɔ p u s t ɪ m ɪ i
систематичний	s ɪ s t ɪ m ɛ t ɪ t͡ʃ n ɪ i
ознайомлення	ɔ z n ɛ j ɔ m ɫ ɪ nʲ ɛ
ізраїльтянин	i z r ɛ j i lʲ tʲ ɑ n ɪ n
побачення	p ɔ b ɑ t͡ʃ ɪ nʲ ɛ
директор	d ɪ r ɛ k t ɔ r
періодизаціям	p ɪ rʲ i ɔ d ɪ z ɑ t͡sʲ i j ɛ m
віяти	ʋ i j ɛ t ɪ
підвіконня	p i dʲ ʋ i k ɔ nʲ ɛ
тирана	t ɪ r ɑ n ɛ
багато	b ɛ ɦ ɑ t ɔ
співробітництво	sʲ p i u r ɔ b i t n ɪ t͡s t ʋ ɔ
азербайджанський	ɛ z ɪ r b ɛ i d͡ʒ ɑ nʲ sʲ k ɪ i
підтримати	p i d t r ɪ m ɛ t ɪ
давати	d ɛ ʋ ɑ t ɪ
десерт	d ɪ s ɛ r t
заколот	z ɑ k ɔ ɫ ɔ t
умисний	u m ɪ s n ɪ i
коливання	k ɔ ɫ ɪ ʋ ɑ nʲ ɛ
вступати	ʋ s t u p ɑ t ɪ
весь	ʋ ɛ sʲ
друг	d r u ɦ
козакові	k ɔ z ɛ k ɔ ʋ i
вичерпувати	ʋ ɪ t͡ʃ ɛ r p u ʋ ɛ t ɪ
сестрицею	s ɪ s t r ɪ t͡s ɪ j u
конкурс	k ɔ n k u r s
постатях	p ɔ s t ɛ tʲ ɛ x
психолог	p s ɪ x ɔ ɫ ɔ ɦ
плавець	p ɫ ɛ ʋ ɛ t͡sʲ
уста	u s t ɑ
навичка	n ɑ ʋ ɪ t͡ʃ k ɛ
пінний	p i n ɪ i
португальський	p ɔ r t u ɦ ɑ lʲ sʲ k ɪ i
подібність	p ɔ dʲ i b nʲ i sʲ tʲ
туркменістан	t u r k m ɪ nʲ i s t ɑ n
глава	ɦ ɫ ɛ ʋ ɑ
фотографії	f ɔ t ɔ ɦ r ɑ f i j i
отруйний	ɔ t r u i n ɪ i
конкретний	k ɔ n k r ɛ t n ɪ i
курбико	k u r b ɪ k ɔ
виконання	ʋ ɪ k ɔ n ɑ nʲ ɛ
федорович	f ɪ d ɔ r ɔ ʋ ɪ t͡ʃ
був	b u u
білоруський	b i ɫ ɔ r u sʲ k ɪ i
орнітологія	ɔ r nʲ i t ɔ ɫ ɔ ɦ i j ɛ
забруднення	z ɛ b r u d n ɪ nʲ ɛ
чайна	t͡ʃ ɛ i n ɑ
інфекціям	i n f ɛ k t͡sʲ i j ɛ m
вежа	ʋ ɛ ʒ ɛ
багатий	b ɛ ɦ ɑ t ɪ i
сукнях	s u k nʲ ɛ x
гірший	ɦ i r ʃ ɪ i
кубинець	k u b ɪ n ɪ t͡sʲ
товариство	t ɔ ʋ ɛ r ɪ s t ʋ ɔ
його	j ɔ ɦ ɔ
призначення	p r ɪ z n ɑ t͡ʃ ɪ nʲ ɛ
грудень	ɦ r u d ɪ nʲ
переривати	p ɪ r ɪ r ɪ ʋ ɑ t ɪ
авіадивізія	ɛ ʋ i ɛ d ɪ ʋ i zʲ i j ɛ
город	ɦ ɔ r ɔ d
зоологія	z ɔ ɔ ɫ ɔ ɦ i j ɛ
забрало	z ɛ b r ɑ ɫ ɔ
м'яч	m j ɑ t͡ʃ
судинний	s u d ɪ n ɪ i
периферія	p ɪ r ɪ f ɪ rʲ i j ɛ
принести	p r ɪ n ɪ s t ɪ
втілювати	ʋ tʲ i lʲ u ʋ ɛ t ɪ
ураження	u r ɑ ʒ ɪ nʲ ɛ
виключати	ʋ ɪ k lʲ u t͡ʃ ɑ t ɪ
незадоволення	n ɪ z ɛ d ɔ ʋ ɔ ɫ ɪ nʲ ɛ
трибунал	t r ɪ b u n ɑ ɫ
пришви	p r ɪ ʃ ʋ ɪ
спір	sʲ p i r
українською	u k r ɛ j i nʲ sʲ k ɔ j u
бюрократка	b u r ɔ k r ɑ t k ɛ
лекції	ɫ ɛ k t͡sʲ i j i
ковдра	k ɔ u d r ɛ
жовч	ʒ ɔ u t͡ʃ
така	t ɛ k ɑ
корабел	k ɔ r ɛ b ɛ ɫ
безжурний	b ɪ ʒ u r n ɪ i
екваторіальний	ɪ k ʋ ɛ t ɔ rʲ i ɑ lʲ n ɪ i
недосвідчений	n ɪ d ɔ sʲ ʋ i d͡ʒ t͡ʃ ɪ n ɪ i
парламент	p ɛ r ɫ ɑ m ɪ n t
злочинець	z ɫ ɔ t͡ʃ ɪ n ɪ t͡sʲ
винокур	ʋ ɪ n ɔ k u r
горизонтальний	ɦ ɔ r ɪ z ɔ n t ɑ lʲ n ɪ i
бутерброд	b u t ɪ r b r ɔ d
акул	ɛ k u ɫ
взірцевий	ʋ zʲ i r t͡s ɛ ʋ ɪ i
позбутися	p ɔ z b u t ɪ sʲ ɛ
ватру	ʋ ɑ t r u
родовий	r ɔ d ɔ ʋ ɪ i
співпереживання	sʲ p i u p ɪ r ɪ ʒ ɪ ʋ ɑ nʲ ɛ
безготівковий	b ɪ z ɦ ɔ tʲ i u k ɔ ʋ ɪ i
смак	s m ɑ k
місяць	m i sʲ ɛ t͡sʲ
напередодні	n ɛ p ɪ r ɪ d ɔ dʲ nʲ i
олігархія	ɔ lʲ i ɦ ɑ r x i j ɛ
схильний	s x ɪ lʲ n ɪ i
одержувача	ɔ d ɛ r ʒ u ʋ ɛ t͡ʃ ɛ
медуза	m ɪ d u z ɛ
возити	ʋ ɔ z ɪ t ɪ
негативний	n ɪ ɦ ɛ t ɪ u n ɪ i
горизонтові	ɦ ɔ r ɪ z ɔ n t ɔ ʋ i
кіно	k i n ɔ
йогурт	j ɔ ɦ u r t
викрутка	ʋ ɪ k r u t k ɛ
бруднити	b r u d n ɪ t ɪ
програма	p r ɔ ɦ r ɑ m ɛ
привабити	p r ɪ ʋ ɑ b ɪ t ɪ
недоступний	n ɪ d ɔ s t u p n ɪ i
стабілізувати	s t ɛ b i lʲ i z u ʋ ɑ t ɪ
темниця	t ɪ m n ɪ t͡sʲ ɛ
архієпископ	ɛ r x i j ɪ p ɪ s k ɔ p
оподаткувати	ɔ p ɔ d ɛ t k u ʋ ɑ t ɪ
сюди	sʲ u d ɪ
підписувати	p i d p ɪ s u ʋ ɛ t ɪ
всесвітньо	ʋ s ɪ sʲ ʋ i tʲ nʲ ɔ
нетерплячий	n ɪ t ɪ r p lʲ ɑ t͡ʃ ɪ i
компетентний	k ɔ m p ɪ t ɛ n t n ɪ i
кохання	k ɔ x ɑ nʲ ɛ
здогадуватися	z d ɔ ɦ ɑ d u ʋ ɛ t ɪ sʲ ɛ
копито	k ɔ p ɪ t ɔ
абразія	ɛ b r ɑ zʲ i j ɛ
анатомія	ɛ n ɛ t ɔ m i j ɛ
референдумами	r ɪ f ɪ r ɛ n d u m ɛ m ɪ
блокадою	b ɫ ɔ k ɑ d ɔ j u
петиція	p ɪ t ɪ t͡sʲ i j ɛ
індексувати	i n d ɪ k s u ʋ ɑ t ɪ
піхва	p i x ʋ ɛ
єпископ	j ɪ p ɪ s k ɔ p
суддя	s u dʲ ɑ
багатолюдний	b ɛ ɦ ɛ t ɔ lʲ u d n ɪ i
заряджати	z ɛ rʲ ɛ d͡ʒ ɑ t ɪ
суб'єкт	s u b j ɛ k t
спитати	s p ɪ t ɑ t ɪ
світогляд	sʲ ʋ i t ɔ ɦ lʲ ɛ d
ситуаціями	s ɪ t u ɑ t͡sʲ i j ɛ m ɪ
еякуляція	ɪ j ɛ k u lʲ ɑ t͡sʲ i j ɛ
доброта	d ɔ b r ɔ t ɑ
тисячоліттями	t ɪ sʲ ɛ t͡ʃ ɔ lʲ i tʲ ɛ m ɪ
смітник	sʲ m i t n ɪ k
склянка	s k lʲ ɑ n k ɛ
шовковиця	ʃ ɔ u k ɔ ʋ ɪ t͡sʲ ɛ
йти	i t ɪ
метри	m ɛ t r ɪ
нижчий	n ɪ ʒ t͡ʃ ɪ i
повертати	p ɔ ʋ ɪ r t ɑ t ɪ
цінність	t͡sʲ i nʲ i sʲ tʲ
ментовка	m ɪ n t ɔ u k ɛ
навруз	n ɛ u r u z
технократичний	t ɪ x n ɔ k r ɛ t ɪ t͡ʃ n ɪ i
книгарня	k n ɪ ɦ ɑ r nʲ ɛ
авіамоделізм	ɛ ʋ i ɛ m ɔ d ɪ lʲ i z m
вирішення	ʋ ɪ rʲ i ʃ ɪ nʲ ɛ
зара	z ɑ r ɛ
місіонер	m i sʲ i ɔ n ɛ r
молоття	m ɔ ɫ ɔ tʲ ɑ
загальновідомий	z ɛ ɦ ɛ lʲ n ɔ ʋ i d ɔ m ɪ i
авіабаза	ɛ ʋ i ɛ b ɑ z ɛ
християнський	x r ɪ s t ɪ j ɑ nʲ sʲ k ɪ i
чарівник	t͡ʃ ɛ rʲ i u n ɪ k
дислокація	d ɪ s ɫ ɔ k ɑ t͡sʲ i j ɛ
вівторок	ʋ i u t ɔ r ɔ k
родзинки	r ɔ d͡z ɪ n k ɪ
генерувати	ɦ ɪ n ɪ r u ʋ ɑ t ɪ
худий	x u d ɪ i
ґудзик	ɡ u d͡z ɪ k
минулий	m ɪ n u ɫ ɪ i
тілі	tʲ i lʲ i
перетворювати	p ɪ r ɪ t ʋ ɔ rʲ u ʋ ɛ t ɪ
відображати	ʋ i d ɔ b r ɛ ʒ ɑ t ɪ
портфеля	p ɔ r t f ɛ lʲ ɛ
патентувати	p ɛ t ɪ n t u ʋ ɑ t ɪ
осердя	ɔ s ɛ r dʲ ɛ
свояк	s ʋ ɔ j ɑ k
богослів'я	b ɔ ɦ ɔ sʲ lʲ i ʋ j ɛ
антибіотики	ɛ n t ɪ b i ɔ t ɪ k ɪ
все	ʋ s ɛ
угорець	u ɦ ɔ r ɪ t͡sʲ
приманювати	p r ɪ m ɑ nʲ u ʋ ɛ t ɪ
вікторія	ʋ i k t ɔ rʲ i j ɛ
ензим	ɪ n z ɪ m
танцюристки	t ɛ nʲ t͡sʲ u r ɪ s t k ɪ
сполучник	s p ɔ ɫ u t͡ʃ n ɪ k
блокаді	b ɫ ɔ k ɑ dʲ i
наркотичний	n ɛ r k ɔ t ɪ t͡ʃ n ɪ i
імператриця	i m p ɪ r ɛ t r ɪ t͡sʲ ɛ
тож	t ɔ ʒ
салат	s ɛ ɫ ɑ t
лотерея	ɫ ɔ t ɪ r ɛ j ɛ
токар	t ɔ k ɛ r
делегатка	d ɪ ɫ ɪ ɦ ɑ t k ɛ
дисертацію	d ɪ s ɪ r t ɑ t͡sʲ i j u
тієї	tʲ i j ɛ j i
доречний	d ɔ r ɛ t͡ʃ n ɪ i
познань	p ɔ z n ɛ nʲ
інерцією	i n ɛ r t͡sʲ i j ɪ j u
самодостатній	s ɛ m ɔ d ɔ s t ɑ tʲ nʲ i i
апарат	ɛ p ɛ r ɑ t
атеїстичний	ɛ t ɪ j i s t ɪ t͡ʃ n ɪ i
важливий	ʋ ɛ ʒ ɫ ɪ ʋ ɪ i
шкіру	ʃ k i r u
скаржитися	s k ɑ r ʒ ɪ t ɪ sʲ ɛ
ненароджений	n ɪ n ɛ r ɔ d͡ʒ ɪ n ɪ i
зайвий	z ɑ j ʋ ɪ i
філіжанка	f i lʲ i ʒ ɑ n k ɛ
головний	ɦ ɔ ɫ ɔ u n ɪ i
авіабензин	ɛ ʋ i ɛ b ɪ n z ɪ n
вівтарний	ʋ i u t ɛ r n ɪ i
прогнозів	p r ɔ ɦ n ɔ zʲ i u
дешевший	d ɪ ʃ ɛ u ʃ ɪ i
ватрушка	ʋ ɛ t r u ʃ k ɛ
характерний	x ɛ r ɛ k t ɛ r n ɪ i
розорений	r ɔ z ɔ r ɪ n ɪ i
галстук	ɦ ɑ ɫ s t u k
прабабуся	p r ɛ b ɛ b u sʲ ɛ
посталий	p ɔ s t ɑ ɫ ɪ i
зібратися	zʲ i b r ɑ t ɪ sʲ ɛ
період	p ɪ rʲ i ɔ d
рукою	r u k ɔ j u
школи	ʃ k ɔ ɫ ɪ
розпізнавання	r ɔ zʲ p i z n ɛ ʋ ɑ nʲ ɛ
кобальт	k ɔ b ɛ lʲ t
белград	b ɪ ɫ ɦ r ɑ d
трагедіє	t r ɛ ɦ ɛ dʲ i j ɪ
внесок	ʋ n ɛ s ɔ k
фінляндія	f i nʲ lʲ ɑ nʲ dʲ i j ɛ
сова	s ɔ ʋ ɑ
біднота	b i d n ɔ t ɛ
ідеалізм	i d ɪ ɛ lʲ i z m
родзинка	r ɔ d͡z ɪ n k ɛ
авансоутримувач	ɛ ʋ ɛ n s ɔ u t r ɪ m u ʋ ɛ t͡ʃ
погрожувати	p ɔ ɦ r ɔ ʒ u ʋ ɛ t ɪ
для	dʲ lʲ ɑ
морський	m ɔ r sʲ k ɪ i
парашутизм	p ɛ r ɛ ʃ u t ɪ z m
спричинювати	s p r ɪ t͡ʃ ɪ nʲ u ʋ ɛ t ɪ
уособлювати	u ɔ s ɔ b lʲ u ʋ ɛ t ɪ
абулія	ɛ b u lʲ i j ɛ
карликовий	k ɑ r ɫ ɪ k ɔ ʋ ɪ i
звук	z ʋ u k
широкомасштабний	ʃ ɪ r ɔ k ɔ m ɛ ʃ t ɑ b n ɪ i
фрагменти	f r ɛ ɦ m ɛ n t ɪ
негативно	n ɪ ɦ ɛ t ɪ u n ɔ
безтурботний	b ɪ z t u r b ɔ t n ɪ i
ґанок	ɡ ɑ n ɔ k
зоомагазин	z ɔ ɔ m ɛ ɦ ɛ z ɪ n
асимптота	ɛ s ɪ m p t ɔ t ɛ
ягода	j ɑ ɦ ɔ d ɛ
конотоп	k ɔ n ɔ t ɔ p
гель	ɦ ɛ lʲ
колись	k ɔ ɫ ɪ sʲ
забруднювати	z ɛ b r u dʲ nʲ u ʋ ɛ t ɪ
капуста	k ɛ p u s t ɛ
колонія	k ɔ ɫ ɔ nʲ i j ɛ
психологія	p s ɪ x ɔ ɫ ɔ ɦ i j ɛ
цап	t͡s ɑ p
скарб	s k ɑ r b
життєздатний	ʒ ɪ tʲ ɪ z d ɑ t n ɪ i
ламати	ɫ ɛ m ɑ t ɪ
підготовка	p i d ɦ ɔ t ɔ u k ɛ
покупець	p ɔ k u p ɛ t͡sʲ
воєнний	ʋ ɔ j ɛ n ɪ i
дебютувати	d ɪ b u t u ʋ ɑ t ɪ
численний	t͡ʃ ɪ s ɫ ɛ n ɪ i
оцією	ɔ t͡sʲ i j ɛ j u
домашнє	d ɔ m ɑ ʃ nʲ ɪ
давай	d ɛ ʋ ɑ i
зателефонувати	z ɛ t ɪ ɫ ɪ f ɔ n u ʋ ɑ t ɪ
синочок	s ɪ n ɔ t͡ʃ ɔ k
альбатрос	ɛ lʲ b ɛ t r ɔ s
психіка	p s ɪ x i k ɛ
несподіваний	n ɪ s p ɔ dʲ i ʋ ɛ n ɪ i
страхіття	s t r ɛ x i tʲ ɛ
східний	sʲ x i d n ɪ i
бельгійський	b ɪ lʲ ɦ i i sʲ k ɪ i
серце	s ɛ r t͡s ɪ
михайло	m ɪ x ɑ i ɫ ɔ
токсикологічний	t ɔ k s ɪ k ɔ ɫ ɔ ɦ i t͡ʃ n ɪ i
помста	p ɔ m s t ɛ
кораблебудівник	k ɔ r ɛ b ɫ ɪ b u dʲ i u n ɪ k
легеня	ɫ ɪ ɦ ɛ nʲ ɛ
матрьошка	m ɛ tʲ rʲ ɔ ʃ k ɛ
приємність	p r ɪ j ɛ m nʲ i sʲ tʲ
спора	s p ɔ r ɛ
культурний	k u lʲ t u r n ɪ i
власна	ʋ ɫ ɑ s n ɛ
шовковий	ʃ ɔ u k ɔ ʋ ɪ i
дорогий	d ɔ r ɔ ɦ ɪ i
шибеницями	ʃ ɪ b ɪ n ɪ t͡sʲ ɛ m ɪ
мокнути	m ɔ k n u t ɪ
сторож	s t ɔ r ɔ ʒ
пропорціям	p r ɔ p ɔ r t͡sʲ i j ɛ m
шестигранник	ʃ ɪ s t ɪ ɦ r ɑ n ɪ k
канадієць	k ɛ n ɛ dʲ i j ɪ t͡sʲ
ампер	ɛ m p ɛ r
панікерство	p ɛ nʲ i k ɛ r s t ʋ ɔ
іграшка	i ɦ r ɛ ʃ k ɛ
проблема	p r ɔ b ɫ ɛ m ɛ
житній	ʒ ɪ tʲ nʲ i i
постачати	p ɔ s t ɛ t͡ʃ ɑ t ɪ
бісексуал	b i s ɪ k s u ɑ ɫ
уникнути	u n ɪ k n u t ɪ
безнадійний	b ɪ z n ɛ dʲ i i n ɪ i
дровця	d r ɔ u t͡sʲ ɑ
крим	k r ɪ m
катастрофами	k ɛ t ɛ s t r ɔ f ɛ m ɪ
блокадами	b ɫ ɔ k ɑ d ɛ m ɪ
авіамаяк	ɛ ʋ i ɛ m ɛ j ɑ k
населити	n ɛ s ɪ ɫ ɪ t ɪ
трагедія	t r ɛ ɦ ɛ dʲ i j ɛ
клавіатурах	k ɫ ɛ ʋ i ɛ t u r ɛ x
термін	t ɛ r m i n
відсвяткувати	ʋ i d͡z sʲ ʋ ɛ t k u ʋ ɑ t ɪ
коса	k ɔ s ɑ
зворотний	z ʋ ɔ r ɔ t n ɪ i
інтуїтивно	i n t u j i t ɪ u n ɔ
чабер	t͡ʃ ɛ b ɛ r
ворота	ʋ ɔ r ɔ t ɛ
стакан	s t ɛ k ɑ n
гідравлічний	ɦ i d r ɛ u lʲ i t͡ʃ n ɪ i
сміх	sʲ m i x
літопис	lʲ i t ɔ p ɪ s
трагічний	t r ɛ ɦ i t͡ʃ n ɪ i
дивізіям	d ɪ ʋ i zʲ i j ɛ m
від'їбатися	ʋ i d j i b ɑ t ɪ sʲ ɛ
зірка	zʲ i r k ɛ
празник	p r ɑ z n ɪ k
ємен	j ɛ m ɪ n
соціальний	s ɔ t͡sʲ i ɑ lʲ n ɪ i
армія	ɑ r m i j ɛ
смерека	s m ɪ r ɛ k ɛ
втратити	ʋ t r ɑ t ɪ t ɪ
дебіл	d ɪ b i ɫ
монастир	m ɔ n ɛ s t ɪ r
календарем	k ɛ ɫ ɪ n d ɛ r ɛ m
кобальтовий	k ɔ b ɛ lʲ t ɔ ʋ ɪ i
інциденти	i n t͡s ɪ d ɛ n t ɪ
органів	ɔ r ɦ ɛ nʲ i u
льотчик	lʲ ɔ tʃ ɪ k
корисність	k ɔ r ɪ sʲ nʲ i sʲ tʲ
фабрика	f ɑ b r ɪ k ɛ
кухонний	k u x ɔ n ɪ i
бактерія	b ɛ k t ɛ rʲ i j ɛ
даремність	d ɛ r ɛ m nʲ i sʲ tʲ
кіт	k i t
тонкий	t ɔ n k ɪ i
спостерегти	s p ɔ s t ɪ r ɪ ɦ t ɪ
албанка	ɛ ɫ b ɑ n k ɛ
чиновниця	t͡ʃ ɪ n ɔ u n ɪ t͡sʲ ɛ
виглядати	ʋ ɪ ɦ lʲ ɛ d ɑ t ɪ
пестицид	p ɪ s t ɪ t͡s ɪ d
голодомор	ɦ ɔ ɫ ɔ d ɔ m ɔ r
славити	s ɫ ɑ ʋ ɪ t ɪ
докторат	d ɔ k t ɔ r ɑ t
знак	z n ɑ k
започаткувати	z ɛ p ɔ t͡ʃ ɛ t k u ʋ ɑ t ɪ
розв'язувати	r ɔ z ʋ j ɑ z u ʋ ɛ t ɪ
мандрувати	m ɛ n d r u ʋ ɑ t ɪ
олівець	ɔ lʲ i ʋ ɛ t͡sʲ
п'ятнадцятий	p j ɛ t n ɑ d͡zʲ t͡sʲ ɛ t ɪ i
вторгатися	ʋ t ɔ r ɦ ɑ t ɪ sʲ ɛ
найнижчий	n ɛ i n ɪ ʒ t͡ʃ ɪ i
діагностувати	dʲ i ɛ ɦ n ɔ s t u ʋ ɑ t ɪ
поняття	p ɔ nʲ ɑ tʲ ɛ
щиколотка	ʃ t͡ʃ ɪ k ɔ ɫ ɔ t k ɛ
переконати	p ɪ r ɪ k ɔ n ɑ t ɪ
фразеологічний	f r ɛ z ɪ ɔ ɫ ɔ ɦ i t͡ʃ n ɪ i
м'язові	m j ɑ z ɔ ʋ i
німа	nʲ i m ɑ
недільний	n ɪ dʲ i lʲ n ɪ i
акція	ɑ k t͡sʲ i j ɛ
вус	ʋ u s
активувати	ɛ k t ɪ ʋ u ʋ ɑ t ɪ
погуляти	p ɔ ɦ u lʲ ɑ t ɪ
родина	r ɔ d ɪ n ɛ
переддень	p ɪ r ɪ d ɛ nʲ
стілець	sʲ tʲ i ɫ ɛ t͡sʲ
гладіатор	ɦ ɫ ɛ dʲ i ɑ t ɔ r
щиколотки	ʃ t͡ʃ ɪ k ɔ ɫ ɔ t k ɪ
валець	ʋ ɛ ɫ ɛ t͡sʲ
молдавія	m ɔ ɫ d ɑ ʋ i j ɛ
парші	p ɑ r ʃ i
яничар	j ɛ n ɪ t͡ʃ ɑ r
компактний	k ɔ m p ɑ k t n ɪ i
акцентувати	ɛ k t͡s ɪ n t u ʋ ɑ t ɪ
спідницею	sʲ p i d n ɪ t͡s ɪ j u
ґринджоли	ɡ r ɪ n d͡ʒ ɔ ɫ ɪ
тощо	t ɔ ʃ t͡ʃ ɔ
перукарня	p ɪ r u k ɑ r nʲ ɛ
громико	ɦ r ɔ m ɪ k ɔ
гіперактивний	ɦ i p ɪ r ɛ k t ɪ u n ɪ i
чий	t͡ʃ ɪ i
марта	m ɑ r t ɛ
срібний	sʲ rʲ i b n ɪ i
вади	ʋ ɑ d ɪ
арахнологіє	ɛ r ɛ x n ɔ ɫ ɔ ɦ i j ɪ
монохромний	m ɔ n ɔ x r ɔ m n ɪ i
перевиховати	p ɪ r ɪ ʋ ɪ x ɔ ʋ ɛ t ɪ
норвежка	n ɔ r ʋ ɛ ʒ k ɛ
гони	ɦ ɔ n ɪ
квантова	k ʋ ɑ n t ɔ ʋ ɛ
нагадувати	n ɛ ɦ ɑ d u ʋ ɛ t ɪ
перебільшити	p ɪ r ɪ b i lʲ ʃ ɪ t ɪ
впевнений	ʋ p ɛ u n ɪ n ɪ i
впізнавати	ʋ p i z n ɛ ʋ ɑ t ɪ
пропозиціями	p r ɔ p ɔ z ɪ t͡sʲ i j ɛ m ɪ
загреб	z ɑ ɦ r ɪ b
старик	s t ɛ r ɪ k
утомлений	u t ɔ m ɫ ɪ n ɪ i
авантура	ɛ ʋ ɛ n t u r ɛ
картопля	k ɛ r t ɔ p lʲ ɛ
хлопчик	x ɫ ɔ p t͡ʃ ɪ k
непохитний	n ɪ p ɔ x ɪ t n ɪ i
застуджуватися	z ɛ s t u d͡ʒ u ʋ ɛ t ɪ sʲ ɛ
киплячий	k ɪ p lʲ ɑ t͡ʃ ɪ i
стимул	s t ɪ m u ɫ
молоти	m ɔ ɫ ɔ t ɪ
ик	ɪ k
противник	p r ɔ t ɪ u n ɪ k
взірець	ʋ zʲ i r ɛ t͡sʲ
плутократію	p ɫ u t ɔ k r ɑ tʲ i j u
особа	ɔ s ɔ b ɛ
таліях	t ɑ lʲ i j ɛ x
варіантові	ʋ ɛ rʲ i ɑ n t ɔ ʋ i
розглянути	r ɔ z ɦ lʲ ɑ n u t ɪ
територіальна	t ɪ r ɪ t ɔ rʲ i ɑ lʲ n ɛ
брамо	b r ɑ m ɔ
кість	k i sʲ tʲ
воротар	ʋ ɔ r ɔ t ɑ r
емігрувати	ɪ m i ɦ r u ʋ ɑ t ɪ
невидимий	n ɪ ʋ ɪ d ɪ m ɪ i
перевага	p ɪ r ɪ ʋ ɑ ɦ ɛ
затвердити	z ɛ t ʋ ɛ r d ɪ t ɪ
опубліковувати	ɔ p u b lʲ i k ɔ ʋ u ʋ ɛ t ɪ
рот	r ɔ t
задоволення	z ɛ d ɔ ʋ ɔ ɫ ɪ nʲ ɛ
українофоб	u k r ɛ j i n ɔ f ɔ b
монополіст	m ɔ n ɔ p ɔ lʲ i s t
соловейко	s ɔ ɫ ɔ ʋ ɛ i k ɔ
загальнонаціональний	z ɛ ɦ ɛ lʲ n ɔ n ɛ t͡sʲ i ɔ n ɑ lʲ n ɪ i
емоціє	ɪ m ɔ t͡sʲ i j ɪ
печивам	p ɛ t͡ʃ ɪ ʋ ɛ m
індустріалізувати	i n d u s tʲ rʲ i ɛ lʲ i z u ʋ ɑ t ɪ
заручати	z ɛ r u t͡ʃ ɑ t ɪ
правителька	p r ɛ ʋ ɪ t ɪ lʲ k ɛ
повставати	p ɔ u s t ɛ ʋ ɑ t ɪ
пацюк	p ɛ t͡sʲ u k
повідомлення	p ɔ ʋ i d ɔ m ɫ ɪ nʲ ɛ
скребти	s k r ɪ b t ɪ
метелик	m ɪ t ɛ ɫ ɪ k
гуляти	ɦ u lʲ ɑ t ɪ
райдуга	r ɑ i d u ɦ ɛ
виявитися	ʋ ɪ j ɛ ʋ ɪ t ɪ sʲ ɛ
пропозиції	p r ɔ p ɔ z ɪ t͡sʲ i j i
невідворотний	n ɪ ʋ i d ʋ ɔ r ɔ t n ɪ i
бонусами	b ɔ n u s ɛ m ɪ
штандарт	ʃ t ɛ n d ɑ r t
компенсація	k ɔ m p ɪ n s ɑ t͡sʲ i j ɛ
купальний	k u p ɑ lʲ n ɪ i
кожух	k ɔ ʒ u x
підтримувати	p i d t r ɪ m u ʋ ɛ t ɪ
візантійський	ʋ i z ɛ nʲ tʲ i i sʲ k ɪ i
проголошувати	p r ɔ ɦ ɔ ɫ ɔ ʃ u ʋ ɛ t ɪ
прекрасний	p r ɪ k r ɑ s n ɪ i
джгут	d͡ʒ ɦ u t
вигук	ʋ ɪ ɦ u k
абиколи	ɛ b ɪ k ɔ ɫ ɪ
погляд	p ɔ ɦ lʲ ɛ d
ради	r ɑ d ɪ
виріб	ʋ ɪ rʲ i b
монгольський	m ɔ n ɦ ɔ lʲ sʲ k ɪ i
сучасник	s u t͡ʃ ɑ s n ɪ k
акціонер	ɛ k t͡sʲ i ɔ n ɛ r
лівія	lʲ i ʋ i j ɛ
обмежувати	ɔ b m ɛ ʒ u ʋ ɛ t ɪ
самодержавство	s ɛ m ɔ d ɪ r ʒ ɑ u s t ʋ ɔ
функціональний	f u n k t͡sʲ i ɔ n ɑ lʲ n ɪ i
телевізійний	t ɪ ɫ ɪ ʋ i zʲ i i n ɪ i
супругою	s u p r u ɦ ɔ j u
прикро	p r ɪ k r ɔ
працівниками	p r ɛ t͡sʲ i u n ɪ k ɑ m ɪ
раніше	r ɛ nʲ i ʃ ɪ
афганістан	ɛ f ɦ ɛ nʲ i s t ɑ n
завершувати	z ɛ ʋ ɛ r ʃ u ʋ ɛ t ɪ
речення	r ɛ t͡ʃ ɪ nʲ ɛ
авгіїв	ɛ u ɦ i j i u
писар	p ɪ s ɛ r
першість	p ɛ r ʃ i sʲ tʲ
вірменія	ʋ i r m ɛ nʲ i j ɛ
природничий	p r ɪ r ɔ d n ɪ t͡ʃ ɪ i
перекладати	p ɪ r ɪ k ɫ ɛ d ɑ t ɪ
розбіжний	r ɔ zʲ b i ʒ n ɪ i
частка	t͡ʃ ɑ s t k ɛ
самостійність	s ɛ m ɔ sʲ tʲ i i nʲ i sʲ tʲ
економічний	ɪ k ɔ n ɔ m i t͡ʃ n ɪ i
просьба	p r ɔ zʲ b ɛ
мева	m ɛ ʋ ɛ
космологія	k ɔ s m ɔ ɫ ɔ ɦ i j ɛ
тисяч	t ɪ sʲ ɛ t͡ʃ
динамічно	d ɪ n ɛ m i t͡ʃ n ɔ
абатиса	ɛ b ɛ t ɪ s ɛ
мешкати	m ɛ ʃ k ɛ t ɪ
зупинятися	z u p ɪ nʲ ɑ t ɪ sʲ ɛ
використати	ʋ ɪ k ɔ r ɪ s t ɛ t ɪ
були	b u ɫ ɪ
постать	p ɔ s t ɛ tʲ
дефініцію	d ɪ f i nʲ i t͡sʲ i j u
англійка	ɛ n ɦ lʲ i i k ɛ
безглуздість	b ɪ z ɦ ɫ u zʲ dʲ i sʲ tʲ
холодно	x ɔ ɫ ɔ d n ɔ
рік	rʲ i k
вільнодумство	ʋ i lʲ n ɔ d u m s t ʋ ɔ
інтелектуальний	i n t ɪ ɫ ɪ k t u ɑ lʲ n ɪ i
каплиць	k ɛ p ɫ ɪ t͡sʲ
хімічний	x i m i t͡ʃ n ɪ i
споживач	s p ɔ ʒ ɪ ʋ ɑ t͡ʃ
корисний	k ɔ r ɪ s n ɪ i
декларативний	d ɪ k ɫ ɛ r ɛ t ɪ u n ɪ i
багатолітній	b ɛ ɦ ɛ t ɔ lʲ i tʲ nʲ i i
націоналістичний	n ɛ t͡sʲ i ɔ n ɛ lʲ i s t ɪ t͡ʃ n ɪ i
зоровий	z ɔ r ɔ ʋ ɪ i
мимоволі	m ɪ m ɔ ʋ ɔ lʲ i
фактично	f ɛ k t ɪ t͡ʃ n ɔ
відпочинок	ʋ i d p ɔ t͡ʃ ɪ n ɔ k
віртуальний	ʋ i r t u ɑ lʲ n ɪ i
сусідній	s u sʲ i dʲ nʲ i i
християнство	x r ɪ s t ɪ j ɑ n s t ʋ ɔ
слух	s ɫ u x
пісня	p i sʲ nʲ ɛ
формулювати	f ɔ r m u lʲ u ʋ ɑ t ɪ
рацію	r ɑ t͡sʲ i j u
працівником	p r ɛ t͡sʲ i u n ɪ k ɔ m
фінляндський	f i nʲ lʲ ɑ n d͡zʲ sʲ k ɪ i
відень	ʋ i d ɪ nʲ
внука	ʋ n u k ɛ
фізіологічний	f i zʲ i ɔ ɫ ɔ ɦ i t͡ʃ n ɪ i
заяць	z ɑ j ɛ t͡sʲ
когут	k ɔ ɦ u t
скроні	s k r ɔ nʲ i
корупція	k ɔ r u p t͡sʲ i j ɛ
феях	f ɛ j ɛ x
тлумачити	t ɫ u m ɑ t͡ʃ ɪ t ɪ
конфлікт	k ɔ n f lʲ i k t
кінчик	k i n t͡ʃ ɪ k
істина	i s t ɪ n ɛ
автовакцина	ɛ u t ɔ ʋ ɛ k t͡s ɪ n ɛ
мене	m ɪ n ɛ
восьмисот	ʋ ɔ sʲ m ɪ s ɔ t
репресивний	r ɪ p r ɪ s ɪ u n ɪ i
трав'яний	t r ɛ ʋ j ɛ n ɪ i
нього	nʲ ɔ ɦ ɔ
так	t ɑ k
літературний	lʲ i t ɪ r ɛ t u r n ɪ i
вітебськ	ʋ i t ɪ b sʲ k
стрічки	s tʲ rʲ i t͡ʃ k ɪ
нутрощі	n u t r ɔ ʃ t͡ʃʲ i
календарів	k ɛ ɫ ɪ n d ɛ rʲ i u
рейтузи	r ɪ i t u z ɪ
диспетчер	d ɪ s p ɛ tʃ ɪ r
дивізій	d ɪ ʋ i zʲ i i
установити	u s t ɛ n ɔ ʋ ɪ t ɪ
реєстрація	r ɪ j ɪ s t r ɑ t͡sʲ i j ɛ
кончина	k ɔ n t͡ʃ ɪ n ɛ
ізумрудний	i z u m r u d n ɪ i
автобусний	ɛ u t ɔ b u s n ɪ i
санкціонувати	s ɛ n k t͡sʲ i ɔ n u ʋ ɑ t ɪ
підлогу	p i d ɫ ɔ ɦ u
абсурдність	ɛ b s u r dʲ nʲ i sʲ tʲ
виразно	ʋ ɪ r ɑ z n ɔ
доброзичливиця	d ɔ b r ɔ z ɪ t͡ʃ ɫ ɪ ʋ ɪ t͡sʲ ɛ
позиція	p ɔ z ɪ t͡sʲ i j ɛ
паровоз	p ɛ r ɔ ʋ ɔ z
промокнути	p r ɔ m ɔ k n u t ɪ
внучка	ʋ n u t͡ʃ k ɛ
мід	m i d
артеріях	ɛ r t ɛ rʲ i j ɛ x
туреччина	t u r ɛ tʃ ɪ n ɛ
гендер	ɦ ɛ n d ɪ r
важко	ʋ ɑ ʒ k ɔ
посуд	p ɔ s u d
комбінація	k ɔ m b i n ɑ t͡sʲ i j ɛ
печив	p ɛ t͡ʃ ɪ u
незалежности	n ɪ z ɛ ɫ ɛ ʒ n ɔ s t ɪ
перевантаженість	p ɪ r ɪ ʋ ɛ n t ɑ ʒ ɪ nʲ i sʲ tʲ
виживати	ʋ ɪ ʒ ɪ ʋ ɑ t ɪ
допустити	d ɔ p u s t ɪ t ɪ
херсон	x ɪ r s ɔ n
вираз	ʋ ɪ r ɛ z
булава	b u ɫ ɛ ʋ ɑ
неформальний	n ɪ f ɔ r m ɑ lʲ n ɪ i
вищий	ʋ ɪ ʃ t͡ʃ ɪ i
феє	f ɛ j ɪ
абрикосник	ɛ b r ɪ k ɔ s n ɪ k
грішний	ɦ rʲ i ʃ n ɪ i
молекулярна	m ɔ ɫ ɪ k u lʲ ɑ r n ɛ
намібія	n ɛ m i b i j ɛ
передчасний	p ɪ r ɪ d͡ʒ t͡ʃ ɑ s n ɪ i
хронологія	x r ɔ n ɔ ɫ ɔ ɦ i j ɛ
металург	m ɪ t ɛ ɫ u r ɦ
сімсот	sʲ i m s ɔ t
патологічний	p ɛ t ɔ ɫ ɔ ɦ i t͡ʃ n ɪ i
діалог	dʲ i ɛ ɫ ɔ ɦ
еволюціонувати	ɪ ʋ ɔ lʲ u t͡sʲ i ɔ n u ʋ ɑ t ɪ
дев'яностий	d ɪ ʋ j ɛ n ɔ s t ɪ i
абсорбування	ɛ b s ɔ r b u ʋ ɑ nʲ ɛ
енциклопедист	ɪ n t͡s ɪ k ɫ ɔ p ɪ d ɪ s t
щокою	ʃ t͡ʃ ɔ k ɔ j u
руку	r u k u
жасмин	ʒ ɛ s m ɪ n
біологія	b i ɔ ɫ ɔ ɦ i j ɛ
неправду	n ɪ p r ɑ u d u
закінчення	z ɛ k i n t͡ʃ ɪ nʲ ɛ
завдання	z ɛ u d ɑ nʲ ɛ
інколи	i n k ɔ ɫ ɪ
сльозогінний	sʲ lʲ ɔ z ɔ ɦ i n ɪ i
вибрати	ʋ ɪ b r ɛ t ɪ
перевищувати	p ɪ r ɪ ʋ ɪ ʃ t͡ʃ u ʋ ɛ t ɪ
покій	p ɔ k i i
зимовий	z ɪ m ɔ ʋ ɪ i
зазначити	z ɛ z n ɛ t͡ʃ ɪ t ɪ
легеневий	ɫ ɪ ɦ ɪ n ɛ ʋ ɪ i
брак	b r ɑ k
двоповерховий	d ʋ ɔ p ɔ ʋ ɪ r x ɔ ʋ ɪ i
очиці	ɔ t͡ʃ ɪ t͡sʲ i
таліям	t ɑ lʲ i j ɛ m
гранатомет	ɦ r ɛ n ɛ t ɔ m ɛ t
масть	m ɑ sʲ tʲ
поєднання	p ɔ j ɪ d n ɑ nʲ ɛ
макові	m ɑ k ɔ ʋ i
мужність	m u ʒ nʲ i sʲ tʲ
ті	tʲ i
продуктивність	p r ɔ d u k t ɪ u nʲ i sʲ tʲ
очолити	ɔ t͡ʃ ɔ ɫ ɪ t ɪ
тісний	tʲ i s n ɪ i
зазначати	z ɛ z n ɛ t͡ʃ ɑ t ɪ
перевалювати	p ɪ r ɪ ʋ ɑ lʲ u ʋ ɛ t ɪ
фотографіями	f ɔ t ɔ ɦ r ɑ f i j ɛ m ɪ
фільтр	f i lʲ t r
стоматологія	s t ɔ m ɛ t ɔ ɫ ɔ ɦ i j ɛ
електрифікувати	ɪ ɫ ɪ k t r ɪ f i k u ʋ ɑ t ɪ
позбавити	p ɔ z b ɑ ʋ ɪ t ɪ
аваліст	ɛ ʋ ɛ lʲ i s t
неймовірний	n ɪ i m ɔ ʋ i r n ɪ i
неможливий	n ɪ m ɔ ʒ ɫ ɪ ʋ ɪ i
відродження	ʋ i d r ɔ d͡ʒ ɪ nʲ ɛ
інтерес	i n t ɪ r ɛ s
епох	ɪ p ɔ x
перевищити	p ɪ r ɪ ʋ ɪ ʃ t͡ʃ ɪ t ɪ
сатана	s ɛ t ɛ n ɑ
молитва	m ɔ ɫ ɪ t ʋ ɛ
артеріє	ɛ r t ɛ rʲ i j ɪ
ніс	nʲ i s
вельможа	ʋ ɪ lʲ m ɔ ʒ ɛ
пропозиція	p r ɔ p ɔ z ɪ t͡sʲ i j ɛ
прихильниця	p r ɪ x ɪ lʲ n ɪ t͡sʲ ɛ
авіапарк	ɛ ʋ i ɛ p ɑ r k
відпочилий	ʋ i d p ɔ t͡ʃ ɪ ɫ ɪ i
коротше	k ɔ r ɔ t͡ʃ ʃ ɪ
інерційний	i n ɪ r t͡sʲ i i n ɪ i
їй	j i i
ферзь	f ɛ r zʲ
кочерга	k ɔ t͡ʃ ɪ r ɦ ɑ
філософія	f i ɫ ɔ s ɔ f i j ɛ
індивідуально	i n d ɪ ʋ i d u ɑ lʲ n ɔ
руки	r u k ɪ
рівність	rʲ i u nʲ i sʲ tʲ
ворожість	ʋ ɔ r ɔ ʒʲ i sʲ tʲ
слимак	s ɫ ɪ m ɑ k
винайти	ʋ ɪ n ɛ i t ɪ
обмежень	ɔ b m ɛ ʒ ɪ nʲ
організацією	ɔ r ɦ ɛ nʲ i z ɑ t͡sʲ i j ɪ j u
нерішучість	n ɪ rʲ i ʃ u t͡ʃʲ i sʲ tʲ
прислівниковий	p r ɪ sʲ lʲ i u n ɪ k ɔ ʋ ɪ i
ресторан	r ɪ s t ɔ r ɑ n
меншина	m ɪ n ʃ ɪ n ɛ
карась	k ɛ r ɑ sʲ
втілити	ʋ tʲ i ɫ ɪ t ɪ
мелодіям	m ɪ ɫ ɔ dʲ i j ɛ m
скандинавія	s k ɛ n d ɪ n ɑ ʋ i j ɛ
селити	s ɪ ɫ ɪ t ɪ
кат	k ɑ t
забобон	z ɛ b ɔ b ɔ n
щоку	ʃ t͡ʃ ɔ k u
удосвіта	u d ɔ sʲ ʋ i t ɛ
абзац	ɛ b z ɑ t͡s
посадка	p ɔ s ɑ d k ɛ
революціонерка	r ɪ ʋ ɔ lʲ u t͡sʲ i ɔ n ɛ r k ɛ
стиль	s t ɪ lʲ
ідеалістичний	i d ɪ ɛ lʲ i s t ɪ t͡ʃ n ɪ i
долоням	d ɔ ɫ ɔ nʲ ɛ m
абандон	ɛ b ɛ n d ɔ n
генасамблея	ɦ ɪ n ɛ s ɛ m b ɫ ɛ j ɛ
привселюдний	p r ɪ u s ɪ lʲ u d n ɪ i
осінній	ɔ sʲ i nʲ i i
фільтрувати	f i lʲ t r u ʋ ɑ t ɪ
тисячоліть	t ɪ sʲ ɛ t͡ʃ ɔ lʲ i tʲ
панпсихізм	p ɛ n p s ɪ x i z m
перлина	p ɪ r ɫ ɪ n ɛ
попередній	p ɔ p ɪ r ɛ dʲ nʲ i i
покупка	p ɔ k u p k ɛ
емблематичний	ɪ m b ɫ ɪ m ɛ t ɪ t͡ʃ n ɪ i
агресивність	ɛ ɦ r ɪ s ɪ u nʲ i sʲ tʲ
русинка	r u s ɪ n k ɛ
оренда	ɔ r ɛ n d ɛ
автобальзам	ɛ u t ɔ b ɛ lʲ z ɑ m
синтезувати	s ɪ n t ɪ z u ʋ ɑ t ɪ
народитися	n ɛ r ɔ d ɪ t ɪ sʲ ɛ
трансформаціям	t r ɛ n s f ɔ r m ɑ t͡sʲ i j ɛ m
козел	k ɔ z ɛ ɫ
замовити	z ɛ m ɔ ʋ ɪ t ɪ
вугор	ʋ u ɦ ɔ r
упасти	u p ɑ s t ɪ
плуг	p ɫ u ɦ
сприйняття	s p r ɪ i nʲ ɛ tʲ ɑ
тридцять	t r ɪ d͡zʲ t͡sʲ ɛ tʲ
андріан	ɛ n dʲ rʲ i ɑ n
захворіти	z ɛ x ʋ ɔ rʲ i t ɪ
старіти	s t ɛ rʲ i t ɪ
свердловина	s ʋ ɪ r d ɫ ɔ ʋ ɪ n ɛ
вимираючий	ʋ ɪ m ɪ r ɑ j u t͡ʃ ɪ i
магніт	m ɛ ɦ nʲ i t
співрозмовник	sʲ p i u r ɔ z m ɔ u n ɪ k
тренер	t r ɛ n ɪ r
прагнення	p r ɑ ɦ n ɪ nʲ ɛ
ожина	ɔ ʒ ɪ n ɛ
лаванд	ɫ ɛ ʋ ɑ n d
сегрегація	s ɪ ɦ r ɪ ɦ ɑ t͡sʲ i j ɛ
усвідомлювати	u sʲ ʋ i d ɔ m lʲ u ʋ ɛ t ɪ
крохмаль	k r ɔ x m ɑ lʲ
крісло	k rʲ i s ɫ ɔ
чудище	t͡ʃ u d ɪ ʃ t͡ʃ ɪ
інвестувати	i n ʋ ɪ s t u ʋ ɑ t ɪ
вишити	ʋ ɪ ʃ ɪ t ɪ
петиціях	p ɪ t ɪ t͡sʲ i j ɛ x
еротика	ɪ r ɔ t ɪ k ɛ
легендарний	ɫ ɪ ɦ ɪ n d ɑ r n ɪ i
наявність	n ɛ j ɑ u nʲ i sʲ tʲ
відстояти	ʋ i d͡z s t ɔ j ɑ t ɪ
цвях	t͡sʲ ʋ ɑ x
нагромаджувати	n ɛ ɦ r ɔ m ɑ d͡ʒ u ʋ ɛ t ɪ
занотувати	z ɛ n ɔ t u ʋ ɑ t ɪ
лебідь	ɫ ɛ b i dʲ
кубічний	k u b i t͡ʃ n ɪ i
зекономити	z ɪ k ɔ n ɔ m ɪ t ɪ
залізо	z ɛ lʲ i z ɔ
знайомий	z n ɛ j ɔ m ɪ i
незалежносте	n ɪ z ɛ ɫ ɛ ʒ n ɔ s t ɪ
відвертати	ʋ i d ʋ ɪ r t ɑ t ɪ
видатний	ʋ ɪ d ɛ t n ɪ i
комедією	k ɔ m ɛ dʲ i j ɪ j u
скроням	s k r ɔ nʲ ɛ m
підприємство	p i d p r ɪ j ɛ m s t ʋ ɔ
кубанський	k u b ɑ nʲ sʲ k ɪ i
спідниці	sʲ p i d n ɪ t͡sʲ i
авіасалон	ɛ ʋ i ɛ s ɛ ɫ ɔ n
органи	ɔ r ɦ ɛ n ɪ
слухняний	s ɫ u x nʲ ɑ n ɪ i
спортсмен	s p ɔ r t͡s m ɛ n
можливий	m ɔ ʒ ɫ ɪ ʋ ɪ i
японія	j ɛ p ɔ nʲ i j ɛ
глядачка	ɦ lʲ ɛ d ɑ t͡ʃ k ɛ
білий	b i ɫ ɪ i
система	s ɪ s t ɛ m ɛ
хороший	x ɔ r ɔ ʃ ɪ i
геймплей	ɦ ɪ i m p ɫ ɛ i
безробітний	b ɪ z r ɔ b i t n ɪ i
тім	tʲ i m
лось	ɫ ɔ sʲ
обід	ɔ b i d
зобов'язання	z ɔ b ɔ ʋ j ɑ z ɛ nʲ ɛ
еякулювати	ɪ j ɛ k u lʲ u ʋ ɑ t ɪ
тацею	t ɑ t͡s ɪ j u
убогий	u b ɔ ɦ ɪ i
зад	z ɑ d
ложе	ɫ ɔ ʒ ɪ
починати	p ɔ t͡ʃ ɪ n ɑ t ɪ
абластика	ɛ b ɫ ɑ s t ɪ k ɛ
яма	j ɑ m ɛ
змусити	z m u s ɪ t ɪ
чотирьохсот	t͡ʃ ɔ t ɪ rʲ ɔ x s ɔ t
абсолютно	ɛ b s ɔ lʲ u t n ɔ
етика	ɛ t ɪ k ɛ
охороняти	ɔ x ɔ r ɔ nʲ ɑ t ɪ
інженерія	i n ʒ ɪ n ɛ rʲ i j ɛ
чемпіон	t͡ʃ ɪ m p i ɔ n
пробудження	p r ɔ b u d͡ʒ ɪ nʲ ɛ
хижак	x ɪ ʒ ɑ k
холодний	x ɔ ɫ ɔ d n ɪ i
містобудування	m i s t ɔ b u d u ʋ ɑ nʲ ɛ
централізація	t͡s ɪ n t r ɛ lʲ i z ɑ t͡sʲ i j ɛ
нестерпний	n ɪ s t ɛ r p n ɪ i
тунелях	t u n ɛ lʲ ɛ x
масштаб	m ɛ ʃ t ɑ b
п'єса	p j ɛ s ɛ
пакистан	p ɛ k ɪ s t ɑ n
оприлюднювати	ɔ p r ɪ lʲ u dʲ nʲ u ʋ ɛ t ɪ
пропорціях	p r ɔ p ɔ r t͡sʲ i j ɛ x
наркозалежний	n ɛ r k ɔ z ɛ ɫ ɛ ʒ n ɪ i
портативний	p ɔ r t ɛ t ɪ u n ɪ i
обґрунтовувати	ɔ b ɡ r u n t ɔ ʋ u ʋ ɛ t ɪ
подовження	p ɔ d ɔ u ʒ ɪ nʲ ɛ
разом	r ɑ z ɔ m
коліно	k ɔ lʲ i n ɔ
женевський	ʒ ɪ n ɛ u sʲ k ɪ i
внаслідок	ʋ n ɑ sʲ lʲ i d ɔ k
дитята	d ɪ tʲ ɑ t ɛ
абонент	ɛ b ɔ n ɛ n t
споживчий	s p ɔ ʒ ɪ u t͡ʃ ɪ i
ангольський	ɛ n ɦ ɔ lʲ sʲ k ɪ i
завойовувати	z ɛ ʋ ɔ j ɔ ʋ u ʋ ɛ t ɪ
ропуха	r ɔ p u x ɛ
абстрагованість	ɛ b s t r ɛ ɦ ɔ ʋ ɛ nʲ i sʲ tʲ
централізувати	t͡s ɪ n t r ɛ lʲ i z u ʋ ɑ t ɪ
словак	s ɫ ɔ ʋ ɑ k
референдум	r ɪ f ɪ r ɛ n d u m
вся	ʋ sʲ ɑ
ти	t ɪ
нирка	n ɪ r k ɛ
конлі	k ɔ nʲ lʲ i
безплатний	b ɪ z p ɫ ɑ t n ɪ i
рішити	rʲ i ʃ ɪ t ɪ
афаліна	ɛ f ɛ lʲ i n ɛ
заступник	z ɛ s t u p n ɪ k
слобода	s ɫ ɔ b ɔ d ɑ
район	r ɛ j ɔ n
чорниця	t͡ʃ ɔ r n ɪ t͡sʲ ɛ
дисципліна	d ɪ s t͡s ɪ p lʲ i n ɛ
захаренко	z ɛ x ɑ r ɪ n k ɔ
делегаціях	d ɪ ɫ ɪ ɦ ɑ t͡sʲ i j ɛ x
в'єтнамський	ʋ j ɪ t n ɑ m sʲ k ɪ i
авіапідживлення	ɛ ʋ i ɛ p i d͡ʒ ɪ u ɫ ɪ nʲ ɛ
пхати	p x ɑ t ɪ
паузами	p ɑ u z ɛ m ɪ
аріка	ɛ rʲ i k ɛ
користь	k ɔ r ɪ sʲ tʲ
сироватка	s ɪ r ɔ ʋ ɛ t k ɛ
одношлюбність	ɔ d n ɔ ʃ lʲ u b nʲ i sʲ tʲ
епохи	ɪ p ɔ x ɪ
систематизувати	s ɪ s t ɪ m ɛ t ɪ z u ʋ ɑ t ɪ
красний	k r ɑ s n ɪ i
заздрити	z ɑ z d r ɪ t ɪ
щука	ʃ t͡ʃ u k ɛ
королеві	k ɔ r ɔ ɫ ɛ ʋ i
модернізувати	m ɔ d ɪ r nʲ i z u ʋ ɑ t ɪ
вагання	ʋ ɛ ɦ ɑ nʲ ɛ
законодавиця	z ɛ k ɔ n ɔ d ɑ ʋ ɪ t͡sʲ ɛ
перебільшувати	p ɪ r ɪ b i lʲ ʃ u ʋ ɛ t ɪ
соловей	s ɔ ɫ ɔ ʋ ɛ i
фрустрація	f r u s t r ɑ t͡sʲ i j ɛ
відміну	ʋ i dʲ m i n u
польща	p ɔ lʲ ʃ t͡ʃ ɛ
горизонтами	ɦ ɔ r ɪ z ɔ n t ɛ m ɪ
незнання	n ɪ z n ɛ nʲ ɑ
абсурд	ɛ b s u r d
прибічниця	p r ɪ b i t͡ʃ n ɪ t͡sʲ ɛ
їжакевич	j i ʒ ɛ k ɛ ʋ ɪ t͡ʃ
кишеню	k ɪ ʃ ɛ nʲ u
виробництво	ʋ ɪ r ɔ b n ɪ t͡s t ʋ ɔ
сантиметр	s ɛ n t ɪ m ɛ t r
щонайменше	ʃ t͡ʃ ɔ n ɛ i m ɛ n ʃ ɪ
революція	r ɪ ʋ ɔ lʲ u t͡sʲ i j ɛ
істеричний	i s t ɪ r ɪ t͡ʃ n ɪ i
каплиці	k ɛ p ɫ ɪ t͡sʲ i
великодушність	ʋ ɪ ɫ ɪ k ɔ d u ʃ nʲ i sʲ tʲ
добросусідський	d ɔ b r ɔ s u sʲ i d͡zʲ sʲ k ɪ i
звернення	z ʋ ɛ r n ɪ nʲ ɛ
горище	ɦ ɔ r ɪ ʃ t͡ʃ ɪ
змагання	z m ɛ ɦ ɑ nʲ ɛ
квітень	k ʋ i t ɪ nʲ
місія	m i sʲ i j ɛ
кипіти	k ɪ p i t ɪ
дата	d ɑ t ɛ
п'ятдесят	p j ɛ d d ɪ sʲ ɑ t
ознака	ɔ z n ɑ k ɛ
стайня	s t ɑ i nʲ ɛ
сам	s ɑ m
справах	s p r ɑ ʋ ɛ x
раніший	r ɛ nʲ i ʃ ɪ i
наблизити	n ɛ b ɫ ɪ z ɪ t ɪ
чудовисько	t͡ʃ u d ɔ ʋ ɪ sʲ k ɔ
змагатися	z m ɛ ɦ ɑ t ɪ sʲ ɛ
суми	s u m ɪ
біржа	b i r ʒ ɛ
мирний	m ɪ r n ɪ i
область	ɔ b ɫ ɛ sʲ tʲ
аптека	ɛ p t ɛ k ɛ
корчма	k ɔ r t͡ʃ m ɛ
втрачати	ʋ t r ɛ t͡ʃ ɑ t ɪ
безпритульний	b ɪ z p r ɪ t u lʲ n ɪ i
валютний	ʋ ɛ lʲ u t n ɪ i
шанувальник	ʃ ɛ n u ʋ ɑ lʲ n ɪ k
герцогиня	ɦ ɪ r t͡s ɔ ɦ ɪ nʲ ɛ
вероніка	ʋ ɪ r ɔ nʲ i k ɛ
персефона	p ɪ r s ɪ f ɔ n ɛ
вигідний	ʋ ɪ ɦ i d n ɪ i
епічний	ɪ p i t͡ʃ n ɪ i
авіадвигун	ɛ ʋ i ɛ d ʋ ɪ ɦ u n
дефект	d ɪ f ɛ k t
книжкова	k n ɪ ʒ k ɔ ʋ ɛ
третій	t r ɛ tʲ i i
добувати	d ɔ b u ʋ ɑ t ɪ
травень	t r ɑ ʋ ɪ nʲ
включати	ʋ k lʲ u t͡ʃ ɑ t ɪ
парасолька	p ɛ r ɛ s ɔ lʲ k ɛ
гривні	ɦ r ɪ u nʲ i
мислити	m ɪ s ɫ ɪ t ɪ
ножовий	n ɔ ʒ ɔ ʋ ɪ i
тістечко	tʲ i s t ɪ t͡ʃ k ɔ
ґандж	ɡ ɑ n d͡ʒ
феміністичний	f ɪ m i nʲ i s t ɪ t͡ʃ n ɪ i
трансплантації	t r ɛ n s p ɫ ɛ n t ɑ t͡sʲ i j i
щітка	ʃ t͡ʃʲ i t k ɛ
сонечко	s ɔ n ɪ t͡ʃ k ɔ
більшості	b i lʲ ʃ ɔ sʲ tʲ i
теоріям	t ɪ ɔ rʲ i j ɛ m
капітулювати	k ɛ p i t u lʲ u ʋ ɑ t ɪ
вирости	ʋ ɪ r ɔ s t ɪ
арістотель	ɛ rʲ i s t ɔ t ɪ lʲ
сестрице	s ɪ s t r ɪ t͡s ɪ
будапештський	b u d ɛ p ɛ sʲ t͡sʲ k ɪ i
небога	n ɪ b ɔ ɦ ɛ
поздоровити	p ɔ z d ɔ r ɔ ʋ ɪ t ɪ
варіант	ʋ ɛ rʲ i ɑ n t
рильцям	r ɪ lʲ t͡sʲ ɛ m
живий	ʒ ɪ ʋ ɪ i
абортувати	ɛ b ɔ r t u ʋ ɑ t ɪ
лихоманка	ɫ ɪ x ɔ m ɑ n k ɛ
абсанс	ɛ b s ɑ n s
варіантами	ʋ ɛ rʲ i ɑ n t ɛ m ɪ
намисто	n ɛ m ɪ s t ɔ
ложа	ɫ ɔ ʒ ɛ
неподалік	n ɪ p ɔ d ɛ lʲ i k
автовагон	ɛ u t ɔ ʋ ɛ ɦ ɔ n
каплицею	k ɛ p ɫ ɪ t͡s ɪ j u
дивний	d ɪ u n ɪ i
шведка	ʃ ʋ ɛ d k ɛ
городянин	ɦ ɔ r ɔ dʲ ɑ n ɪ n
присутність	p r ɪ s u tʲ nʲ i sʲ tʲ
підміняти	p i dʲ m i nʲ ɑ t ɪ
вимкнути	ʋ ɪ m k n u t ɪ
зустріти	z u s tʲ rʲ i t ɪ
лінійний	lʲ i nʲ i i n ɪ i
дорога	d ɔ r ɔ ɦ ɛ
клуатр	k ɫ u ɑ t r
пустиня	p u s t ɪ nʲ ɛ
лапша	ɫ ɛ p ʃ ɑ
вираження	ʋ ɪ r ɛ ʒ ɪ nʲ ɛ
взаємоповага	ʋ z ɛ j ɪ m ɔ p ɔ ʋ ɑ ɦ ɛ
компонент	k ɔ m p ɔ n ɛ n t
субтитри	s u b t ɪ t r ɪ
літ	lʲ i t
кросівка	k r ɔ sʲ i u k ɛ
трансформаціях	t r ɛ n s f ɔ r m ɑ t͡sʲ i j ɛ x
відвага	ʋ i d ʋ ɑ ɦ ɛ
пробуджуватися	p r ɔ b u d͡ʒ u ʋ ɛ t ɪ sʲ ɛ
гривня	ɦ r ɪ u nʲ ɛ
хутро	x u t r ɔ
безіменний	b ɪ zʲ i m ɛ n ɪ i
інтернаціональний	i n t ɪ r n ɛ t͡sʲ i ɔ n ɑ lʲ n ɪ i
дорослий	d ɔ r ɔ s ɫ ɪ i
вадами	ʋ ɑ d ɛ m ɪ
майя	m ɑ i j ɛ
щоби	ʃ t͡ʃ ɔ b ɪ
знижувати	z n ɪ ʒ u ʋ ɛ t ɪ
прав	p r ɑ u
мрія	m rʲ i j ɛ
недостатньо	n ɪ d ɔ s t ɑ tʲ nʲ ɔ
піддержати	p i d ɛ r ʒ ɛ t ɪ
жорстокий	ʒ ɔ r s t ɔ k ɪ i
баритися	b ɛ r ɪ t ɪ sʲ ɛ
переоцінювати	p ɪ r ɪ ɔ t͡sʲ i nʲ u ʋ ɛ t ɪ
чомусь	t͡ʃ ɔ m u sʲ
героїчний	ɦ ɪ r ɔ j i t͡ʃ n ɪ i
правомірний	p r ɛ ʋ ɔ m i r n ɪ i
брест	b r ɛ s t
дати	d ɑ t ɪ
протест	p r ɔ t ɛ s t
слов'янам	s ɫ ɔ ʋ j ɑ n ɛ m
твої	t ʋ ɔ j i
добробут	d ɔ b r ɔ b u t
підмет	p i d m ɪ t
лексикографія	ɫ ɪ k s ɪ k ɔ ɦ r ɑ f i j ɛ
періодизаціях	p ɪ rʲ i ɔ d ɪ z ɑ t͡sʲ i j ɛ x
приїжджати	p r ɪ j i ʒ d͡ʒ ɑ t ɪ
активістка	ɛ k t ɪ ʋ i s t k ɛ
асиміляція	ɛ s ɪ m i lʲ ɑ t͡sʲ i j ɛ
таємницею	t ɛ j ɪ m n ɪ t͡s ɪ j u
автовласник	ɛ u t ɔ u ɫ ɑ s n ɪ k
молодиця	m ɔ ɫ ɔ d ɪ t͡sʲ ɛ
кільце	k i lʲ t͡s ɛ
незалежністю	n ɪ z ɛ ɫ ɛ ʒ nʲ i sʲ tʲ u
кіш	k i ʃ
бетономішалка	b ɪ t ɔ n ɔ m i ʃ ɑ ɫ k ɛ
специфічний	s p ɪ t͡s ɪ f i t͡ʃ n ɪ i
гривень	ɦ r ɪ ʋ ɪ nʲ
абстракціонізм	ɛ b s t r ɛ k t͡sʲ i ɔ nʲ i z m
м'язи	m j ɑ z ɪ
румунія	r u m u nʲ i j ɛ
пуголовок	p u ɦ ɔ ɫ ɔ ʋ ɔ k
зовнішня	z ɔ u nʲ i ʃ nʲ ɛ
обміркувати	ɔ b m i r k u ʋ ɑ t ɪ
промовляти	p r ɔ m ɔ u lʲ ɑ t ɪ
відповідати	ʋ i d p ɔ ʋ i d ɑ t ɪ
догадуватися	d ɔ ɦ ɑ d u ʋ ɛ t ɪ sʲ ɛ
британія	b r ɪ t ɑ nʲ i j ɛ
шумний	ʃ u m n ɪ i
природознавство	p r ɪ r ɔ d ɔ z n ɑ u s t ʋ ɔ
пивний	p ɪ u n ɪ i
р	r
бобер	b ɔ b ɛ r
теоретичний	t ɪ ɔ r ɪ t ɪ t͡ʃ n ɪ i
нормальний	n ɔ r m ɑ lʲ n ɪ i
заявити	z ɛ j ɛ ʋ ɪ t ɪ
тактовний	t ɛ k t ɔ u n ɪ i
лисиця	ɫ ɪ s ɪ t͡sʲ ɛ
наприкінці	n ɛ p r ɪ k i nʲ t͡sʲ i
візуальний	ʋ i z u ɑ lʲ n ɪ i
ночви	n ɔ t͡ʃ ʋ ɪ
радо	r ɑ d ɔ
підготовляти	p i d ɦ ɔ t ɔ u lʲ ɑ t ɪ
громило	ɦ r ɔ m ɪ ɫ ɔ
дзеркало	d͡z ɛ r k ɛ ɫ ɔ
авіашоу	ɛ ʋ i ɛ ʃ ɔ u
фольклор	f ɔ lʲ k ɫ ɔ r
муха	m u x ɛ
мертвий	m ɛ r t ʋ ɪ i
звідси	zʲ ʋ i d͡z s ɪ
масаж	m ɛ s ɑ ʒ
придатний	p r ɪ d ɑ t n ɪ i
вільнодумець	ʋ i lʲ n ɔ d u m ɪ t͡sʲ
аероліт	ɛ ɪ r ɔ lʲ i t
налаштовувати	n ɛ ɫ ɛ ʃ t ɔ ʋ u ʋ ɛ t ɪ
вільна	ʋ i lʲ n ɛ
причинний	p r ɪ t͡ʃ ɪ n ɪ i
завдяки	z ɛ u dʲ ɛ k ɪ
тримати	t r ɪ m ɑ t ɪ
застудитися	n ɛ r ɔ d ɪ t ɪ sʲ ɛ
абрикоса	ɛ b r ɪ k ɔ s ɛ
дані	d ɑ nʲ i
автопортрет	ɛ u t ɔ p ɔ r t r ɛ t
уявіть	u j ɛ ʋ i tʲ
евакуювати	ɪ ʋ ɛ k u j u ʋ ɑ t ɪ
сумніватися	s u m nʲ i ʋ ɑ t ɪ sʲ ɛ
дешевий	d ɪ ʃ ɛ ʋ ɪ i
психіатрія	p s ɪ x i ɛ tʲ rʲ i j ɛ
декларацій	d ɪ k ɫ ɛ r ɑ t͡sʲ i i
варіанту	ʋ ɛ rʲ i ɑ n t u
кредитний	k r ɪ d ɪ t n ɪ i
дня	dʲ nʲ ɑ
емілія	ɪ m i lʲ i j ɛ
споживачів	s p ɔ ʒ ɪ ʋ ɛ t͡ʃʲ i u
стефанія	s t ɪ f ɑ nʲ i j ɛ
вечора	ʋ ɛ t͡ʃ ɔ r ɛ
археологів	ɛ r x ɪ ɔ ɫ ɔ ɦ i u
косити	k ɔ s ɪ t ɪ
федерація	f ɪ d ɪ r ɑ t͡sʲ i j ɛ
фольга	f ɔ lʲ ɦ ɛ
інна	i n ɛ
дзьоб	d͡zʲ ɔ b
витратити	ʋ ɪ t r ɛ t ɪ t ɪ
повікою	p ɔ ʋ i k ɔ j u
охра	ɔ x r ɛ
тарган	t ɛ r ɦ ɑ n
утратам	u t r ɑ t ɛ m
трансформацію	t r ɛ n s f ɔ r m ɑ t͡sʲ i j u
аґрусовий	ɑ ɡ r u s ɔ ʋ ɪ i
фразеологія	f r ɛ z ɪ ɔ ɫ ɔ ɦ i j ɛ
жодний	ʒ ɔ d n ɪ i
олово	ɔ ɫ ɔ ʋ ɔ
сестриця	s ɪ s t r ɪ t͡sʲ ɛ
танцювати	t ɛ nʲ t͡sʲ u ʋ ɑ t ɪ
комедія	k ɔ m ɛ dʲ i j ɛ
жнець	ʒ n ɛ t͡sʲ
внутрішній	ʋ n u tʲ rʲ i ʃ nʲ i i
абак	ɛ b ɑ k
михаїл	m ɪ x ɛ j i ɫ
повезти	p ɔ ʋ ɪ z t ɪ
талія	t ɑ lʲ i j ɛ
кислотність	k ɪ s ɫ ɔ tʲ nʲ i sʲ tʲ
пріоритет	p rʲ i ɔ r ɪ t ɛ t
давньогрецький	d ɛ u nʲ ɔ ɦ r ɛ t͡sʲ k ɪ i
в'язниця	ʋ j ɛ z n ɪ t͡sʲ ɛ
крейда	k r ɛ i d ɛ
дієвий	dʲ i j ɛ ʋ ɪ i
білок	b i ɫ ɔ k
зручний	z r u t͡ʃ n ɪ i
печивом	p ɛ t͡ʃ ɪ ʋ ɔ m
пень	p ɛ nʲ
слов'янині	s ɫ ɔ ʋ j ɛ n ɪ nʲ i
програмувати	p r ɔ ɦ r ɛ m u ʋ ɑ t ɪ
тарас	t ɛ r ɑ s
біженка	b i ʒ ɪ n k ɛ
блокнот	b ɫ ɔ k n ɔ t
щупальце	ʃ t͡ʃ u p ɛ lʲ t͡s ɪ
шпигун	ʃ p ɪ ɦ u n
чорт	t͡ʃ ɔ r t
поступці	p ɔ s t u p t͡sʲ i
засада	z ɛ s ɑ d ɛ
велиґдень	ʋ ɪ ɫ ɪ ɡ d ɪ nʲ
словацький	s ɫ ɔ ʋ ɑ t͡sʲ k ɪ i
перекладачка	p ɪ r ɪ k ɫ ɛ d ɑ t͡ʃ k ɛ
жук	ʒ u k
вмикати	ʋ m ɪ k ɑ t ɪ
задоволень	z ɛ d ɔ ʋ ɔ ɫ ɪ nʲ
декларацією	d ɪ k ɫ ɛ r ɑ t͡sʲ i j ɪ j u
амбіція	ɛ m b i t͡sʲ i j ɛ
мігрант	m i ɦ r ɑ n t
мошонка	m ɔ ʃ ɔ n k ɛ
чемпіонський	t͡ʃ ɪ m p i ɔ nʲ sʲ k ɪ i
геополітика	ɦ ɪ ɔ p ɔ lʲ i t ɪ k ɛ
естонія	ɪ s t ɔ nʲ i j ɛ
консервувати	k ɔ n s ɪ r ʋ u ʋ ɑ t ɪ
жлуктати	ʒ ɫ u k t ɑ t ɪ
замощувати	z ɛ m ɔ ʃ t͡ʃ u ʋ ɛ t ɪ
спочатку	s p ɔ t͡ʃ ɑ t k u
поліно	p ɔ lʲ i n ɔ
більш	b i lʲ ʃ
випадок	ʋ ɪ p ɑ d ɔ k
серцевий	s ɪ r t͡s ɛ ʋ ɪ i
двері	d ʋ ɛ rʲ i
вулиця	ʋ u ɫ ɪ t͡sʲ ɛ
таємницях	t ɛ j ɪ m n ɪ t͡sʲ ɛ x
офіра	ɔ f i r ɛ
п'ятниця	p j ɑ t n ɪ t͡sʲ ɛ
навчити	n ɛ u t͡ʃ ɪ t ɪ
візовий	ʋ i z ɔ ʋ ɪ i
дитя	d ɪ tʲ ɑ
знайти	z n ɛ i t ɪ
повільно	p ɔ ʋ i lʲ n ɔ
велосипед	ʋ ɪ ɫ ɔ s ɪ p ɛ d
науковий	n ɛ u k ɔ ʋ ɪ i
груша	ɦ r u ʃ ɛ
розгляд	r ɔ z ɦ lʲ ɛ d
написати	n ɛ p ɪ s ɑ t ɪ
аналітичний	ɛ n ɛ lʲ i t ɪ t͡ʃ n ɪ i
сарана	s ɛ r ɛ n ɑ
суперник	s u p ɛ r n ɪ k
брехню	b r ɪ x nʲ u
космодром	k ɔ s m ɔ d r ɔ m
добривечір	d ɔ b r ɪ ʋ ɛ t͡ʃʲ i r
положення	p ɔ ɫ ɔ ʒ ɪ nʲ ɛ
аналізувати	ɛ n ɛ lʲ i z u ʋ ɑ t ɪ
самозакоханий	s ɛ m ɔ z ɛ k ɔ x ɛ n ɪ i
кошуля	k ɔ ʃ u lʲ ɛ
плювати	p lʲ u ʋ ɑ t ɪ
плутократією	p ɫ u t ɔ k r ɑ tʲ i j ɪ j u
монумент	m ɔ n u m ɛ n t
прискорити	p r ɪ s k ɔ r ɪ t ɪ
збагатити	z b ɛ ɦ ɛ t ɪ t ɪ
мем	m ɛ m
член	t͡ʃ ɫ ɛ n
стремено	s t r ɪ m ɪ n ɔ
ломака	ɫ ɔ m ɑ k ɛ
довічний	d ɔ ʋ i t͡ʃ n ɪ i
галасливий	ɦ ɛ ɫ ɛ s ɫ ɪ ʋ ɪ i
тополі	t ɔ p ɔ lʲ i
зелен	z ɛ ɫ ɪ n
виноградник	ʋ ɪ n ɔ ɦ r ɑ d n ɪ k
операція	ɔ p ɪ r ɑ t͡sʲ i j ɛ
обідати	ɔ b i d ɛ t ɪ
граніт	ɦ r ɛ nʲ i t
цегла	t͡s ɛ ɦ ɫ ɛ
виграш	ʋ ɪ ɦ r ɛ ʃ
різноманітний	rʲ i z n ɔ m ɛ nʲ i t n ɪ i
міжзоряний	m i ʒ z ɔ rʲ ɛ n ɪ i
обмеження	ɔ b m ɛ ʒ ɪ nʲ ɛ
аналогічний	ɛ n ɛ ɫ ɔ ɦ i t͡ʃ n ɪ i
зрадниця	z r ɑ d n ɪ t͡sʲ ɛ
їм	j i m
спина	s p ɪ n ɛ
кравченко	k r ɑ u t͡ʃ ɪ n k ɔ
ностальгія	n ɔ s t ɛ lʲ ɦ i j ɛ
реб	r ɛ b
ультиматум	u lʲ t ɪ m ɑ t u m
медитація	m ɪ d ɪ t ɑ t͡sʲ i j ɛ
водка	ʋ ɔ d k ɛ
погодитися	p ɔ ɦ ɔ d ɪ t ɪ sʲ ɛ
батальйон	b ɛ t ɛ lʲ j ɔ n
другові	d r u ɦ ɔ ʋ i
заспокоювати	z ɛ s p ɔ k ɔ j u ʋ ɛ t ɪ
тристоронній	t r ɪ s t ɔ r ɔ nʲ i i
різноманіття	rʲ i z n ɔ m ɛ nʲ i tʲ ɛ
започатковувати	z ɛ p ɔ t͡ʃ ɛ t k ɔ ʋ u ʋ ɛ t ɪ
опера	ɔ p ɪ r ɛ
тротуарі	t r ɔ t u ɑ rʲ i
фотосинтез	f ɔ t ɔ s ɪ n t ɪ z
уряд	u rʲ ɛ d
виклик	ʋ ɪ k ɫ ɪ k
авіазасіб	ɛ ʋ i ɛ z ɑ sʲ i b
чутливий	t͡ʃ u t ɫ ɪ ʋ ɪ i
поет	p ɔ ɛ t
припущень	p r ɪ p u ʃ t͡ʃ ɪ nʲ
правило	p r ɑ ʋ ɪ ɫ ɔ
колумбія	k ɔ ɫ u m b i j ɛ
портфелях	p ɔ r t f ɛ lʲ ɛ x
перекладачки	p ɪ r ɪ k ɫ ɛ d ɑ t͡ʃ k ɪ
тесть	t ɛ sʲ tʲ
фрагменту	f r ɛ ɦ m ɛ n t u
безжальний	b ɪ ʒ ɑ lʲ n ɪ i
мінськ	m i nʲ sʲ k
влаштовуватися	ʋ ɫ ɛ ʃ t u ʋ ɑ t ɪ sʲ ɛ
лід	lʲ i d
мотоциклам	m ɔ t ɔ t͡s ɪ k ɫ ɛ m
арка	ɑ r k ɛ
вдовець	ʋ d ɔ ʋ ɛ t͡sʲ
миролюбний	m ɪ r ɔ lʲ u b n ɪ i
ікра	i k r ɑ
іволга	i ʋ ɔ ɫ ɦ ɛ
брухт	b r u x t
сауна	s ɑ u n ɛ
людці	lʲ u d͡zʲ t͡sʲ i
однозначно	ɔ d n ɔ z n ɑ t͡ʃ n ɔ
кліматичний	k lʲ i m ɛ t ɪ t͡ʃ n ɪ i
повість	p ɔ ʋ i sʲ tʲ
стандартові	s t ɛ n d ɑ r t ɔ ʋ i
сечогінний	s ɪ t͡ʃ ɔ ɦ i n ɪ i
критерієві	k r ɪ t ɛ rʲ i j ɪ ʋ i
григоріанський	ɦ r ɪ ɦ ɔ rʲ i ɑ nʲ sʲ k ɪ i
гаджет	ɦ ɑ d͡ʒ ɪ t
паломництво	p ɛ ɫ ɔ m n ɪ t͡s t ʋ ɔ
переосмислювати	p ɪ r ɪ ɔ s m ɪ sʲ lʲ u ʋ ɛ t ɪ
емоцію	ɪ m ɔ t͡sʲ i j u
рослина	r ɔ s ɫ ɪ n ɛ
порошенко	p ɔ r ɔ ʃ ɛ n k ɔ
розпізнавальний	r ɔ zʲ p i z n ɛ ʋ ɑ lʲ n ɪ i
гончар	ɦ ɔ n t͡ʃ ɑ r
хвіст	x ʋ i s t
соха	s ɔ x ɑ
причина	p r ɪ t͡ʃ ɪ n ɛ
шептати	ʃ ɪ p t ɑ t ɪ
мотоциклів	m ɔ t ɔ t͡s ɪ k lʲ i u
плівка	p lʲ i u k ɛ
виборами	ʋ ɪ b ɔ r ɛ m ɪ
шкідливий	ʃ k i d ɫ ɪ ʋ ɪ i
пороховий	p ɔ r ɔ x ɔ ʋ ɪ i
верем'я	ʋ ɪ r ɛ m j ɛ
час	t͡ʃ ɑ s
поселяти	p ɔ s ɪ lʲ ɑ t ɪ
поступки	p ɔ s t u p k ɪ
голосувати	ɦ ɔ ɫ ɔ s u ʋ ɑ t ɪ
кишенею	k ɪ ʃ ɛ n ɪ j u
дощок	d ɔ ʃ t͡ʃ ɔ k
тротуари	t r ɔ t u ɑ r ɪ
трансформацій	t r ɛ n s f ɔ r m ɑ t͡sʲ i i
звідкись	zʲ ʋ i d k ɪ sʲ
пригодницький	p r ɪ ɦ ɔ d n ɪ t͡sʲ k ɪ i
ліцензія	lʲ i t͡s ɛ nʲ zʲ i j ɛ
батько	b ɑ tʲ k ɔ
авіатика	ɛ ʋ i ɑ t ɪ k ɛ
хтивий	x t ɪ ʋ ɪ i
ластівка	ɫ ɑ sʲ tʲ i u k ɛ
собою	s ɔ b ɔ j u
з'їсти	z j i s t ɪ
калій	k ɑ lʲ i i
комунізм	k ɔ m u nʲ i z m
абияк	ɛ b ɪ j ɛ k
індивід	i n d ɪ ʋ i d
лом	ɫ ɔ m
віковічний	ʋ i k ɔ ʋ i t͡ʃ n ɪ i
ліворуч	lʲ i ʋ ɔ r u t͡ʃ
діафрагмі	dʲ i ɛ f r ɑ ɦ m i
концентрація	k ɔ n t͡s ɪ n t r ɑ t͡sʲ i j ɛ
албанія	ɛ ɫ b ɑ nʲ i j ɛ
великодній	ʋ ɪ ɫ ɪ k ɔ dʲ nʲ i i
суднобудівна	s u d n ɔ b u dʲ i u n ɑ
начиння	n ɛ t͡ʃ ɪ nʲ ɛ
яєчний	j ɛ j ɛ t͡ʃ n ɪ i
оптика	ɔ p t ɪ k ɛ
будда	b u d ɛ
підпорядковувати	p i d p ɔ rʲ ɛ d k ɔ ʋ u ʋ ɛ t ɪ
міністр	m i nʲ i s t r
мелодію	m ɪ ɫ ɔ dʲ i j u
навколо	n ɛ u k ɔ ɫ ɔ
консалтинговий	k ɔ n s ɑ ɫ t ɪ n ɦ ɔ ʋ ɪ i
століттю	s t ɔ lʲ i tʲ u
пилосос	p ɪ ɫ ɔ s ɔ s
симпатичний	s ɪ m p ɛ t ɪ t͡ʃ n ɪ i
мріє	m rʲ i j ɪ
дискусія	d ɪ s k u sʲ i j ɛ
ідеальний	i d ɪ ɑ lʲ n ɪ i
електромагнетизм	ɪ ɫ ɪ k t r ɔ m ɛ ɦ n ɪ t ɪ z m
кота	k ɔ t ɑ
засудити	z ɛ s u d ɪ t ɪ
шлюб	ʃ lʲ u b
китайський	k ɪ t ɑ i sʲ k ɪ i
лексикографічний	ɫ ɪ k s ɪ k ɔ ɦ r ɛ f i t͡ʃ n ɪ i
рацій	r ɑ t͡sʲ i i
поліція	p ɔ lʲ i t͡sʲ i j ɛ
пандемічний	p ɛ n d ɪ m i t͡ʃ n ɪ i
рости	r ɔ s t ɪ
покарань	p ɔ k ɛ r ɑ nʲ
абляція	ɛ b lʲ ɑ t͡sʲ i j ɛ
меншість	m ɛ nʲ ʃ i sʲ tʲ
абхаз	ɛ b x ɑ z
зрости	z r ɔ s t ɪ
господиню	ɦ ɔ s p ɔ d ɪ nʲ u
рись	r ɪ sʲ
двомовність	d ʋ ɔ m ɔ u nʲ i sʲ tʲ
врятовувати	ʋ rʲ ɛ t ɔ ʋ u ʋ ɛ t ɪ
хворіти	x ʋ ɔ rʲ i t ɪ
стать	s t ɑ tʲ
салон	s ɛ ɫ ɔ n
бірюзовий	b i rʲ u z ɔ ʋ ɪ i
восьмитисячний	ʋ ɔ sʲ m ɪ t ɪ sʲ ɛ t͡ʃ n ɪ i
копати	k ɔ p ɑ t ɪ
стандартом	s t ɛ n d ɑ r t ɔ m
песимізм	p ɪ s ɪ m i z m
повільність	p ɔ ʋ i lʲ nʲ i sʲ tʲ
неврологія	n ɪ u r ɔ ɫ ɔ ɦ i j ɛ
готовність	ɦ ɔ t ɔ u nʲ i sʲ tʲ
утратах	u t r ɑ t ɛ x
ваді	ʋ ɑ dʲ i
небажання	n ɪ b ɛ ʒ ɑ nʲ ɛ
агресор	ɛ ɦ r ɛ s ɔ r
сфер	s f ɛ r
елегантний	ɪ ɫ ɪ ɦ ɑ n t n ɪ i
громадянка	ɦ r ɔ m ɛ dʲ ɑ n k ɛ
пізній	p i zʲ nʲ i i
вени	ʋ ɛ n ɪ
експонат	ɪ k s p ɔ n ɑ t
купувати	k u p u ʋ ɑ t ɪ
теща	t ɛ ʃ t͡ʃ ɛ
швидкість	ʃ ʋ ɪ dʲ k i sʲ tʲ
справи	s p r ɑ ʋ ɪ
співчутливий	sʲ p i u t͡ʃ u t ɫ ɪ ʋ ɪ i
авіапромисловість	ɛ ʋ i ɛ p r ɔ m ɪ s ɫ ɔ ʋ i sʲ tʲ
письменниця	p ɪ sʲ m ɛ n ɪ t͡sʲ ɛ
плавчиня	p ɫ ɛ u t͡ʃ ɪ nʲ ɛ
числовий	t͡ʃ ɪ s ɫ ɔ ʋ ɪ i
подія	p ɔ dʲ i j ɛ
привіт	p r ɪ ʋ i t
трагедіям	t r ɛ ɦ ɛ dʲ i j ɛ m
самоціль	s ɛ m ɔ t͡sʲ i lʲ
аблактування	ɛ b ɫ ɛ k t u ʋ ɑ nʲ ɛ
золота	z ɔ ɫ ɔ t ɛ
різновид	rʲ i z n ɔ ʋ ɪ d
перевиховувати	p ɪ r ɪ ʋ ɪ x ɔ ʋ u ʋ ɛ t ɪ
безсторонність	b ɪ z s t ɔ r ɔ nʲ i sʲ tʲ
таємницями	t ɛ j ɪ m n ɪ t͡sʲ ɛ m ɪ
україномовний	u k r ɛ j i n ɔ m ɔ u n ɪ i
христина	x r ɪ s t ɪ n ɛ
розширити	r ɔ ʒ ʃ ɪ r ɪ t ɪ
погруддя	p ɔ ɦ r u dʲ ɛ
категоричний	k ɛ t ɪ ɦ ɔ r ɪ t͡ʃ n ɪ i
переорієнтувати	p ɪ r ɪ ɔ rʲ i j ɪ n t u ʋ ɑ t ɪ
представниця	p r ɪ d͡z s t ɛ u n ɪ t͡sʲ ɛ
тротуарів	t r ɔ t u ɑ rʲ i u
тільки	tʲ i lʲ k ɪ
погрозити	p ɔ ɦ r ɔ z ɪ t ɪ
благий	b ɫ ɛ ɦ ɪ i
грабіж	ɦ r ɛ b i ʒ
ніготь	nʲ i ɦ ɔ tʲ
реанімація	r ɪ ɛ nʲ i m ɑ t͡sʲ i j ɛ
зображувати	z ɔ b r ɑ ʒ u ʋ ɛ t ɪ
транспортний	t r ɑ n s p ɔ r t n ɪ i
ганьба	ɦ ɛ nʲ b ɑ
поселити	p ɔ s ɪ ɫ ɪ t ɪ
сказати	s k ɛ z ɑ t ɪ
тис	t ɪ s
долоні	d ɔ ɫ ɔ nʲ i
клієнт	k lʲ i j ɛ n t
переважний	p ɪ r ɪ ʋ ɑ ʒ n ɪ i
нейтралітет	n ɪ i t r ɛ lʲ i t ɛ t
поширити	p ɔ ʃ ɪ r ɪ t ɪ
моє	m ɔ j ɛ
заучувати	z ɛ u t͡ʃ u ʋ ɛ t ɪ
нас	n ɑ s
делегат	d ɪ ɫ ɪ ɦ ɑ t
критикувати	k r ɪ t ɪ k u ʋ ɑ t ɪ
туризм	t u r ɪ z m
вербальний	ʋ ɪ r b ɑ lʲ n ɪ i
нарвал	n ɛ r ʋ ɑ ɫ
мандрівник	m ɛ n dʲ rʲ i u n ɪ k
доїхати	d ɔ j i x ɛ t ɪ
вперше	ʋ p ɛ r ʃ ɪ
сповільнювати	s p ɔ ʋ i lʲ nʲ u ʋ ɛ t ɪ
прибуток	p r ɪ b u t ɔ k
металевий	m ɪ t ɛ ɫ ɛ ʋ ɪ i
танцюристок	t ɛ nʲ t͡sʲ u r ɪ s t ɔ k
контроль	k ɔ n t r ɔ lʲ
аквамариновий	ɛ k ʋ ɛ m ɛ r ɪ n ɔ ʋ ɪ i
смертний	s m ɛ r t n ɪ i
друзям	d r u zʲ ɛ m
турнір	t u r nʲ i r
авангард	ɛ ʋ ɛ n ɦ ɑ r d
інтенсивність	i n t ɪ n s ɪ u nʲ i sʲ tʲ
глек	ɦ ɫ ɛ k
елефант	ɪ ɫ ɪ f ɑ n t
авіаполк	ɛ ʋ i ɛ p ɔ ɫ k
спідницями	sʲ p i d n ɪ t͡sʲ ɛ m ɪ
лошак	ɫ ɔ ʃ ɑ k
відчиняти	ʋ i d͡ʒ t͡ʃ ɪ nʲ ɑ t ɪ
особистий	ɔ s ɔ b ɪ s t ɪ i
занотовувати	z ɛ n ɔ t ɔ ʋ u ʋ ɛ t ɪ
карт	k ɑ r t
антидот	ɛ n t ɪ d ɔ t
транзит	t r ɛ n z ɪ t
класти	k ɫ ɑ s t ɪ
узаконювати	u z ɛ k ɔ nʲ u ʋ ɛ t ɪ
прабаба	p r ɛ b ɑ b ɛ
королівський	k ɔ r ɔ lʲ i u sʲ k ɪ i
діафрагма	dʲ i ɛ f r ɑ ɦ m ɛ
грати	ɦ r ɑ t ɪ
молодята	m ɔ ɫ ɔ dʲ ɑ t ɛ
неня	n ɛ nʲ ɛ
наставати	n ɛ s t ɛ ʋ ɑ t ɪ
вуглеводень	ʋ u ɦ ɫ ɪ ʋ ɔ d ɪ nʲ
подружжя	p ɔ d r u ʒʲ ɛ
егоїстичний	ɪ ɦ ɔ j i s t ɪ t͡ʃ n ɪ i
квадратний	k ʋ ɛ d r ɑ t n ɪ i
амфібія	ɛ m f i b i j ɛ
кілометр	k i ɫ ɔ m ɛ t r
зовнішній	z ɔ u nʲ i ʃ nʲ i i
мільйон	m i lʲ j ɔ n
перевезення	p ɪ r ɪ ʋ ɛ z ɪ nʲ ɛ
поздоровляти	p ɔ z d ɔ r ɔ u lʲ ɑ t ɪ
ранній	r ɑ nʲ i i
увімкнути	u ʋ i m k n u t ɪ
завантажувати	z ɛ ʋ ɛ n t ɑ ʒ u ʋ ɛ t ɪ
природнича	p r ɪ r ɔ d n ɪ t͡ʃ ɛ
повернути	p ɔ ʋ ɪ r n u t ɪ
потрібний	p ɔ tʲ rʲ i b n ɪ i
равлик	r ɑ u ɫ ɪ k
притулок	p r ɪ t u ɫ ɔ k
присвійний	p r ɪ sʲ ʋ i i n ɪ i
патина	p ɛ t ɪ n ɛ
політик	p ɔ lʲ i t ɪ k
рушниця	r u ʃ n ɪ t͡sʲ ɛ
намагатися	n ɛ m ɛ ɦ ɑ t ɪ sʲ ɛ
хотітися	x ɔ tʲ i t ɪ sʲ ɛ
громадянство	ɦ r ɔ m ɛ dʲ ɑ n s t ʋ ɔ
фільм	f i lʲ m
занедбувати	z ɛ n ɛ d b u ʋ ɛ t ɪ
пандус	p ɑ n d u s
щі	ʃ t͡ʃʲ i
лялька	lʲ ɑ lʲ k ɛ
центавр	t͡s ɪ n t ɑ u r
персоніфікація	p ɪ r s ɔ nʲ i f i k ɑ t͡sʲ i j ɛ
страшний	s t r ɛ ʃ n ɪ i
словниками	s ɫ ɔ u n ɪ k ɑ m ɪ
рекомендувати	r ɪ k ɔ m ɪ n d u ʋ ɑ t ɪ
сформулювати	s f ɔ r m u lʲ u ʋ ɑ t ɪ
чебрець	t͡ʃ ɪ b r ɛ t͡sʲ
вовна	ʋ ɔ u n ɛ
молодиць	m ɔ ɫ ɔ d ɪ t͡sʲ
тривога	t r ɪ ʋ ɔ ɦ ɛ
вимова	ʋ ɪ m ɔ ʋ ɛ
співіснування	sʲ p i ʋ i s n u ʋ ɑ nʲ ɛ
коровай	k ɔ r ɔ ʋ ɑ i
зобов'язати	z ɔ b ɔ ʋ j ɛ z ɑ t ɪ
зменшень	z m ɛ n ʃ ɪ nʲ
бидло	b ɪ d ɫ ɔ
мегаліт	m ɪ ɦ ɛ lʲ i t
тимчасовий	t ɪ m t͡ʃ ɛ s ɔ ʋ ɪ i
хома	x ɔ m ɑ
почати	p ɔ t͡ʃ ɑ t ɪ
ставлення	s t ɑ u ɫ ɪ nʲ ɛ
занурити	z ɛ n u r ɪ t ɪ
їбати	j i b ɑ t ɪ
лебединий	ɫ ɪ b ɪ d ɪ n ɪ i
ігор	i ɦ ɔ r
громадянський	ɦ r ɔ m ɛ dʲ ɑ nʲ sʲ k ɪ i
тацях	t ɑ t͡sʲ ɛ x
зайнятися	z ɛ i nʲ ɑ t ɪ sʲ ɛ
вмерти	ʋ m ɛ r t ɪ
цистерна	t͡s ɪ s t ɛ r n ɛ
оленина	ɔ ɫ ɪ n ɪ n ɛ
сімейний	sʲ i m ɛ i n ɪ i
своєрідний	s ʋ ɔ j ɪ rʲ i d n ɪ i
черняк	t͡ʃ ɪ r nʲ ɑ k
геометричний	ɦ ɪ ɔ m ɪ t r ɪ t͡ʃ n ɪ i
версія	ʋ ɛ r sʲ i j ɛ
комедіям	k ɔ m ɛ dʲ i j ɛ m
імітація	i m i t ɑ t͡sʲ i j ɛ
аборт	ɛ b ɔ r t
криме	k r ɪ m ɪ
боліти	b ɔ lʲ i t ɪ
існуючий	i s n u j u t͡ʃ ɪ i
ратифікація	r ɛ t ɪ f i k ɑ t͡sʲ i j ɛ
себе	s ɪ b ɛ
періодизацією	p ɪ rʲ i ɔ d ɪ z ɑ t͡sʲ i j ɪ j u
пан	p ɑ n
акваріум	ɛ k ʋ ɑ rʲ i u m
рильцями	r ɪ lʲ t͡sʲ ɛ m ɪ
маргіналізація	m ɛ r ɦ i n ɛ lʲ i z ɑ t͡sʲ i j ɛ
весільна	ʋ ɪ sʲ i lʲ n ɛ
конкурентоспроможність	k ɔ n k u r ɪ n t ɔ s p r ɔ m ɔ ʒ nʲ i sʲ tʲ
адреса	ɛ d r ɛ s ɛ
любов	lʲ u b ɔ u
кишенькові	k ɪ ʃ ɪ nʲ k ɔ ʋ i
лісова	lʲ i s ɔ ʋ ɑ
австралопітек	ɛ u s t r ɛ ɫ ɔ p i t ɛ k
сусідство	s u sʲ i d͡z s t ʋ ɔ
кода	k ɔ d ɛ
смола	s m ɔ ɫ ɑ
повторювати	p ɔ u t ɔ rʲ u ʋ ɛ t ɪ
щоразу	ʃ t͡ʃ ɔ r ɑ z u
тетяна	t ɪ tʲ ɑ n ɛ
спортивний	s p ɔ r t ɪ u n ɪ i
каплицю	k ɛ p ɫ ɪ t͡sʲ u
персональний	p ɪ r s ɔ n ɑ lʲ n ɪ i
крикливий	k r ɪ k ɫ ɪ ʋ ɪ i
пропорція	p r ɔ p ɔ r t͡sʲ i j ɛ
скляний	s k lʲ ɛ n ɪ i
адміністратор	ɛ dʲ m i nʲ i s t r ɑ t ɔ r
шумливий	ʃ u m ɫ ɪ ʋ ɪ i
вітамін	ʋ i t ɛ m i n
неподільний	n ɪ p ɔ dʲ i lʲ n ɪ i
спадщина	s p ɑ d ʃ t͡ʃ ɪ n ɛ
скло	s k ɫ ɔ
мовознавство	m ɔ ʋ ɔ z n ɑ u s t ʋ ɔ
спорт	s p ɔ r t
морфологічний	m ɔ r f ɔ ɫ ɔ ɦ i t͡ʃ n ɪ i
абрикос	ɛ b r ɪ k ɔ s
євгенія	j ɪ u ɦ ɛ nʲ i j ɛ
світанок	sʲ ʋ i t ɑ n ɔ k
зоопарк	z ɔ ɔ p ɑ r k
звіря	zʲ ʋ i rʲ ɑ
слівцях	sʲ lʲ i u t͡sʲ ɛ x
кара	k ɑ r ɛ
співробітник	sʲ p i u r ɔ b i t n ɪ k
забудькуватий	z ɛ b u dʲ k u ʋ ɛ t ɪ i
усвідомити	u sʲ ʋ i d ɔ m ɪ t ɪ
ковзкий	k ɔ u z k ɪ i
страта	s t r ɑ t ɛ
сприятливий	s p r ɪ j ɑ t ɫ ɪ ʋ ɪ i
молюск	m ɔ lʲ u s k
бесіда	b ɛ sʲ i d ɛ
фашизм	f ɛ ʃ ɪ z m
палка	p ɑ ɫ k ɛ
застраховувати	z ɛ s t r ɛ x ɔ ʋ u ʋ ɛ t ɪ
підсумок	p i d͡z s u m ɔ k
верес	ʋ ɛ r ɪ s
мережа	m ɪ r ɛ ʒ ɛ
найбільше	n ɛ i b i lʲ ʃ ɪ
фея	f ɛ j ɛ
дівчина	dʲ i u t͡ʃ ɪ n ɛ
теплота	t ɪ p ɫ ɔ t ɑ
змога	z m ɔ ɦ ɛ
відлякувати	ʋ i dʲ lʲ ɑ k u ʋ ɛ t ɪ
мітоз	m i t ɔ z
міф	m i f
абстрагування	ɛ b s t r ɛ ɦ u ʋ ɑ nʲ ɛ
повікам	p ɔ ʋ i k ɛ m
хворий	x ʋ ɔ r ɪ i
мексиканка	m ɪ k s ɪ k ɑ n k ɛ
баддя	b ɛ dʲ ɑ
звуковий	z ʋ u k ɔ ʋ ɪ i
геноцидів	ɦ ɪ n ɔ t͡s ɪ dʲ i u
гад	ɦ ɑ d
файний	f ɑ i n ɪ i
контрастувати	k ɔ n t r ɛ s t u ʋ ɑ t ɪ
ольга	ɔ lʲ ɦ ɛ
трьохсотий	tʲ rʲ ɔ x s ɔ t ɪ i
прогнозувати	p r ɔ ɦ n ɔ z u ʋ ɑ t ɪ
спортсменка	s p ɔ r t͡s m ɛ n k ɛ
шиям	ʃ ɪ j ɛ m
працівниці	p r ɛ t͡sʲ i u n ɪ t͡sʲ i
слов'янко	s ɫ ɔ ʋ j ɑ n k ɔ
гладіаторський	ɦ ɫ ɛ dʲ i ɑ t ɔ r sʲ k ɪ i
нинішній	n ɪ nʲ i ʃ nʲ i i
перетинка	p ɪ r ɛ t ɪ n k ɛ
нещирий	n ɪ ʃ t͡ʃ ɪ r ɪ i
сімдесятий	sʲ i m d ɪ sʲ ɑ t ɪ i
саботажниця	s ɛ b ɔ t ɑ ʒ n ɪ t͡sʲ ɛ
поема	p ɔ ɛ m ɛ
радий	r ɑ d ɪ i
репутація	r ɪ p u t ɑ t͡sʲ i j ɛ
ігнорувати	i ɦ n ɔ r u ʋ ɑ t ɪ
банан	b ɛ n ɑ n
болниця	b ɔ ɫ n ɪ t͡sʲ ɛ
друзями	d r u zʲ ɛ m ɪ
лучник	ɫ u t͡ʃ n ɪ k
орієнтувати	ɔ rʲ i j ɪ n t u ʋ ɑ t ɪ
тоді	t ɔ dʲ i
бик	b ɪ k
костел	k ɔ s t ɛ ɫ
зовні	z ɔ u nʲ i
лунь	ɫ u nʲ
козака	k ɔ z ɛ k ɑ
коаліційний	k ɔ ɛ lʲ i t͡sʲ i i n ɪ i
адаптувати	ɛ d ɛ p t u ʋ ɑ t ɪ
осло	ɔ s ɫ ɔ
візантій	ʋ i z ɑ nʲ tʲ i i
сірий	sʲ i r ɪ i
латиський	ɫ ɛ t ɪ sʲ k ɪ i
письменний	p ɪ sʲ m ɛ n ɪ i
софія	s ɔ f i j ɛ
жлуктити	ʒ ɫ u k t ɪ t ɪ
другий	d r u ɦ ɪ i
отець	ɔ t ɛ t͡sʲ
бездомний	b ɪ z d ɔ m n ɪ i
багатогранний	b ɛ ɦ ɛ t ɔ ɦ r ɑ n ɪ i
гілка	ɦ i ɫ k ɛ
спірний	sʲ p i r n ɪ i
асистентка	ɛ s ɪ s t ɛ n t k ɛ
програміст	p r ɔ ɦ r ɛ m i s t
конференція	k ɔ n f ɪ r ɛ nʲ t͡sʲ i j ɛ
гарантія	ɦ ɛ r ɑ nʲ tʲ i j ɛ
маслина	m ɛ s ɫ ɪ n ɛ
суміжний	s u m i ʒ n ɪ i
ліван	lʲ i ʋ ɑ n
багатогодинний	b ɛ ɦ ɛ t ɔ ɦ ɔ d ɪ n ɪ i
бактеріальний	b ɛ k t ɪ rʲ i ɑ lʲ n ɪ i
знадобитися	z n ɛ d ɔ b ɪ t ɪ sʲ ɛ
вечірка	ʋ ɪ t͡ʃʲ i r k ɛ
консалтинг	k ɔ n s ɑ ɫ t ɪ n ɦ
німий	nʲ i m ɪ i
мексиканський	m ɪ k s ɪ k ɑ nʲ sʲ k ɪ i
бойко	b ɔ i k ɔ
дев'ять	d ɛ ʋ j ɛ tʲ
лев	ɫ ɛ u
шпиталь	ʃ p ɪ t ɑ lʲ
рицар	r ɪ t͡s ɛ r
фундаментальний	f u n d ɛ m ɪ n t ɑ lʲ n ɪ i
органічна	ɔ r ɦ ɛ nʲ i t͡ʃ n ɛ
диктатор	d ɪ k t ɑ t ɔ r
незамінність	n ɪ z ɛ m i nʲ i sʲ tʲ
інвестиція	i n ʋ ɪ s t ɪ t͡sʲ i j ɛ
біомедицина	b i ɔ m ɪ d ɪ t͡s ɪ n ɛ
келих	k ɛ ɫ ɪ x
фірма	f i r m ɛ
пастка	p ɑ s t k ɛ
вагітна	ʋ ɛ ɦ i t n ɛ
австралійська	ɛ u s t r ɛ lʲ i i sʲ k ɛ
зозуля	z ɔ z u lʲ ɛ
заснувати	z ɛ s n u ʋ ɑ t ɪ
ідеологічний	i d ɪ ɔ ɫ ɔ ɦ i t͡ʃ n ɪ i
баклан	b ɛ k ɫ ɑ n
тестування	t ɪ s t u ʋ ɑ nʲ ɛ
безпілотний	b ɪ zʲ p i ɫ ɔ t n ɪ i
кікбоксинг	k i ɡ b ɔ k s ɪ n ɦ
містичний	m i s t ɪ t͡ʃ n ɪ i
припинення	p r ɪ p ɪ n ɪ nʲ ɛ
загадка	z ɛ ɦ ɑ d k ɛ
астрологія	ɛ s t r ɔ ɫ ɔ ɦ i j ɛ
помирати	p ɔ m ɪ r ɑ t ɪ
шоколадник	ʃ ɔ k ɔ ɫ ɑ d n ɪ k
галушка	ɦ ɛ ɫ u ʃ k ɛ
розуміння	r ɔ z u m i nʲ ɛ
гомосексуальний	ɦ ɔ m ɔ s ɪ k s u ɑ lʲ n ɪ i
критерієм	k r ɪ t ɛ rʲ i j ɪ m
куток	k u t ɔ k
відважний	ʋ i d ʋ ɑ ʒ n ɪ i
америка	ɛ m ɛ r ɪ k ɛ
феями	f ɛ j ɛ m ɪ
слухати	s ɫ u x ɛ t ɪ
крива	k r ɪ ʋ ɑ
експлуатація	ɪ k s p ɫ u ɛ t ɑ t͡sʲ i j ɛ
автогемотерапія	ɛ u t ɔ ɦ ɪ m ɔ t ɪ r ɛ p i j ɛ
пересічний	p ɪ r ɪ sʲ i t͡ʃ n ɪ i
датувати	d ɛ t u ʋ ɑ t ɪ
постати	p ɔ s t ɑ t ɪ
покарання	p ɔ k ɛ r ɑ nʲ ɛ
вітальні	ʋ i t ɑ lʲ nʲ i
щотижневий	ʃ t͡ʃ ɔ t ɪ ʒ n ɛ ʋ ɪ i
рецесія	r ɪ t͡s ɛ sʲ i j ɛ
позичати	p ɔ z ɪ t͡ʃ ɑ t ɪ
українським	u k r ɛ j i nʲ sʲ k ɪ m
сусідка	s u sʲ i d k ɛ
релігійний	r ɪ lʲ i ɦ i i n ɪ i
виключний	ʋ ɪ k lʲ u t͡ʃ n ɪ i
євразійський	j ɪ u r ɛ zʲ i i sʲ k ɪ i
абстракціоніст	ɛ b s t r ɛ k t͡sʲ i ɔ nʲ i s t
вишня	ʋ ɪ ʃ nʲ ɛ
гратися	ɦ r ɑ t ɪ sʲ ɛ
продукція	p r ɔ d u k t͡sʲ i j ɛ
сотий	s ɔ t ɪ i
крига	k r ɪ ɦ ɛ
міфологія	m i f ɔ ɫ ɔ ɦ i j ɛ
скайдайвінг	s k ɛ i d ɑ j ʋ i n ɦ
маніпуляція	m ɛ nʲ i p u lʲ ɑ t͡sʲ i j ɛ
стандарту	s t ɛ n d ɑ r t u
майонез	m ɛ j ɔ n ɛ z
обдарувати	ɔ b d ɛ r u ʋ ɑ t ɪ
дисиміляція	d ɪ s ɪ m i lʲ ɑ t͡sʲ i j ɛ
дев'ятеро	d ɛ ʋ j ɛ t ɪ r ɔ
займати	z ɛ i m ɑ t ɪ
водосховище	ʋ ɔ d ɔ s x ɔ ʋ ɪ ʃ t͡ʃ ɪ
моногамний	m ɔ n ɔ ɦ ɑ m n ɪ i
іспанія	i s p ɑ nʲ i j ɛ
рибка	r ɪ b k ɛ
прийменник	p r ɪ i m ɛ n ɪ k
перукар	p ɪ r u k ɑ r
погоджуватися	p ɔ ɦ ɔ d͡ʒ u ʋ ɛ t ɪ sʲ ɛ
клоччя	k ɫ ɔ t͡ʃʲː ɛ
заїр	z ɛ j i r
центр	t͡s ɛ n t r
відчути	ʋ i d͡ʒ t͡ʃ u t ɪ
спалах	s p ɑ ɫ ɛ x
остаточний	ɔ s t ɛ t ɔ t͡ʃ n ɪ i
шабля	ʃ ɑ b lʲ ɛ
завіса	z ɛ ʋ i s ɛ
шестигранний	ʃ ɪ s t ɪ ɦ r ɑ n ɪ i
молоко	m ɔ ɫ ɔ k ɔ
суть	s u tʲ
поступку	p ɔ s t u p k u
безпідставний	b ɪ zʲ p i d͡z s t ɑ u n ɪ i
янтар	j ɛ n t ɑ r
законодавство	z ɛ k ɔ n ɔ d ɑ u s t ʋ ɔ
міряти	m i rʲ ɛ t ɪ
сир	s ɪ r
гривню	ɦ r ɪ u nʲ u
ласка	ɫ ɑ s k ɛ
рилу	r ɪ ɫ u
семисотий	s ɪ m ɪ s ɔ t ɪ i
латвія	ɫ ɑ tʲ ʋ i j ɛ
доріжка	d ɔ rʲ i ʒ k ɛ
велосипедистка	ʋ ɪ ɫ ɔ s ɪ p ɪ d ɪ s t k ɛ
шістнадцятий	ʃ i s t n ɑ d͡zʲ t͡sʲ ɛ t ɪ i
готувати	ɦ ɔ t u ʋ ɑ t ɪ
крихітний	k r ɪ x i t n ɪ i
упевненість	u p ɛ u n ɪ nʲ i sʲ tʲ
комедій	k ɔ m ɛ dʲ i i
напружити	n ɛ p r u ʒ ɪ t ɪ
східноєвропейський	sʲ x i d n ɔ j ɪ u r ɔ p ɛ i sʲ k ɪ i
соня	s ɔ nʲ ɛ
абсорбер	ɛ b s ɔ r b ɪ r
лист	ɫ ɪ s t
аероскопія	ɛ ɪ r ɔ s k ɔ p i j ɛ
мур	m u r
процедурний	p r ɔ t͡s ɪ d u r n ɪ i
сорго	s ɔ r ɦ ɔ
пінистий	p i n ɪ s t ɪ i
занурювати	z ɛ n u rʲ u ʋ ɛ t ɪ
питання	p ɪ t ɑ nʲ ɛ
політично	p ɔ lʲ i t ɪ t͡ʃ n ɔ
авіадесантник	ɛ ʋ i ɛ d ɪ s ɑ n t n ɪ k
галиця	ɦ ɑ ɫ ɪ t͡sʲ ɛ
монархіє	m ɔ n ɑ r x i j ɪ
артеріям	ɛ r t ɛ rʲ i j ɛ m
винахідливість	ʋ ɪ n ɛ x i d ɫ ɪ ʋ i sʲ tʲ
опанувати	ɔ p ɛ n u ʋ ɑ t ɪ
відродити	ʋ i d r ɔ d ɪ t ɪ
корінь	k ɔ rʲ i nʲ
авіатранспорт	ɛ ʋ i ɛ t r ɑ n s p ɔ r t
шаньга	ʃ ɑ nʲ ɦ ɛ
здріти	z dʲ rʲ i t ɪ
авіавиставка	ɛ ʋ i ɛ ʋ ɪ s t ɛ u k ɛ
росіянин	r ɔ sʲ i j ɑ n ɪ n
олег	ɔ ɫ ɛ ɦ
пауз	p ɑ u z
інфекцію	i n f ɛ k t͡sʲ i j u
швидкий	ʃ ʋ ɪ d k ɪ i
відкладати	ʋ i d k ɫ ɛ d ɑ t ɪ
безчесний	b ɪ ʒ t͡ʃ ɛ s n ɪ i
спростити	s p r ɔ s t ɪ t ɪ
віру	ʋ i r u
метрів	m ɛ tʲ rʲ i u
стопа	s t ɔ p ɑ
осмислювати	ɔ s m ɪ sʲ lʲ u ʋ ɛ t ɪ
пошук	p ɔ ʃ u k
найбільший	n ɛ i b i lʲ ʃ ɪ i
анонімність	ɛ n ɔ nʲ i m nʲ i sʲ tʲ
опис	ɔ p ɪ s
житловий	ʒ ɪ t ɫ ɔ ʋ ɪ i
частинка	t͡ʃ ɛ s t ɪ n k ɛ
гріб	ɦ rʲ i b
риж	r ɪ ʒ
репродуктивний	r ɪ p r ɔ d u k t ɪ u n ɪ i
й	j
виборі	ʋ ɪ b ɔ rʲ i
направляти	n ɛ p r ɛ u lʲ ɑ t ɪ
сонце	s ɔ n t͡s ɪ
хотіти	x ɔ tʲ i t ɪ
ваги	ʋ ɛ ɦ ɪ
слуховий	s ɫ u x ɔ ʋ ɪ i
надії	n ɛ dʲ i j i
шокований	ʃ ɔ k ɔ ʋ ɛ n ɪ i
роззброювати	r ɔ z b r ɔ j u ʋ ɛ t ɪ
підвищувати	p i d ʋ ɪ ʃ t͡ʃ u ʋ ɛ t ɪ
коронавірус	k ɔ r ɔ n ɛ ʋ i r u s
бурштин	b u r ʃ t ɪ n
освітній	ɔ sʲ ʋ i tʲ nʲ i i
визначення	ʋ ɪ z n ɛ t͡ʃ ɪ nʲ ɛ
вказівний	ʋ k ɛ zʲ i u n ɪ i
капітал	k ɛ p i t ɑ ɫ
пропорції	p r ɔ p ɔ r t͡sʲ i j i
гордитися	ɦ ɔ r d ɪ t ɪ sʲ ɛ
пізніший	p i zʲ nʲ i ʃ ɪ i
гро	ɦ r ɔ
безжалісний	b ɪ ʒ ɑ lʲ i s n ɪ i
шкіра	ʃ k i r ɛ
педагог	p ɪ d ɛ ɦ ɔ ɦ
термінологічний	t ɪ r m i n ɔ ɫ ɔ ɦ i t͡ʃ n ɪ i
раціям	r ɑ t͡sʲ i j ɛ m
вагітність	ʋ ɛ ɦ i tʲ nʲ i sʲ tʲ
роман	r ɔ m ɑ n
продавщиця	p r ɔ d ɛ u ʃ t͡ʃ ɪ t͡sʲ ɛ
чотирикутний	t͡ʃ ɔ t ɪ r ɪ k u t n ɪ i
оберігати	ɔ b ɪ rʲ i ɦ ɑ t ɪ
сцена	s t͡s ɛ n ɛ
безособовий	b ɪ z ɔ s ɔ b ɔ ʋ ɪ i
вираховувати	ʋ ɪ r ɛ x ɔ ʋ u ʋ ɛ t ɪ
своє	s ʋ ɔ j ɛ
позаземний	p ɔ z ɛ z ɛ m n ɪ i
підняти	p i dʲ nʲ ɑ t ɪ
три	t r ɪ
коханий	k ɔ x ɛ n ɪ i
поліпшити	p ɔ lʲ i p ʃ ɪ t ɪ
досягнення	d ɔ sʲ ɑ ɦ n ɪ nʲ ɛ
найманець	n ɑ i m ɛ n ɪ t͡sʲ
діставатися	dʲ i s t ɛ ʋ ɑ t ɪ sʲ ɛ
щастя	ʃ t͡ʃ ɑ sʲ tʲ ɛ
простота	p r ɔ s t ɔ t ɑ
розчарування	r ɔ ʒ t͡ʃ ɛ r u ʋ ɑ nʲ ɛ
непомірний	n ɪ p ɔ m i r n ɪ i
сентиментальний	s ɪ n t ɪ m ɪ n t ɑ lʲ n ɪ i
електрика	ɪ ɫ ɛ k t r ɪ k ɛ
салдат	s ɛ ɫ d ɑ t
королевич	k ɔ r ɔ ɫ ɛ ʋ ɪ t͡ʃ
ананас	ɛ n ɛ n ɑ s
термометр	t ɪ r m ɔ m ɪ t r
марія	m ɛ rʲ i j ɛ
ріпами	rʲ i p ɛ m ɪ
властивий	ʋ ɫ ɛ s t ɪ ʋ ɪ i
всередині	ʋ s ɪ r ɛ d ɪ nʲ i
троє	t r ɔ j ɪ
брати	b r ɛ t ɪ
розвідування	r ɔ zʲ ʋ i d u ʋ ɛ nʲ ɛ
постатям	p ɔ s t ɛ tʲ ɛ m
звичайний	z ʋ ɪ t͡ʃ ɑ i n ɪ i
куди	k u d ɪ
виснажувати	ʋ ɪ s n ɑ ʒ u ʋ ɛ t ɪ
рівновага	rʲ i u n ɔ ʋ ɑ ɦ ɛ
рівне	rʲ i u n ɪ
орбіт	ɔ r b i t
мікроскоп	m i k r ɔ s k ɔ p
прапір	p r ɑ p i r
вужчий	ʋ u ʒ t͡ʃ ɪ i
шкірах	ʃ k i r ɛ x
гетьман	ɦ ɛ tʲ m ɛ n
жолудь	ʒ ɔ ɫ u dʲ
житель	ʒ ɪ t ɪ lʲ
диван	d ɪ ʋ ɑ n
глибина	ɦ ɫ ɪ b ɪ n ɑ
конвенція	k ɔ n ʋ ɛ nʲ t͡sʲ i j ɛ
забороняти	z ɛ b ɔ r ɔ nʲ ɑ t ɪ
шоколад	ʃ ɔ k ɔ ɫ ɑ d
веретено	ʋ ɪ r ɪ t ɛ n ɔ
розвальні	r ɔ z ʋ ɛ lʲ nʲ i
цвіт	t͡sʲ ʋ i t
аболіціоніст	ɛ b ɔ lʲ i t͡sʲ i ɔ nʲ i s t
незалежності	n ɪ z ɛ ɫ ɛ ʒ n ɔ sʲ tʲ i
працівницям	p r ɛ t͡sʲ i u n ɪ t͡sʲ ɛ m
бомба	b ɔ m b ɛ
копил	k ɔ p ɪ ɫ
інструмент	i n s t r u m ɛ n t
транспортувати	t r ɛ n s p ɔ r t u ʋ ɑ t ɪ
вітряний	ʋ i tʲ rʲ ɛ n ɪ i
поїти	p ɔ j i t ɪ
дейтон	d ɛ i t ɔ n
щедрий	ʃ t͡ʃ ɛ d r ɪ i
запобігання	z ɛ p ɔ b i ɦ ɑ nʲ ɛ
залежний	z ɛ ɫ ɛ ʒ n ɪ i
голландія	ɦ ɔ ɫ ɑ nʲ dʲ i j ɛ
білолиций	b i ɫ ɔ ɫ ɪ t͡s ɪ i
потенціал	p ɔ t ɪ nʲ t͡sʲ i ɑ ɫ
молодиці	m ɔ ɫ ɔ d ɪ t͡sʲ i
порядковий	p ɔ rʲ ɛ d k ɔ ʋ ɪ i
мітотичний	m i t ɔ t ɪ t͡ʃ n ɪ i
в'язень	ʋ j ɑ z ɪ nʲ
дерев'яний	d ɪ r ɪ ʋ j ɑ n ɪ i
календарний	k ɛ ɫ ɪ n d ɑ r n ɪ i
тут	t u t
погода	p ɔ ɦ ɔ d ɛ
дядьо	dʲ ɑ dʲ ɔ
обґрунтувати	ɔ b ɡ r u n t u ʋ ɑ t ɪ
інституційний	i n s t ɪ t u t͡sʲ i i n ɪ i
мікрофон	m i k r ɔ f ɔ n
верховна	ʋ ɪ r x ɔ u n ɛ
споживача	s p ɔ ʒ ɪ ʋ ɛ t͡ʃ ɑ
ворона	ʋ ɔ r ɔ n ɛ
ловелас	ɫ ɔ ʋ ɪ ɫ ɑ s
клавіатурам	k ɫ ɛ ʋ i ɛ t u r ɛ m
інфікування	i nʲ f i k u ʋ ɑ nʲ ɛ
пухлина	p u x ɫ ɪ n ɛ
озимий	ɔ z ɪ m ɪ i
унікальний	u nʲ i k ɑ lʲ n ɪ i
здібний	zʲ dʲ i b n ɪ i
озерце	ɔ z ɪ r t͡s ɛ
пов'язати	p ɔ ʋ j ɛ z ɑ t ɪ
психологічний	p s ɪ x ɔ ɫ ɔ ɦ i t͡ʃ n ɪ i
працівникам	p r ɛ t͡sʲ i u n ɪ k ɑ m
вчити	ʋ t͡ʃ ɪ t ɪ
омбудсмен	ɔ m b u d͡z s m ɛ n
вікісловник	ʋ i k i s ɫ ɔ u n ɪ k
посидіти	p ɔ s ɪ dʲ i t ɪ
змій	zʲ m i i
укус	u k u s
бонусом	b ɔ n u s ɔ m
волокти	ʋ ɔ ɫ ɔ k t ɪ
доросла	d ɔ r ɔ s ɫ ɛ
апатичний	ɛ p ɛ t ɪ t͡ʃ n ɪ i
чорні	t͡ʃ ɔ r nʲ i
млин	m ɫ ɪ n
розгромити	r ɔ z ɦ r ɔ m ɪ t ɪ
богослов'я	b ɔ ɦ ɔ s ɫ ɔ ʋ j ɛ
синонімічний	s ɪ n ɔ nʲ i m i t͡ʃ n ɪ i
обережний	ɔ b ɪ r ɛ ʒ n ɪ i
типовий	t ɪ p ɔ ʋ ɪ i
суднобудівник	s u d n ɔ b u dʲ i u n ɪ k
тисячоліттях	t ɪ sʲ ɛ t͡ʃ ɔ lʲ i tʲ ɛ x
кухарка	k u x ɛ r k ɛ
ющенко	j u ʃ t͡ʃ ɪ n k ɔ
безвідсотковий	b ɪ zʲ ʋ i d͡z s ɔ t k ɔ ʋ ɪ i
саботувати	s ɛ b ɔ t u ʋ ɑ t ɪ
молочний	m ɔ ɫ ɔ t͡ʃ n ɪ i
висловлюватися	ʋ ɪ s ɫ ɔ u lʲ u ʋ ɛ t ɪ sʲ ɛ
урожай	u r ɔ ʒ ɑ i
досьє	d ɔ sʲ j ɛ
підозра	p i d ɔ z r ɛ
заохотити	z ɛ ɔ x ɔ t ɪ t ɪ
урізноманітнити	u rʲ i z n ɔ m ɛ nʲ i t n ɪ t ɪ
додатках	d ɔ d ɑ t k ɛ x
щоко	ʃ t͡ʃ ɔ k ɔ
обґрунтований	ɔ b ɡ r u n t ɔ ʋ ɛ n ɪ i
інвестиційний	i n ʋ ɪ s t ɪ t͡sʲ i i n ɪ i
освіжати	ɔ sʲ ʋ i ʒ ɑ t ɪ
ґніт	ɡ nʲ i t
священик	sʲ ʋ ɛ ʃ t͡ʃ ɛ n ɪ k
раптом	r ɑ p t ɔ m
референдумах	r ɪ f ɪ r ɛ n d u m ɛ x
жона	ʒ ɔ n ɑ
землевласник	z ɪ m ɫ ɪ u ɫ ɑ s n ɪ k
цвіркун	t͡sʲ ʋ i r k u n
жарт	ʒ ɑ r t
звикнути	z ʋ ɪ k n u t ɪ
високосний	ʋ ɪ s ɔ k ɔ s n ɪ i
діаграма	dʲ i ɛ ɦ r ɑ m ɛ
автодидакт	ɛ u t ɔ d ɪ d ɑ k t
ми	m ɪ
клавіатур	k ɫ ɛ ʋ i ɛ t u r
чотири	t͡ʃ ɔ t ɪ r ɪ
розташовувати	r ɔ z t ɛ ʃ ɔ ʋ u ʋ ɛ t ɪ
надзвуковий	n ɛ d͡z ʋ u k ɔ ʋ ɪ i
сповіщення	s p ɔ ʋ i ʃ t͡ʃ ɪ nʲ ɛ
