سائبان	s a: iː b a: n
کہ	k eː
کہانی	k ə ɦ a: n iː
صحافت	s ɪ ɦ a: f ə t
خوش	x ʊ ʃ
گودھرا	ɡ oː dʰ ɽ aː
کنی	k ə n iː
خنجر	x ə n d͡ʒ ə ɽ
ہماہمی	ɦ ə m a: ɦ ə m iː
روبہ	r oː b a:
مکانپور	m ə k a: n p ɔː ɽ
پھیلاو	pʰ ɛː l a: ʋ
بمقابلہ	b ə m q a: b l ə ɦ
بکس	b ə k s
مرحومہ	m ə ɽ ɦ uː m ə
محسن	m ʊ ɦ s ə n
ہائیکورٹ	ɦ aː iː k ɔː ɽ ʈ
چکنا	t͡ʃ ʊ k n a:
دریا	d ə ɽ iː a:
باضابطہ	b a: z a: b ɪ t ɦ a:
فیاض	f j a: z
سج	s ə d͡ʒ
ایت	ə j ʊ t
چھڑکاؤ	t͡ʃʰ ɪ ɽ k a: oː
نہس	n ɛ ɦ s
حرف	ɦ ɛː ɽ f
فارسی	f a: ɽ s iː
قدوائی	q ʊ d ʋ aː ɪ
پریم	p ɽ eː m
باولی	b aː oː l iː
نائٹ	n aɪ t
اکثر	ə k s ə ɽ
مالدیپ	m a: l d iː p
رضوی	ɽ ɪ z ʋ iː
آئٹمس	a: ɪ ʈ m s
آیئنا	a: iː ə n ə
سرگرم	s ə ɽ ɡ ə ɽ m
اجتماع	ɪ d͡ʒ t ɪ m aː a
بنجر	b ʊ n d͡ʒ ɛ r
پہ	p eː
سری۔لنکائی	s ə ɽ iː l ə n k a: iː
اضطراری	ɪ z t ɪ ɽ a: ɽ iː
سمراٹ	s ə m ɽ a: ʈ
دیوبندی	d eː ʋ b ə n d iː
حقیئقت	ɦ ə q iː q ə t
رابطہ	ɽ a: b t a:
جاننا	d͡ʒ a: n n a:
کنٹراکٹر	k a n ʈ r a: k ʈ a r
ہوٹل	ɦ oː ʈ ə l
ہوشیار	ɦ oː ʃ ɪ j a: ɽ
منڈا	m ʊ n ɖ a:
کمیونٹی	k a m j uː n ɪ ʈ iː
ہستم	ɦ ə s t ə m
بھالو	bʰ a: l uː
بہن	bʰ ɛː n
کشٹاریڈی	k ʊ ʃ t a: ɽ iː d iː
اوپینین	oː p iː n iː n
بریلی	b ɽ iː l iː
گرجنا	ɡ ə ɽ ə d͡ʒ n a:
الاسد	ə l a: s d
ٹیکس	ʈ iː k s
جہازی	d͡ʒ ə ɦ a: z iː
حویلی	ɦ ə ʋ eː l iː
المقدس	ʔ ə l m ʊ q d ə s
وجود	ʋ ə d͡ʒ uː d
چھٹی	t͡ʃʰ ʊ ʈ iː
نوبت	n ɔː b ə t
فلک۔نما	f ɪ l k n ə m a:
ترجیح	t ə ɽ d͡ʒ iː ɦ
پتی	p ə t t iː
آشکارا	a: ʃ k a: ɽ a:
کواری	k ʋ a: r iː
شیپ	ʃ eː p
محدود	m ə ɦ d uː d
آنجہانی	a: n d͡ʒ ə ɦ aː n iː
جامن	d͡ʒ a: m ə n , d͡ʒ a: m ʊ n
یا	j a:
اوباما	ɔː b a: m a:
ورما	ʋ ɔː ɽ m a:
گائناکالوجی	ɡ a: iː n a: k a: l oː d͡ʒ iː
جانی	d͡ʒ a: n iː
نشور	n ʊ ʃ uː ɽ
کوی۶	k oː ɪ a 6
روشنی	ɽ ɔː ʃ n iː
اسٹیونس	ə s ʈ iː ʋ oː n s
جوس	d͡ʒ oʊ s
ارسال	ə ɽ s a: l
سینیٹر	s iː n eː ʈ ə ɽ
سوچنا	s oː t͡ʃ n a:
کیمیائی	k iː m ɪ j a: iː
مسلمان	m ʊ s ə l m a: n
فصل	f a s l
وفاق	ʋ ɪ f a: q
خواہ	x a: ɦ
فیڈنگ	f iː d ɪ ŋ ɡ
بهیس	bʰ eː s
کورٹ	k ɔː r ʈ
سخت	s ʊ x t
بےحیائی	b eː ɦ j a: iː
طور	t ɔː ɽ
حقوق	ɦ ʊ q uː q
پاؤں	p a: u:
شہلا	ʃ ə ɦ l a:
پٹے	p a t eɪ
خسر	x ʊ s ɽ
محنت	m ɪ ɦ n ə t
مرد	m ə ɽ d
اصلاح	ɪ s l a: ɦ
انڈیا	ɪ n ɖ ɪ j a:
بہیرہ	b ə ɦ eː ɽ ə
بیک	b eː k
ناصرت	n a: s ə ɽ ə t
ویژن	ʋ iː ʒ ə n
مہارانی	m ə ɦ a: ɽ a: n iː
موسم	m ɔː s ə m
دھوج	dʰ ʋ ə d͡ʒ
نا	n a:
رفتہ	r a f t ə
بہار	b ə ɦ a: ɽ
سوستک	s ʋ ə s t ɪ k
ازاں	a: z a: n
ایووکیڈو	ɛ j uː k iː d oʊ
بت	b ʊ t
روزگار	r oː z ɡ a: r
جڑ	d͡ʒ ə ɽ
بینچ	b iː n t͡ʃ
ہتھیلی	ɦ ə tʰ eː l iː
چیارٹیبل	t͡ʃ iː a: ɽ ʈ iː b ʊ l
یسعیاہ	j ə s a: ʔ j a: ɦ
ایلینا	ʔ eː l iː n a:
ثقافت	s ə q a: f ə t
محتاجی	m ʊ ɦ t a: d͡ʒ iː
محشر	m ə ɦ ʃ ə ɽ
سوٹ	s uː ʈ
چوری	t͡ʃ oː ɽ iː
ہیڈکوارٹر	ɦ iː ʈ k ʋ a: ɽ ʈ ə ɽ
بستی	b ə s t iː
تضاد	t ʊ z a: d
بناوٹی	b ə n a: ʋ ə ʈ iː
چیتاپور	t͡ʃ iː t aː p ɔː r
چنتا	t͡ʃ ɪ n t a:
عجب	a d͡ʒ a b
بال	b a: l
اخراجات	a: x r a: d͡ʒ a: t
اغوا	ɪ ɣ ʋ a:
عرض	ə ɽ z
بنچس	b ə n t͡ʃ ə s
مچھلی	m ə t͡ʃʰ l iː
آڈیٹنگ	a: d ɪ t ɪ ŋ
آوشيکتا	a: ʋ ə ʃ j ə k t a:
عناصر	a ɪ n a: s ə r
ڈابسن	ɖ a: b s ə n
دودھ	d uː dʰ
ریختہ	ɽ eː x t a:
ماحول	m a: ɦ ɔː l
دھواں	dʰ uː a:
کلب	k ʊ l b
خراش	x ə ɽ a: ʃ
خداوندی	x ʊ d a: ʋ ə n d iː
ہمسفر	ɦ ə m s ə f ə ɽ
حصول	ɦ ʊ s uː l
اینٹی	ʔ eː n ʈ iː
منشیات	m ʊ n ə ʃ ɪ j a: t
حالت	ɦ a: l ə t
وضو	ʋ ʊ z uː
نجیب	n ə d͡ʒ iː b
دسواں	d ə s ʋ a:
غلام	ɣ ʊ l a: m
جپنا	d͡ʒ ə p n a:
دلچسپی	d ɪ l t͡ʃ ʊ s p iː
لوتھ	l oː tʰ
گہہ	ɡ ə ɦ ɦ
دبئی	d ʊ b ə iː
گھیرنے	ɡʰ iː r n eɪ
کوبائلوبہ	k ʋ ʊ b a: iː l ʋ ʊ b a:
جرأت	d͡ʒ ʊ ɽ ɽ ə t
ہندوستانی	ɦ ɪ n d ʊ s t a: n iː
مفتاحی	m uː f t aː ɦ iː
شبہات	ʃ ə b ɦ a: t
یت	ɪ j ə t
سمجھ	s ʊ m d͡ʒʰ
بلے	b ʊ l eː
مرتیو	m ɽ ɪ t j uː
بہنا	b ɛ ɦ n a:
دلیری	d ə l iː ɽ iː
نسق	n ɪ s q
بلی	b ə l iː
خاصا	x a: s a:
ماسٹر	m a: s ʈ ə ɽ
بہاراں	b ə ɦ a: ɽ a:
صاحب	s a: ɦ ɪ b
رفتار	ɽ ə f t a: ɽ
روا	r ʋ a:
اذیت	ə z iː t
اژدہا	ə ʒ d ə ɦ a:
خودمختاری	x ʊ d m ʊ x t a: ɽ iː
پردیش	p ɽ ə d iː ʃ
تحقیقی	t ə ɦ ə q iː q iː
بودھن	b oː dʰ ə n
پھل	pʰ ə l
کھٹائی	kʰ ə ʈ a: iː
انت	ə n t
داعش	d a: ʔ ɪ ʃ
نارا	n a: ɽ a:
لنگایت	l ɪ ŋ ɡ a: j ə t
یوں	j u: n
بڑھتا	b ə ɽ ʈ a:
طالب	ʈ a: l ɪ b
ہسپانیہ	ɦ ə s p a: n ɪ j ə ɦ
مینہ	m e: ɦ
گیڈ	ɡ eː ɖ
تیزاب	t eː z aː b
اطمینان	ɪ t m iː n a: n
شب	ʃ a b
متعلق	m ʊ t a ʊ l ɪ q
کنٹیشور	k a n ʈ iː ʃ ɔː r
عمر	a m r
حامدالاحمر	ɦ a: m ɪ d ʔ a: l a: ɦ m ɛː ɽ
اشبیلیہ	ə ʃ b iː l ɪ j a: ɦ
رشادی	r ə ʃ a: d iː
سنجیدگی	s ʊ n d͡ʒ iː d ɡ iː
پہن	p ɛː n
لاہور	l ə ɦ oː ɽ
بوائز	b oʊ z
پرنسپل	p ə ɽ n s p ə l
برن	b ə ɽ n
کاپی	k a: p iː
ژالہ	ʒ a: l ə
انڈکوش	ə n ɖ ə k oː ʃ
ہاما	ɦ a: m a:
موقع	m ɔː q a:
سلیور	s ʊ l j ɔː ɽ
فلاحی	f l a: ɦ iː
فاروق	f a: ɽ ʊ q
مکہ	m ə k ə
سنسکرت	s ə n s k ɽ ɪ t
ٹکٹس	ʈ ɪ k ʈ s
غداری	ɣ ə d aː ɽ iː
کندرا	k ə n d ə ɽ a:
معاملہ	m ʊ a: m l a:
یونیورسٹی	j uː n iː ʋ a r s ʈ iː
خاکستری	x a: k ɪ s t ə ɽ iː
ہندوستان	ɦ ɪ n d ʊ s t a: n
سبقت	s ʊ b q ʊ t
جدا	d͡ʒ ʊ d a:
ہوڑا	ɦ ʊ r a:
ندیاں	n ə d ɪ j a:
اتفاق	ɪ t t ɪ f a: q
داردر	d a: ɽ ɪ d ɽ
تمنا	t ə m ə n n a:
پیڑ	p eː ɽ
کونسل	k oː n s ə l
کھجلی	kʰ ʊ d͡ʒ l iː
معین	m ʊ ʔ iː n
اورمعیاری	ɔː ɽ m a ɪ j a: ɽ iː
اسٹیڈیم	ə s t iː d iː m
اشتمالیت	ɪ ʃ t e m a: l ɪ j ə t
بعدازاں	b aː d a: z a: n
دھرتی	dʰ ə ɽ t iː
میٹروپولیٹن	m eː ʈ ɽ ʊ p ʊ l iː ʈ ʊ n
نیلا	n iː l a:
ہدیۂ	ɦ ə d iː ə
ہانکنا	ɦ a: ŋ k n a:
ہمارا	ɦ ə m a: ɽ a:
مراکش	m ə ɽ a: k e ʃ
نشست	n ə ʃ ɪ s t
اردن	a: r d ə n
مٹانا	m ɪ ʈ a: n a:
پلانڈو	p ə l a: n ɖ uː
لاما	l a: m a:
اکابر	ʔ a: k a: b ɛː ɽ
ققنس	q ə q n ʊ s
ندیوں	n ə d ɪ j o:
آفت	a: f ə t
لیئج	l ɪ j eː d͡ʒ
ایف	eː f
سوغات	s ɔː ɣ a: t
بھانگ	bʰ a: ŋ ɡ
پدما	p ə d m a:
گولہ	ɡ oː l a
گرمکھی	ɡ ʊ ɽ m ʊ kʰ iː
عبدالعزیز	a ʊ b d ʊ l a ʊ z iː z
وینجن	ʋ j ə n d͡ʒ ə n
خاطیوں	x a: t iː j oː n
دستبردار	d ʊ s t b ɛ r d a: r
مہربن	m ə ɦ r b ə n
کامرس	k aː m ə ɽ s
بیزار	b eɪ z a: r
چوتھائی	t͡ʃ ɔː tʰ a: iː
ناگ	n a: ɡ
پستان	p ɪ s t a: n
قاتل	q a: t ɪ l
فرضی	f ə ɽ z iː
منیجر	m ə n iː d͡ʒ ə r
انگلی	ʊ ŋ ɡ l iː
ککش	k ə k ʃ
الشیخ	ʔ ʊ l ʃ eː x
ونا	ʋ ɪ n a:
آکسیجن	a: k s iː d͡ʒ ə n
مالگاڑی	m a: l ɡ a: ɽ iː
قومیت	q ɔː m ɪ j j ə t
خودکشی	x ʊ d k ʊ ʃ iː
خالد	x a: l ɪ d
اضافہ	ɪ z a: f ə
وصولی	ʋ ʊ s uː l iː
بوتے	b ʊ t eː
پورا	p uː ɽ a:
ریاست	ɽ iː j a: s ə t
بہاؤالدین	b ə ɦ a: ʔ ʊ d d iː n
خداوند	x ʊ d a: ʋ ə n d
آدھنک	a: dʰ ʊ n ɪ k
گگن	ɡ ə ɡ ə n
کھاگ	kʰ a: ɡ
شریر	ʃ ə ɽ iː ɽ
دعوہ	d ʊ ʔ a:
مےئر	m eː ɪ ɽ
ندیو	n ə d ɪ j oː
ماریشیس	m a: r iː ʃ iː s
بیٹھ	b eː ʈʰ
فورا	f ɔː ɽ ə n
بھال	bʰ a: l
ڈگیس	ɖ ɪ ɡ iː s
انقلاب	ɪ n q ɪ l a: b
اطلاقی	ɪ t l a: q iː
چاٹنا	t͡ʃ a: ʈ n a:
ثبوت	s ə b uː t
اناج	a: n a: d͡ʒ
واقف	ʋ a: q ɪ f
شلپا	ʃ ʊ l p a:
مذاق	m ə z a: q
موجھی	m oʊ d͡ʒʰ iː
شوٹنگ	ʃ oː ʈ ɪ ŋ
احمد	ʔ ə ɦ m ə d
رامو	ɽ a: m ʊ
میں	m e:
گلابی	ɡ ʊ l a: b iː
جگاڑ	d͡ʒ ʊ ɡ a: ɽ
سیلسیس	s iː l s iː s
خریدی	x ə r iː d iː
مکھو	m ʊ kʰ oː
پیاس	p j a: s
جائیداد	d͡ʒ a: ɪ d a: d
پہنچنا	p ə ɦ ʊ t͡ʃ n a:
یقینا	j ə q iː n ə n
دلچسپ	d ɪ l t͡ʃ ə s p
جواہر	d͡ʒ ʋ a: ɦ ə r
كر	k ə r
تنظیم	t ə n z iː m
آفسیر	a: f s iː ɽ
پردیب	p ə ɽ d iː b
گج	ɡ ə d͡ʒ
ڈپٹی	ɖ ə p ʈ iː
کہرا	k ʊ ɦ ɽ a:
مضحکہ	m ʊ z ɦ a: k ə
چیٹا	t͡ʃ iː ʈ a:
سمن	s ʊ m ə n
استثنی	ɪ s t ɪ s n a: iː
ہمیں	ɦ ə m e:
ٹکراؤ	ʈ ɪ k ɽ a: ʊ
نکال	n ɪ k a: l
منسٹرا	m ə n s ʈ ɽ a:
لکیج	l ə k iː d͡ʒ
سنجہا	s ʊ n d͡ʒ ɦ a:
دال	d a: l
طلبہ	ʈ ə l b ə ɦ
عشرت	a ɪ ʃ r ə t
کینسر	k æ n s ə ɽ
فالکن	f a: l k ə n
انگور	ə n ɡ uː ɽ
ٹرانزیشنل	ʈ r a: n z iː ʃ a n l
اندلس	ʊ n d ʊ l ʊ s
آسکت	a: s ə k t
سرونام	s ə ɽ ʋ n a: m
ترملگیری	t ɛ r m ʊ l ɡ iː r iː
مراٹھی	m ə ɽ a: ʈʰ iː
چوبیس	t͡ʃ oː b iː s
ازدواج	ɪ z d ɪ ʋ a: d͡ʒ
کوڈا	k ʊ d a:
پوجا	p uː d͡ʒ a:
عشق	ɪ ʃ q
وہاں	ʋ ə ɦ a:
بیٹے	b eː ʈ eː
گھاو	ɡʰ a: ʋ
گذراننا	ɡ ʊ z ɽ a: n n a:
عزا	a ɪ z a:
سرشپ	s ə ɽ ʂ ə p
دھو	dʰ uː
سرسید	s ə ɽ s iː d
مسٹالا	m ʊ s ʈ a: l a:
راجیم	r a: d͡ʒ iː m
روپیا	ɽ uː p iː a:
غیرموسمی	ɣ ɛː ɽ m oː s m iː
انتہاپسند	ɪ n t e ɦ a: p ə s ə n d
عزیز	ə z iː z
سنیوگ	s ə j oː ɡ
تقریبا	t ə q ɽ iː b a:
ملن	m ɪ l ə n
اطالیہ	ɪ t a: l ɪ j a: ɦ
سرور	s ʊ ɽ uː ɽ
سرمہ	s ʊ ɽ m a:
گیارنٹی	ɡ j a: r n ʈ iː
پیاز	p ɪ j a: z
مخاطب	m ʊ x a: t ɪ b
سربرآوردہ	s ɛ r b ɛ r a: ʋ ɛ r d a:
پرتبھا	p ə r t ʊ bʰ a:
نشریات	n ə ʃ ɽ ɪ j a: t
شہادت	ʃ ə ɦ a: d ə t
ابن	ə b n
تمام۔تر	t ʊ m a: m t ɽ
چلانا	t͡ʃ ɪ l l a: n a:
قرطبہ	q ʊ ɽ t ə b a: ɦ
چٹس	t͡ʃ ə ʈ s
چلچتر	t͡ʃ ə l t͡ʃ ɪ t ɽ ə
رہنا	ɽ ə ɦ n a:
پون	p ə ʋ ə n
بریہ	b ə ɽ j ə
ایشور	iː ʃ ʋ ə ɽ
مرمت	m ə ɽ ə m ə t
ڈال	ɖ a: l
گھرا	ɡʰ ɛː ɽ a:
فائر	f aː ɪ ɽ
عالمی	a a: l ə m iː
دھمکا	dʰ ʊ m k a:
ممنوعہ	m ə m n oː a ə ɦ
باز	b a: z
اندیشہ	ɪ n d iː ʃ a:
لاٹھی	l a: ʈʰ iː
شریعت	ʃ ə ɽ iː ʔ j ə t
معدنیات	m ʊ ʔ d ə n iː a: t
غیر	ɣ ɛː ɽ
پورم	p ʊ r m
آسمانی	a: s m a: n iː
انارکلی	ə n a: ɽ k ə l iː
قابلیت	q a: b l ɪ j ə t
وفا	ʋ ə f a:
کمی	k ə m iː
جنم	d͡ʒ ə n m
پانڈے	p a: n ʈ e
انہدامی	ʔ ʊ n ɦ d a: m iː
انفورسمنٹ	ɪ n f ɔː r s m ə n ʈ
ضبط	z a b t
متحدہ	m ʊ t ɦ ɛ d a:
سوان	s ʋ a: n
سائمن	s a: ɪ m ʊ n
مقررہ	m ʊ q ɽ a: ɽ ə
شاعرہ	ʃ a: j ɽ a:
امن	ə m ə n
انتظام	ɪ n t ɪ z a: m
ناخدا	n a: x ʊ d a:
الماس	ə l m a: s
اطباء	ɪ t ɪ b a: a:
مقدر	m ʊ q d a: ɽ
اعزازی	a: ɪ z a: z iː
اجناس	ə d͡ʒ n a: s
راجا	ɽ a: d͡ʒ a:
تاڑ	t a: ɽ
حیران	ɦ ɛː ɽ a: n
کنسلٹنگ	k a n s a l t ɪ ŋ ɡ
کمھڑا	k ʊ m ə ɽ a:
دو	d oː
چولھا	t͡ʃ uː l ɦ a:
مئی	m eː ɪ
پٹنہ	p a t n a:
حفاظت	ɦ ɪ f a: z ə t
چودنا	t͡ʃ oː d n a:
آکرمن	a: k ɽ ə m ə n
تیمور	t ɛː m uː ɽ
اطلس	ə t l ə s
بھاشا	bʰ a: ʂ a:
قواعد	q ə ʋ a: ɪ d
آئندہ	a: ɪ n d ə
بامشقت	b a: m ʃ q a t
جڑواں	d͡ʒ ʊ ɽ ʋ a:
آلسی	a: l s iː
اقتصادی	ɪ q t ɪ s a: d iː
داغ	d a: ɣ
کالجس	k a: l d͡ʒ ə s
مظالم	m ʊ z a: l ɪ m
تمہیں	t ʊ m ɦ e:
سبد	s ə b ʊ d
کھیل	kʰ eː l
جٹا	d͡ʒ ə ʈ a:
یونٹس	j ʊ n ɪ t s
دیگر	d eː ɡ ɽ
پربهات	p ɽ ə bʰ a: t
پہلوان	p ə ɦ l ʋ ə n
پدماناتھن	p ʊ d m aː n aː tʰ n
چاہت	t͡ʃ a: ɦ ə t
غیرمحفوظ	ɣ ɛː ɽ m ɦ ʊ f ʊ z
دھمال	dʰ ə m m a: l
دھوپ	dʰ uː p
نانگل	n a: ŋ ɡ ə l
سشما	s ʊ ʃ m a:
بھوتنی	bʰ uː t ɪ n iː
بحیثیت	b ɦ ɪ s iː t
فطرت	f ɪ t ɽ ə t
آلودگی	a: l uː d ə ɡ iː
ہومگارڈ	ɦ oː m ɡ aː r ɖ
ایٹمی	ɛː ʈ m iː
اندھیرا	ə n dʰ iː ɽ aː
حکمرانی	ɦ ʊ k ʊ m ɽ a: n iː
قینچی	q ɛ: t͡ʃ iː
تقلید	t ə q l iː d
جن	d͡ʒ ɪ n n
ٹیچر	ʈ iː t͡ʃ ɪ ɽ
پےنٹ	p eː n ʈ
شارجہ	ʃ a: ɽ d͡ʒ a: ɦ
بٹورنا	b ə ʈ oː ɽ n a:
جوان	d͡ʒ ʋ a: n
گرفتاری	ɡ ɽ ɪ f t a: ɽ iː
مالٹا	m ə l ʈ a:
کیوں	k j ɔː n
تمام	t ə m a: m
ماہ	m aː ɦ
عنصر	a ʊ n s ʊ r
ابلیس	a: b l iː s
سنگھ	s ɪ ŋ ɡʰ
دیپک	d iː p ə k
بٹور	b ʊ t ɔː ɽ
ادھنا	ə dʰ ʊ n a:
آمیزش	a: m eː z ɪ ʃ
ڈھولک	ɖʰ oː l ə k
اکرام	a: k r a: m
کارنامہ	k aː r n aː m ə
مخملی	m ə x m ə l iː
بھوک	bʰ uː k
منٹ	m ɪ n ə ʈ
اشیاء	a ʃ j a: ʔ a:
سپلی	s ə p l iː
طلبی	t a: l b iː
ایکڑ	eː k ə r
چوڑائی	t͡ʃ ɔː ɽ a: iː
استعمال	ɪ s t eː m a: l
مصر	m ɪ s ə ɽ
گلال	ɡ ʊ l a: l
رائےدہندگان	ɽ a: ɪ d ə ɦ ə n d ɡ a: n
دجلہ	d ə d͡ʒ l a:
بہتر	b ə ɦ ə t t ə ɽ
تن	t ə n
میرا	m eː ɽ a:
راضی	ɽ a: z iː
ساحلی	s a: ɦ l iː
تم	t ʊ m
چنگال	t͡ʃ ə ŋ ɡ a: l
سرحد	s ə ɽ ɦ ə d
بہادر	b ə ɦ a: d ə ɽ
عبدالحمید	a b d ʊ l ɦ ə m iː d
اوسطا	ɔː s t ə n
فکسنگ	f ə k s ɪ ŋ
بھکت	bʰ ə k t
ریمارک	r eɪ m a: r k
کھجور	kʰ ə d͡ʒ uː ɽ
شری	ʃ ɽ iː
مانشیرا	m a: n ʃ iː ɽ a:
بابرہ	b a: b ɽ a:
کار	k a: ɽ
اوسو	ɔː s o
اکائی	a: k a: iː
مالک	m a: l ə k
بسا	b ə s a:
نبھانے	n ʊ bʰ a: n eː
سڑک	s ə ɽ ə k
تولیے	t ɔː l ɪ j eː
گرانٹس	ɡ r a: n t s
کارگزاری	k a: r ɡ ʊ z a: r iː
خالق	x a: l ɪ q
باشندہ	b a: ʃ ɪ n d a:
خزاں	x ɪ z a:
کھرجو	kʰ ə ɽ d͡ʒ uː
وسیع	ʋ ʊ s iː a
کمپ	k ə m p
نشریہ	n ə ʃ ɽ ɪ j ə
مایوس۔کن	m aː j oː s k ʊ n
پیلاگو	p iː l aː ɡ oː
کروڑپتی	k ɽ oː ɽ p a t iː
لفظ	l ə f z
اٹاپٹو	a t aː p t o
چندناکھن	t͡ʃ ʊ n d n a: kʰ n
نافذالعمل	n aː f iː z ʔ ə l a ə m ə l
گوناگوں	ɡ oː n a: ɡ oː n
اثبات	ɪ s b a: t
صرفہ	s ʊ ɽ f a:
مسقط	m ə s q ə t
پلانٹ	p l a: n ʈ
انکاؤنٹر	ɪ n k aʊ n t ɛ r
ہنڈی	ɦ ʊ n ɖ iː
مشرا	m ə ʃ ɽ a:
سلام	s ə l a: m
گلو	ɡ ʊ l oː , ɡ ʊ l uː , ɡ ə l uː
پولیت	p oː l iː t
پرستش	p ə ɽ ə s t ɪ ʃ
لمبا	l ə m b a:
پھلنا	pʰ ə l n a:
نوٹ	n oʊ t
مکل	m ʊ k l
سیکھنا	s iː kʰ n a:
ادھو	a dʰ oʊ
دکھانا	d ɪ kʰ a: n a:
بلاآواز	b a l a: a: ʋ a: z
انوکھا	ə n oː kʰ a:
لکژری	l ʊ k z ʊ r iː
شہزادہ	ʃ ə ɦ z a: d a:
اسپیشلسٹ	ə s p eː ʃ l ɪ s ʈ
مے	m ɛː
ادب	ɪ d b
گھڑی	ɡʰ ə ɽ iː
ایرلائینس	ɛː r l aɪ n s
بھرت	bʰ ə r t
مفتی	m ʊ f t iː
مقتول	m ʊ q t uː l
بیلاروس	b eː l a: ɽ uː s
خدا	x ʊ d a:
مواقع	m ə ʋ a: q eː
سنوار	s ʊ n ʋ a: r
تاپنا	t a: p n a:
انسیت	ɪ n s iː t
دیا	d ɪ j a:
ریحان	r eɪ ɦ a: n
غلبہ	ɡʰ ʊ l b a:
قرمزی	q ɪ ɽ m ɪ z iː
مت	m ə t
برف	b ɛː ɽ f
ایشن	eɪ ʃ ʊ n
ضرور	z ə ɽ uː ɽ
عنب	ɪ n eː b
خلق	x ə l q
روزنامہ	ɽ oː z n a: m ə
بچپن	b ə t͡ʃ p ə n
تال	t a: l
توبہ	t ə ʊ b a:
مایاوتی	m aː j aː ʋ ə t iː
برما	b ə ɽ m a:
سکو	s k uː
کلومیٹر	k ɪ l oʊ m iː t ə ɽ
محراب	m ɪ ɦ ɽ a: b
راہبہ	ɽ a: ɦ ɪ b a:
اجنبی	ə d͡ʒ n ə b iː
یہودنی	j ə ɦ uː d ɪ n iː
روایت	r ʋ a: j ə t
سلجھ	s ʊ l d͡ʒ ɦ
العرفائ	ə l a ɽ f a: ɪ
چپل	t͡ʃ ə p ə l
آزادی	a: z a: d iː
متوجہ	m ʊ t ə ʋ ə d͡ʒ d͡ʒ ʊ ɦ
باون	b a: ʊ n
استاد	ʊ s t a: d
اتھان	ʊ t tʰ a: n
مفاہمت	m ʊ f a: ɦ ɪ m ə t
کھانی	kʰ a: n iː
ٹورنمنٹ	ʈ ɔː r n m ə n ʈ
لحاظ	l ɪ ɦ a: z
کیسی	k eɪ s iː
دھن	dʰ ʊ n
ہمنوائی	ɦ ə m ‿ n ə ʋ a: iː
آخرت	a: x ɪ ɽ ə t
چشتی	t͡ʃ ɪ ʃ t iː
تندرست	t ə n d ʊ ɽ ʊ s t
ہوا	ɦ ə ʋ a:
بینالاقوامی	b eɪ n a: l a: q ʋ a: m iː
ہنوز	ɦ ə n oː z
پنجاب	p ə n d͡ʒ a: b
گائیڈنس	ɡ a: iː d n s
تھوکنا	tʰ uː k n a:
سوار	s ʋ a: ɽ
اسپاٹ	ɪ s p a: ʈ
علامت	a ʊ l aː m a t
خودمحتار	x ʊ d m ʊ ɦ t aː ɽ
ایمباسیٹرس	ɪ m b a: s iː ʈ ʊ ɽ s
مارکس	m a: ɽ k s
شکایت	ʃ ɪ k a: j ə t
فرار	f a r aː r
منصور	m ə n s ʊ ɽ
سات	s a: t
اسکینڈلس	ə s k iː n d ə l s
آلنگن	a: l ɪ ŋ ɡ ə n
گنگ	ɡ ʊ ŋ ɡ
مالیت	m a: l iː t
اسپانچ	ɪ s p a: n t͡ʃ
اگان	ə ɡ a: n
طاقتور	t a: q t ʋ ɔː ɽ
شجر	ʃ ə d͡ʒ ə ɽ
سونگھ	s uː ŋ ɦ
کونکنی	k uː n k n iː
فریدآباد	f ə r iː d a: b a: d
حسنی	ɦ ə s n iː
نیم	n ɪ j ə m
گاڑ	ɡ a: ɽ
کب	k a b
معالجہ	m a a a: l ɪ d͡ʒ a:
جاپان	d͡ʒ a: p a: n
پٹرولیم	p a t ɽ oː l iː m
اساس	ʔ ə s a: s
شرینگر	ʃ ɽ iː n ə ɡ ə ɽ
پٹاخا	p ə ʈ a: x a:
رگھوناتھ	r ʊ ɡʰ oʊ n a: tʰ
ترجمان	t ə ɽ d͡ʒ ʊ m a: n
دیش	d eː ʃ
تفصیل	t ə f s iː l
میتو	m iː t ʊ
میوہ	m eː ʋ a:
گیا	ɡ ə j a:
بظاہر	b ə z a: ɦ ɪ ɽ
بادامی	b a: d a: m iː
کس	k ʊ s
اشارہ	ɪ ʃ a: ɽ a:
فراخ۔دل	f ɽ a: x d ɪ l
خدمت	x ɪ d m ə t
رنگت	ɽ ə ŋ ɡ ə t
آزمانا	a: z m a: n a:
سنا	s ʊ n a:
دامودر	d a: m uː d a r
اور	ɔː ɽ
صبح	s ʊ b ɦ
کھنن	kʰ ə n ə n
قلعہ	q ɪ l a:
شکایات	ʃ iː k aː j aː t
بیدی	b eɪ d iː
جیت	d͡ʒ iː t
طاقت	ʈ a: q ə t
پرمیشور	p ɽ ə m iː ʃ ɔː ɽ
گجرات	ɡ ʊ d͡ʒ ɽ a: t
سلاح	s ɪ l a:
خسرو	x ʊ s ɽ oː
بارش	b a: ɽ ɪ ʃ
سینکڑوں	s eː n k ə ɽ oː n
تمھارا	t ʊ m a: ɽ a:
نافذ	n a: f ɪ z
منگوانا	m ə n ɡ ʋ a: n a:
پڑھنا	p ə ɽʰ n a:
بدلنا	b ə d ə l n a:
مقامی	m ʊ q a: m iː
میکسیکو	m eː k s iː k oː
چھتری	t͡ʃʰ ə t ɽ iː
افزائش	ə f z a: ɪ ʃ
غرور	ɣ ʊ ɽ uː ɽ
جسونت	d͡ʒ ʊ s ʊ n t
نمکین	n ə m k iː n
جامعہ	d͡ʒ a: m ɪ ʔ a:
اگرچیکہ	ə ɡ ə ɽ t͡ʃ iː k ɛː
دانش	d a: n ɪ ʃ
ہرانا	ɦ ə ɽ a: n a:
پڑھ	p ɽʰ
بارہا	b a: ɽ ɦ a:
ایڈس	a: iː d s
مقبوضہ	m ə q b uː z ə
اڑھا	a ɽʰ a:
گمانا	ɡ ʊ m a: n a:
زبردستی	z ʊ b ɽ d ʊ s t iː
پورہ	p uː r a:
قدر	q a d r
ساریامی	s a: r iː a: m iː
تب	t ə b
اندرا	ɪ n d r a:
کارپوریٹر	k aː ɽ p ɔː ɽ iː ʈ ə ɽ
حملہ	ɦ ə m l a:
تاجکستان	t a: d͡ʒ ɪ k ɪ s t a: n
میزبان	m eː z b a: n
رپورٹرس	ɽ ə p ɔː r ʈ ə r s
پاپیا	p a: p iː a:
آستین	a: s t iː n
دینے	d eː n eː
کوتا	k ə ʋ ɪ t a:
نصاب	n ɪ s a: b
مظاہرہ	m ʊ z a: ɦ ɪ ɽ a:
ذمہداری	z ə m ɦ d a: ɽ iː
شماری	ʃ ʊ m a: ɽ iː
ٹرافک	ʈ r a: f ɪ k
پریدا	p ə r iː d a:
بےدخلی	b eː d a x l iː
سنجیدہ	s ʊ n d͡ʒ iː d a
چار	t͡ʃ a: ɽ
چھوٹ	t͡ʃʰ uː ʈ
پھوڑا	pʰ oː ɽ a:
گڑیا	ɡ ʊ ɽ ɪ j a:
الہی	ʔ ɛː l ɦ iː
پرفل	p ə ɽ f l
کٹرپسند	k ʈ ə ɽ p s ʊ n d
طیرانگاہ	ʈ iː ɽ a: n ɡ a: ɦ
راو	r aː ʋ
ملائیشیا	m ə l ə j ʃ ɪ j a:
رتن	ɽ ə t ə n
لسانیات	l ɪ s a: n ɪ j a: t
ریاستہا	ɽ ɪ j a: s ə t ɦ a:
اگر	ə ɡ ə ɽ
تندور	t ə n d uː ɽ
کون	k ɔː n
ابابیل	ə b a: b iː l
ربوہ	ɽ ə b ʋ a: ɦ
فرزند	f ə r z ə n d
اودھاؤ	ɔː dʰ a: ʊ
چھان	t͡ʃʰ a: n
اچھا	ə t͡ʃ t͡ʃʰ a:
ناٹ	n a: ʈ
کشدھا	k ʂ ʊ dʰ a:
طرح	t ə ɽ ɦ
موٹر	m oː ʈ ɽ
نہیں	n ə ɦ i:
ڈسٹرکٹ	ɖ ɪ s ʈ r ɪ k ʈ
پریسیڈنٹ	p ɽ eː s iː ɖ ə n ʈ
خطا	x ə t a:
اسرائیل	ɪ s ɽ a: iː l
ثانوی	s a: n ʋ iː
اصول	ʊ s uː l
انجانا	ə n d͡ʒ a: n a:
وطن	ʋ ə t ə n
ڈیسک	ɖ iː s k
قوت	q ʊ ʋ ʋ ə t
کپاسی	k ə p a: s iː
ہفتہ	ɦ ə f t a: ɦ
پنچھی	p ə n t͡ʃʰ iː
لکھنا	l ɪ kʰ n a:
باشاہ	b a: ʃ a: ɦ
پانچواں	p a: t͡ʃ ʋ a:
عادل	a a: d ə l
سابقہ	s a: b iː q a:
امکانی	ə m k a: n iː
ابھیلاشا	ə bʰ iː l a: ʃ a:
ایرانی	iː ɽ a: n iː
ہانک	ɦ a: k
خوراک	x ʊ ɽ a: k
دورلیکھ	d uː ɽ l eː kʰ
ہمیشگی	ɦ ə m eː ʃ ɡ iː
مولانا	m oː l a: n a:
دکھ	d ʊ kʰ
کائنات	k a: ɪ n a: t
مکتب	m ʊ k t ə b
ریکٹر	ɽ eː k t ɽ
جھگڑا	d͡ʒʰ ə ɡ ɽ a:
اسکام	ə s k a: m
پروار	p ə ɽ ɪ ʋ a: ɽ
المرزائی	a l m ɛ r z aɪ iː
گرکیرت	ɡ ɽ k iː ɽ t
غنائیت	ɣ ʊ n n a: iː j ə t
گھاٹا	ɡʰ a: ʈ ə
برخلاف	b ɪ ɽ x ɪ l a: f
چوگنا	t͡ʃ ɔː ɡ ʊ n a:
خصوصا	x ʊ s uː s ə n
امی	ə m m iː
کاروائی	k a: ɽ oː a: iː
وصال	ʋ ɪ s a: l
حالانکہ	ɦ a: l a: k iː
پیٹ	p eː ʈ
تروپتی	t r oʊ p t iː
سناتن	s ə n a: t ə n
مدھم	m ə dʰ ə m
نور	n ʊ r
فوری	f ɔː r iː
پشتو	p ə ʃ t oː
نخرا	n ə x ɽ a:
بادبان	b a: d b a: n
اوقاف	ɔː q a: f
لاپرواہی	l a: p ɽ ʋ a: ɦ iː
مورتی	m uː ɽ t iː
ٹھیس	ʈʰ iː s
طوفان	t uː f a: n
زاید	z a: j ɪ d
تعصبیت	t a a s b iː t
موظف	m ʊ z ə f
نارنجی	n a: ɽ ə n d͡ʒ iː
اخروٹ	ə x ɽ oː ʈ
ہنسا	ɦ ɪ n s a:
فہد	f ə ɦ d
پور	p uː ɽ
نااہلیت	n a: a: ɦ l iː t
سوالیہ	s uː aː l iː ə
میڑچل	m eː ɽ t͡ʃ l
آدھا	a: dʰ a:
وچن	ʋ ə t͡ʃ ə n
پراڈکٹ	p ɽ aː ɖ a k ʈ
وا	ʋ a:
رد	ɽ ə d d
غیرمستحکم	ɣ ɪ r m ʊ s t ɦ a k a m
فالسئی	f a: l s ə iː
سمجھدار	s ə m ə d͡ʒʰ d a: ɽ
دخل	d ə x ə l
امداد	ɪ m d a: d
سیرسہ	s eː ɽ s ə
غیرانسانی	ɣ ɛː r ɪ n s a: n iː
کرنا	k ə ɽ n a:
بددعا	b ə d d ʊ a:
لاکھ	l a: kʰ
گذرنا	ɡ ʊ z ə ɽ n a:
لرزاں	l ə ɽ z a:
گڈا	ɡ ʊ ɖ ɖ a:
سمرتی	ɪ s m ɽ ɪ t iː
کپوت	k ə p oː t
انشاء	ɪ n ʃ a: ʔ
مسٹرسنہا	m ɪ s ʈ ə r s n ə ɦ a:
گانا	ɡ a: n a:
بگاڈیا	b ʊ ɡ a: ɖ iː a:
حریت	ɦ ʊ r iː t
جوت	d͡ʒ oː t
مکتوب	m ʊ k t oʊ b
چرخہ	t͡ʃ ə ɽ x a:
تھوک	tʰ uː k
آکرشت	a: k ə ɽ ʂ ɪ t
خلل	x ʊ l l
داستان	d a: s t a:
مظفر	m ʊ z f ə r
پابند	p a: b ə n d
اترپردیش	ʊ t ə ɽ p ə ɽ d eː ʃ
فیڈرر	f eː d ɛː ɽ ɽ
بقرعید	b ə q ɽ iː d
کاڑھا	k a: ɽʰ a:
بھید	bʰ eː d
سبب	s ə b b
پرمکھ	p ɽ ə m ʊ kʰ
دیکھنا	d eː kʰ n a:
چوم	t͡ʃ oː m
روزہ	ɽ oː z a:
سويمور	s ʋ ə j ə m ʋ ə ɽ
بمبہ	b ə m b
ساکری	s a: k ɽ iː
نمائندگان	n ʊ m a: ɪ n d ɡ a: n
چربی	t͡ʃ ə ɽ b iː
سنگاپور	s ɪ ŋ ɡ a: p uː ɽ
متھرا	m ə tʰ ʊ ɽ a:
ویراٹ	ʋ ɪ r a: t
جیون	d͡ʒ iː ʋ ə n
فعالیت	f a a: l iː t
اڑان	ʊ ɽ a: n
صلاح	s ʊ l a: ɦ
بلین	b ɛː l iː n
تیکھا	t iː kʰ a:
نکاح	n ɪ k a: ɦ
غیرت	ɣ ɛː ɽ ə t
خادم	x a: d ɪ m
محل	m ɛ ɦ ɛ l
سرمایہ	s ə r m a: j ə
ہاتھ	ɦ a: tʰ
نظیف	n ə z iː f
صفحہ	s ə f ɦ a:
کہاکہ	k ə ɦ a: k ə
پشاور	p e ʃ a: ʋ ə ɽ
وہ	ʋ oː
افسانہ	ə f s a: n ə
چلا	t͡ʃ ʊ l a:
فٹنس	f ɪ t n ə s
ہار	ɦ a: ɽ
پریمئر	p r eɪ m ɪə r
تعداد	t ə ʔ d a: d
اوقات	ɔː q a: t
بکری	b ə k ɽ iː
پانچ	p a: t͡ʃ
گلہری	ɡ ɪ l ə ɦ ɽ iː
شرن	ʃ ə r n
سردیاں	s ə ɽ d ɪ j a:
آٹو	a: ʈ oʊ
دیانتداری	d iː aː n ə t d aː r iː
محمد	m ʊ ɦ ə m m ə d
فائدہ	f a: ɪ d ə
برائے	b ɽ a: ɪ e
فیکلٹی	f iː k l ʈ iː
عبرانی	ɪ b ɽ a: n iː
عکس	a k s
یوگیتا	j oː ɡ iː t a:
استقبال	ɪ s t ɪ q b a: l
کیمرہ	k ɛː m ɽ a:
قبضہ	q ə b z ə
اچانک	ə t͡ʃ a: n ə k
یکساں	j ə k s a: n
ایذارسانی	ɛː z a: ɽ s a: n iː
جادو	d͡ʒ a: d uː
شائد	ʃ a: ɪ d
ناممکن	n a: m ʊ m k ə n
بنچ	b ə n t͡ʃ
امریکا	a: m ɽ iː k a:
پانڈیچری	p a: n ɖ iː t͡ʃ ə r iː
دیویندر	d eː ʋ iː n d ɽ
جدول	d͡ʒ ʊ d ʊ l
اودا	uː d a:
بنجارہ	b ə n d͡ʒ a: ɽ a:
سمکھ	s ə m m ʊ kʰ
خوبصورت	x uː b s uː ɽ ə t
پرندہ	p ə ɽ ɪ n d a:
بھونگیر	bʰ ʊ ŋ ɡ iː r
پارٹنرشپ	p a: r t n ɛ r ʃ ɪ p
لیول	l iː ʋ ə l
کرےگی	k ə r eɪ ɡ iː
آٹھواں	a: ʈʰ ʋ a:
پنا	p ə n n a:
لمبائی	l ə m b a: iː
دادا	d a: d a:
پتلون	p ə t l uː n
انوراللہ	a: n ʋ ə r a: l l a: ɦ
خواب	x a: b
وفاقی	ʋ ʊ f a: q iː
آبادی	a: b a: d iː
مندر	m ə n d ɪ ɽ
پستک	p ʊ s t ə k
انتظار	ɪ n t ɪ z a: ɽ
آکاش	a: k a: ʃ
مایہ	m aː j ɦ
چای	t͡ʃ a: j
بیاگ	b j aː ɡ
گین	ɡ eː n
قابل	q a: b ɪ l
پوٹےشیم	p oʊ ʈ eɪ ʃ iː m
افق	a: f ə q
اورنمائش	ɔː r n ə m a: ɪ ʃ
کھدیوت	kʰ ə d j oː t
پجرنا	p ə d͡ʒ ɽ n a:
انہ	a: n a:
مشکور	m ʊ ʃ k u: ɽ
جلنا	d͡ʒ ə l n a:
اوہ	uː ɦ
برس	b ɛː ɽ s
آریامن	a: ɽ j ə m ə n
رواداری	ɽ ʋ a: d a: ɽ iː
مذمت	m ə z ə m ə t
تار	t a: ɽ
سیشنس	s eː ʃ n s
مصروف	m ʊ s ɽ ʊ f
متوفی	m ʊ t ʋ ɔː f iː
قوانین	q ʋ aː n iː n
ادی	ə d j
تجدید	t ə d͡ʒ d iː d
ایتھنز	iː tʰ ə n z
مناسبت	m ə n aː s b ə t
مند	m ʊ n d
ہیرو	ɦ iː r uː
ہڑتالی	ɦ ə ɽ t a: l iː
گانجا	ɡ a: n d͡ʒ a:
فیریرو	f eɪ r iː r oʊ
تیرھواں	t ɪ ɽ ʊ ʋ a: n
دہندہ	d ə ɦ n d ə
گیہوں	ɡ eː ɦ u:
اولیا	a: ʋ l iː a:
بیچ	b iː t͡ʃ
شراب	ʃ ə ɽ a: b
جلانا	d͡ʒ ə l a: n a:
گدھا	ɡ ə dʰ a:
غیرسرکاری	ɣ ɪ r s ʊ r k a: r iː
جعلی	d͡ʒ a: l iː
برکت	b ə ɽ k ə t
چتا	t͡ʃ ʊ t a:
پپاسا	p ɪ p a: s a:
منسلک	m ʊ n s ʊ l k
دھارا	dʰ a: ɽ a:
کینچلی	k e: t͡ʃ ʊ l iː
لکھائی	l ɪ kʰ a: iː
ابھشیک	ə bʰ ɪ ʂ eː k
فرانس	f ɽ a: n s
انجنیئرنگ	ɪ n d͡ʒ ə n iː ə ɽ n ɡ
ارجن	ə ɽ d͡ʒ ʊ n
شکتی	ʃ ə k t iː
برتن	b ə ɽ t ə n
جرثومہ	d͡ʒ ʊ ɽ s uː m a:
بااثر	b a: ʔ s ɛ ɽ
پھسل	pʰ a s l
نکسیر	n ə k s iː ɽ
بالخصوص	b a: l x a s ʊ s
پھلکی	pʰ ʊ l k iː
سپاہی	s ɪ p a: ɦ iː
خروش	x ɽ ʊ ʃ
چھلانگ	t͡ʃʰ ə l ə ŋ ɡ
انڈیوگونزیلویس	a n ɖ iː ʋ a ɡ a n z iː l a ʋ iː s
برچھیت	b ə ɽ t͡ʃʰ ɛː t
جنسی	d͡ʒ ʊ n s iː
نغمہ	n ə ɣ m ə
لیاپس	l iː a: p s
بشکل	b ʊ ʃ k ə l
چناب	t͡ʃ ə n a: b
ڈارا	ɖ a: ɽ a:
اصیل	ə s iː l
فضاء	f ɪ z a:
امتحان	ɪ m t ɪ ɦ a: n
احترام	e ɦ t ɪ ɽ a: m
نعرہ	n a: ɽ a: ɦ
پڑوسی	p a: r oː s iː
جدید	d͡ʒ ə d iː d
فلپائن	f ɪ l ɪ p a: ɪ n
گھرانا	ɡʰ ə ɽ a: n a:
دستاویز	d ʊ s t aː ʋ iː z
کروانا	k ə ɽ ʋ a: n a:
مصیبت	m ʊ s iː b ə t
سہمانا	s ə ɦ m a: n a:
چھوٹنا	t͡ʃʰ uː ʈ n a:
اودھی	ə ʋ ə dʰ iː
نالے	n a: l eː
شرکرا	ʃ ə ɽ k ə ɽ a:
یوم	j oː m
طینت	ʈ ɪ n t
شرک	ʃ ɪ ɽ k
ذاکر	z a: k ə r
جامنی	d͡ʒ a: m n iː
لگانا	l ə ɡ a: n a:
سمئے	s ə m ə j
سازش	s a: z ɪ ʃ
خلفا	x ʊ l ə f a:
شوقین	ʃ ʊ q iː n
بندر	b ə n d ə ɽ
شائق	ʃ a: ɪ q
کیڑا	k iː ɽ a:
گھرنا	ɡʰ ɽ ɪ n a:
ادبیات	ə d b ɪ j a: t
توقع	t ʋ oː q a
ایسی	aɪ s iː
آفریدی	a: f ɽ iː d iː
اولا	oː l a:
کوتلماں	k oː t ʊ l m a: n
خصوص	x ʊ s uː s
تدبیر	t ə d b iː ɽ
کوکب	k ɔː k ə b
سینکڑہ	s eː n k ɽ ə ɦ
کڑپہ	k a r p a
ری۔ایکٹرس	ɽ eː a: ɪ k t ɽ ʊ s
دوران	d ʊ ɽ a: n
ناظم	n a: z ɪ m
میرے	m iː ɽ eː
پتا	p ɪ t a:
موہن	m oː ɦ n
گنا	ɡ ʊ n a:
چنی	t͡ʃ ʊ n iː
سکھشا	s ə kʰ ʃ a:
یوگانڈا	j ʊ ɡ a: n ʈ a:
تو	t uː
چائے	t͡ʃ aɪ ə
پتلا	p ʊ t l a:
خواتین	x ə ʋ a: t iː n
غلطی	ɣ ə l ə t iː
سارا	s a: ɽ a:
لیسٹر	l ɛː s ʈ ə ɽ
راس	ɽ aː s
چوٹکی	t͡ʃʰ ʊ ʈ k iː
بھراتا	bʰ ɽ a: t a:
استری	ɪ s t ɽ iː
غرض	ɣ ʊ r d z
کھنکنا	kʰ ə n ə k n a:
عیادت	ə j a: d ə t
ارمان	ə ɽ m a: n
نبی	n ə b iː
جھک	d͡ʒʰ ə k
خون	x uː n
شاہی	ʃ a: ɦ iː
کھلواڑ	kʰ ə l ʋ a: ɽ
شبھ	ʃ ʊ bʰ
پسماندگی	p ə s m a: n d ɡ iː
سلوک	s ʊ l uː k
بھی	bʰ iː
اردو	ʊ ɽ d uː
فروری	f ə ɽ ʋ ə ɽ iː
ناقد	n a: q ə d
انجام	ə n d͡ʒ a: m
جاپانی	d͡ʒ a: p a: n iː
کے	k eː
نگرانی	n ɪ ɡ ɽ a: n iː
لیٹنا	l eː ʈ n a:
لامتناہی	l a: m ʊ t ə n a: ɦ iː
میز	m iː z
اخبار	ə x b a: ɽ
ہند	ɦ ɪ n d
تمنچه	t ə m ə n t͡ʃ a:
النظر	ʔ ʊ l n ʊ z ɽ
قمیض	q ə m iː z
جلسہ	d͡ʒ ə l s a ɦ
گرڈ	ɡ ə ɽ ʊ ɖ
مودی	m uː d iː
پرسوں	p ə ɽ s o:
بیگز	b eː ɡ z
آرڈر	a: ɽ ʈ ɽ
کاٹ	k a: ʈ
کنجی	k ʊ n d͡ʒ iː
حبش	ɦ ə b ə ʃ
ٹرینس	ʈ ɽ eː n s
مخمل	m ə x m ə l
ووٹ	ʋ uː ʈ
چھونا	t͡ʃʰ uː n a:
باربروسہ	b a: r b ə r oː s ə
عاقد	a aː q ə d
سکنا	s ə k n a:
نقاب	n ɪ q a: b
لینا	l eː n a:
کہنا	k ə ɦ n a:
سہل	s ə ɦ l
پوچیا	p oː t͡ʃ iː a:
فالحال	f ɪ l ɦ a: l
کعبہ	k a: b a:
وشاکھا	ʋ ʊ ʃ a: kʰ a:
تیاگ	t j a: ɡ
بموجب	b ə m ʊ d͡ʒ ɪ b
ریکارڈز	ɽ eɪ k a: ɽ ɖ z
بھاروپیہ	bʰ a: ɽ oː p ɪ j a:
پالیسی	p a: l iː s iː
تعمیراتی	t a ə m iː r a: t iː
سلجوقی	s ə l d͡ʒ uː q iː
مر	m ə ɽ
جسور	d͡ʒ ə s uː ɽ
فتنہ	f ə t n ə
الوداع	ə l ʋ ɪ d a:
ابودرداء	ʔ a: b uː d ə r d a: ʔ
خواجہ	x a: d͡ʒ a:
سینگ	s iː ŋ ɡ
ٹائیلس	ʈ a: ɪ l s
بورن	b ɔː ɽ n
رائے	ɽ a: j
باٹ	b a: ʈ
فکر	f ɪ k ɽ
ون	ʋ ʊ n
آمدنی	a: m d ə n iː
اڑیوا	ə ɽ eː ʋ a:
گہرا	ɡ ə ɦ ɽ a:
پورکر	p u: r k ə r
مختصر	m ʊ x t ə s ɪ ɽ
قباحت	q ə b a: ɦ ə t
کلیسیا	k ə l iː s ɪ j a:
معتمد	m ʊ ʔ t ə m ɪ d
بابری	b a: b ɽ iː
تاریک	t aː r iː k
بے۔چین	b eː t͡ʃ eː n
ہونا	ɦ oː n a:
ٹھوس	ʈʰ oː s
صدی	s ə d iː
بغیر	b ɪ ɣ ɛː r
گندمی	ɡ ə n d ʊ m iː
زنانی	z ʊ n a: n iː
صد	s ʊ d
اگربتی	ə ɡ ə ɽ b ə t t iː
خاصکر	x a: s k ə ɽ
غصہ	ɣ ʊ s a:
شریک	ʃ a r iː k
سنور	s ɪ n ʋ ɔː ɽ
ایوان	ɛː ʋ a: n
مزدور	m ʊ z d ʊ r
مکین	m ʊ k iː n
وشوکت	ʋ ə ʃ ʋ oː k ə t
سونا	s uː n a:
احتجاج	eː ɦ t ɪ d͡ʒ a: d͡ʒ
دستاویزی	d ə s t a: ʋ iː z iː
کوشش	k oː ʃ ɪ ʃ
دیروز	d iː ɽ oː z
کیوبا	k iː ʋ b a:
قربت	q ʊ r b ə t
اظہر	ʔ ɪ z ʱ ə r
نظر	n ə z ə ɽ
انفوٹی	ɪ n f oʊ ʈ iː
بیمار	b eː m a: ɽ
دفنانا	d ə f n a: n a:
یہ	j eː
اخذ	ə x z
جگنو	d͡ʒ ʊ ɡ n uː
پہلا	p ə ɦ l a:
بجلی	b ɪ d͡ʒ l iː
معلنہ	m a ə l ə n ə ɦ
کومٹ	k oː m ʈ
اپلبدھ	ʊ p l ə b dʰ
بھرن	bʰ ə ɽ ə n
رمضان	ɽ ə m z a: n
وسنت	ʋ ʊ s n a t
گز	ɡ ʊ z
لوری	l oː ɽ iː
دوزخ	d oː z ə x
کیپرس	k eɪ p ɛ r s
سلنڈر	s ə l ə n ɖ ə ɽ
صحافتی	s ʊ ɦ a: f t iː
بدر	b ə d ə ɽ
علم	ɪ l m
توچا	t ʋ ə t͡ʃ a:
فرمانا	f ə ɽ m a: n a:
جارجیا	d͡ʒ a: r d͡ʒ iː a:
مربع	m ʊ ɽ b a:
شاداب	ʃ a: d a: b
پاؤڈر	p a: ʊ ʈ ə ɽ
احمدآباد	a: ɦ m ɛː d a: b a: d
کالا	k a: l a:
ایران	iː ɽ a: n
سزا	s ə z a:
ساری	s a: r iː
مارکٹس	m a: r k ɪ t s
شین	ʃ iː n
کلچر	k ʊ l t͡ʃ ʊ r
ممبئی	m ʊ m b ə iː
نظرانداز	n ʊ z ɽ a: n d a: z
للن	l ʊ l ə n
راہب	ɽ a: ɦ ɪ b
عجائب	ə d͡ʒ a: ɪ b
خاموش	x a: m oː ʃ
اونٹ	u: ʈ
نبردآزما	n ə b ɽ d a: z m a:
رات	ɽ a: t
کلاونت	k ə l a: ʋ ə n t
نکتہ	n ʊ k t a:
سداسیوپیٹ	s ʊ d a: s j oː p iː ʈ
بهنجك	bʰ ə n d͡ʒ ə k
زبیر	z ʊ b eː ɽ
طاق	t a: q
واریرس	ʋ aː ɽ iː ɽ s
چہرہ	t͡ʃ ɪ ɦ ɽ a:
گولمیز	ɡ oː l m iː z
اسم	ɪ s m
نصرت	n ʊ s ɽ ə t
ڈیفنس	ɖ iː f n ɪ s
اڈمیرل	ə d m iː r l
اپنيتر	ʊ p n eː t ɽ
ارب	ə ɽ ə b
ران	r a: n
ولاقو	ʋ ə l aː q oː
ٹائلٹ	ʈ a: ɪ l ʈ
شاپر	ʃ a: p ə ɽ
بورڈس	b ɔː ɽ d s
ثناخوان	s n a: x ʋ a: n
تنازعہ	t ə n a: z a ɦ
اشبھ	ə ʃ ʊ bʰ
برمنگھم	b ə ɽ m ɪ n ɡʰ ə m
گدھ	ɡ ɪ d dʰ
مہابھارت	m ə ɦ a: bʰ a: ɽ ə t
معصوم	m a ʊ s uː m
جہدکار	d͡ʒ ə ɦ d k a: ɽ
سہمنا	s ə ɦ ə m n a:
توحیدیت	t ɔː ɦ iː d ɪ j ə t
پانی	p a: n iː
یہود	j ə ɦ uː d
کامتھ	k a: m tʰ
موجودہ	m oː d͡ʒ uː d a:
مچھرکش	m ʊ t͡ʃʰ ɽ k ɪ ʃ
لہسن	l ə ɦ s ʊ n
کفایتی	k ə f aː j t iː
ڈیوڈ	ɖ iː oʊ ɖ
راہ	ɽ a: ɦ
دن	d ɪ n
میتھن	m ɛː tʰ ʊ n
جائزہ	d͡ʒ a: ɪ z a:
مشروب	m a ʃ r uː b
ستیا	s ʊ t iː a:
عہدہ	a ɛː d a:
رکھا	ɽ ʊ kʰ a:
مضمون	m ʊ z m uː n
راکھ	ɽ a: kʰ
لاگو	l a: ɡ ʊ
وار	ʋ a: ɽ
کابل	k a: b ʊ l
نمونہ	n ə m uː n a:
ین	iː n
ہائی۔ٹیکس	ɦ aɪ t ɛ k s
بپتسمہ	b ə p t ɪ s m a:
روزن	ɽ ɔː z ə n
برسلز	b ɽ ə s ə l z
شاہراہ	ʃ a: ɦ ɽ a: ɦ
مذہب	m ə z ɦ ə b
سگنل	s ɪ ɡ n ə l
کیلئے	k eː l ɪ j eː
یورپ	j oː ɽ ə p
یافتہ	j a: f t a:
توسیعی	t ʊ s iː ʔ iː
برسر	b ə r s ə r
مذاکراہ	m ʊ z a: k ɽ a: ɦ
دہلی	d ɛ ɦ l iː
عجائبات	ə d͡ʒ a: ɪ b a: t
سائنسی	s a: ɪ n s iː
معاملت	m ʊ a: m l ə t
اگزامنیشن	a ɡ z a: m n ɪ ʃ ə n
بےحد	b eː ɦ ə d
ڈوری	ɖ oː ɽ iː
کمیشن	k a m iː ʃ a n
غیرضروری	ɣ eː ɽ z ə ɽ uː ɽ iː
تولیہ	t ɔː l ɪ j ə
جیل	d͡ʒ eː l
مخبر	m ʊ x b ɪ ɽ
لہجہ	l ə ɦ d͡ʒ ə
ڈاریوس	ɖ a: ɽ iː ʊ s
وارسا	ʋ a: ɽ s a:
بلغاریہ	b ʊ l ɣ a: ɽ ɪ j a:
سرمئی	s ʊ ɽ m ə iː , s ə ɽ m ə iː
ڈاک	ɖ a: k
آبی	a: b iː
خاکسار	x a: k s a: ɽ
سمترا	s ə m t r a:
گرفتارشدہ	ɡ ɛ r f t a: r ʃ ʊ d a:
ٹیوب	ʈ iː ʋ b
دور	d uː ɽ
بکھراو	b ɪ kʰ ɽ a: ʋ
آموزش	a: m oː z ɪ ʃ
عورت	ɔː ɽ ə t
چترویدی	t͡ʃ ə t ɽ ʊ ʋ eː d iː
آنکھ	a: kʰ
ننھا	n ə n a:
مروڑ	m ɛ ɽ ʋ ɔː ɽ
گورو	ɡ ɔː ɽ ə ʋ
کرس	k ɽ ʊ s
رویئہ	ɽ ə ʋ ə i a:
سلیکشن	s ə l iː k ʃ ə n
شداد	ʃ ə d aː d
مجرمانہ	m ʊ d͡ʒ ɽ ɪ m a: n a:
کودانڈارام	k uː d a: n ɖ a: ɽ a: m
وزیر	ʋ ə z iː ɽ
گاڑی	ɡ a: ɽ iː
گمبھیر	ɡ ə m bʰ iː ɽ
خوبانی	x uː b a: n iː
کارخانہ	k a: r x a: n ə
خلیفہ	x ə l iː f a: ɦ
دھوسر	dʰ uː s ə r
عراق	ɪ ɽ a: q
ڈین	ɖ iː n
لاپتہ	l a: p ə t ə
دایاں	d a: j a:
تنگ	t ə ŋ ɡ
سؤر	s uː ə ɽ
جی	d͡ʒ iː
مانے	m aː n eː
دوستی	d oʊ s t iː
یروشلم	j ə ɽ uː ʃ ə l ə m
ترنمول	t ə r n m uː l
میٹابولائز	m eː ʈ a: b oː l aː ɪ z
تندرستی	t ə n d ʊ ɽ ʊ s t iː
انفرنس	ɪ n f ə r n ə s
گنت	ɡ ə n ɪ t ə
اسپیکٹرم	ə s p eː k ʈ r ʊ m
انحراف	ɪ n ɦ ɪ r a: f
الشمس	ʔ ə l ʃ ə m s
متاثرہ	m ʊ t a: s ɪ ɽ a:
اسٹیم	ɪ s ʈ iː m
وین	ʋ eː n
دینا	d eː n a:
جنیشور	d͡ʒ ə n iː ʃ ʊ ɽ
لیگ	l iː ɡ
تلقین	t ə l q iː n
انہوں	ʔ ʊ n ɦ ʊ n
کروڈ	k ə r oː ɖ
سننا	s ʊ n n a:
متجاوز	m ʊ t d͡ʒ a: ʋ ə z
اخلاق	ə x l a: q
اسلام	ɪ s l a: m
ایل	a: ɪ l
پٹھان	p ə ʈʰ a: n
پسینہ	p ə s iː n a:
پکار	p ʊ k a: ɽ
میڈیم	m eː d iː ə m
اپدهان	ʊ p dʰ a: n
تبریز	t ə b ɽ eː z
پیٹرسن	p eː ʈ ə ɽ s ə n
سنت	s a n t
کوشاں	k ʊ ʃ a: n
آگاہ	a: ɡ aː ɦ
الیکشن	a l iː k ʃ a n
جوڑا	d͡ʒ oʊ ɽ a:
جمیعتہ	d͡ʒ ʊ m iː a a: t a:
مورت	m uː ɽ ə t
لفٹ	l ɪ f t
تاڑی	t a: ɽ iː
کشیدگی	k ə ʃ iː d ɡ iː
بےصبری	b eː s ʊ b ɽ iː
ڈر	ɖ ə ɽ
شے۶	ʃ eː t͡ʃʰ ʰ
مقفل	m ʊ q f ʊ l
روس	ɽ uː s
فلو	f l oː
آزمودہ	a: z m uː d ə
آرٹیکل	a: r ʈ iː k ə l
نتجہ	n ə t d͡ʒ ə ɦ
ایرانڈیا	a iː r aː n d iː aː
حافظ	ɦ a: f ɪ z
شیوسینا	ʃ iː ʋ s iː n a:
لوبیا	l oː b ɪ j a:
اختیارکردہ	ə x t iː j aː ɽ k ə ɽ d ə ɦ
نامی	n a: m iː
آمریت	a: m ɪ ɽ ɪ j ə t
شیر	ʃ iː ɽ
سنہ	s ɪ ŋ ɦ
انش	ə n ʃ
چھت	t͡ʃʰ ə t
کھیلا	kʰ eː l a:
وینکٹیش	ʋ eː n k ʈ iː ʃ
ہچکی	ɦ ɪ t͡ʃ k iː
جمہوریت	d͡ʒ ə m ɦ uː ɽ ɪ j ə t
ملزمین	m ʊ l z ɪ m iː n
آمیز	a: m iː z
باقاعدہ	b a: q a: ɪ d a:
گمبھی	ɡ ə m bʰ iː
سانپ	s a: p
مسٹرڈ	m ʊ s t ə r d
انوپ	a: n uː p
تحصیل	t ɦ ʊ s iː l
ارکنساس	a: ɽ k ə n s a: s
اتوار	ɪ t ʋ a: ɽ
توجہی	t ʋ oː d͡ʒ ɦ iː
ناخوش	n a: x ʊ ʃ
آواز	a: ʋ a: z
شخص	ʃ ə x s
تعاقب	t a a: q ʊ b
تناظر	t ə n a: z ə r
شبانہ	ʃ ə b a: n a:
آبسٹیٹرکس	a: b s ʈ iː ʈ ɪ ɽ k s
اعتماد	ɪ ʔ t ɪ m a: d
نتیجتا	n ə t iː d͡ʒ ə t ə n
برادرنسبتی	b ɽ a: d ə r n ɪ s b ə t iː
بلاکس	b l a: k s
بالے	b a: l eː
نسچل	n ə s t͡ʃ ə l
نثار	n ɪ s a: r
راجیش	ɽ a: d͡ʒ iː ʃ
اخاہ	ə x a:
ڈنکرک	ɖ ə n k ə ɽ k
عیسائی	a iː s a: ʔ iː
شروع	ʃ ʊ ɽ uː a
گھڑیال	ɡʰ ə ɽ ɪ j a: l
درجہ	d ə r d͡ʒ a:
تعاونی	t a a: ʋ n iː
شعر	ʃ eː ɽ
مناظر	m ə n a: z ɪ ɽ
اتحادی	ɪ t t ɪ ɦ a: d iː
ڈنکی	ɖ ə ŋ k iː
پوت	p uː t
آسیب	a: s eː b
الطاف	a l t a: f
تسلیم	t ə s l iː m
دفن	d a f n
خارج	x aː r ɪ d͡ʒ
پری	p ə ɽ iː
تھیلا	tʰ iː l a:
ناتھولا	n a: tʰ oː l a:
نقطہ	n ʊ q t a:
زائد	z a: ɪ d
صحیح	s ə ɦ iː
سموسہ	s ə m oː s a:
اسٹائسٹکس	ɪ s ʈ a: ɪ s ʈ k s
حجر	ɦ ə d͡ʒ ɽ
ریکارڈکردہ	r eː k a: r ʈ k ʊ r d ə ɦ
عطر	ʔ ɪ t ɽ
سوکھا	s uː kʰ a:
سنگین	s ʊ ŋ ɡ iː n
پنگھٹ	p ə ŋ ɡʰ ə ʈ
میزان	m iː z a: n
سنوائی	s ʊ n oː a: iː
تیسری	t eː s r iː
کمپنی	k ə m p n iː
آرزو	a: ɽ z uː
امام	ɪ m a: m
ڈھا	ɖʰ a:
سمجھنا	s ə m ə d͡ʒʰ n a:
نافرمان	n a: f ə ɽ m a: n
جہاز	d͡ʒ ə ɦ a: z
قبض	q ə b ə z
متواتر	m ʊ t ʋ a: t ɽ
رہنمائے	ɽ ə ɦ n ə m aː ɪ
خیرسگالی	x eː r s ɡ a: l iː
سپریمو	s ʊ p ɽ iː m oː
طبیعت	t ə b iː j ə t
گھریلو	ɡʰ ə ɽ eː l uː
خواہش	x a: ɦ ɪ ʃ
ایمان	iː m a: n
انڈسٹریل	ɪ n ɖ ʊ s t r iː l
چال	t͡ʃ a: l
ذلت	z ɪ l ə t
انتخابی	ɪ n t ɪ x a: b iː
انڈر۔پاس	ɪ n ɖ ə ɽ p a: s
اچاریہ	ə t͡ʃ a: ɽ iː ə
شان	ʃ aː n
فیصد	f iː s ə d
انشورنس	ɪ n ʃ ʊ r ə n s
کوچس	k oː t͡ʃ ə s
تلخی	t ə l x iː
جھنڈ	d͡ʒ ʱ ʊ n ɖ
اصل	ə s ə l
دیرینہ	d eɪ r iː n a:
سید	s eː d
آکھیٹ	a: kʰ eː ʈ
بھوٹیہ	bʰ ʊ ʈ iː a:
سنجائے	s ʊ n d͡ʒ a: ɪ j eː
کھانگ	kʰ a: ɡ
شیشہ	ʃ iː ʃ a:
بلا	b ʊ l l a:
ٹم	t a m
اٹاچی	ə ʈ ɛː t͡ʃ iː
خراج	x ə r a: d͡ʒ
وجیہ	ʋ ə d͡ʒ iː ɦ
چنگل	t͡ʃ ʊ ŋ ɡ ʊ l
سرسوتی	s ə ɽ ə s ʋ ə t iː
پینسل	p eː n s ə l
صابر	s a: b ɪ ɽ
طبقہ	ʈ ə b q ə
کیول	k eː ʋ ə l
محبت	m ʊ ɦ ə b b ə t
چدمبرم	t͡ʃ ʊ d m b ʊ ɽ m
اکانٹس	ə k a: n ʈ s
نظام	n ɪ z a: m
غنہ	ɣ ʊ n n ə
روانہ	ɽ ə ʋ a: n a:
چیرمین	t͡ʃ eː r m iː n
اصطبل	ə s t ə b ə l
مذکر	m ʊ z ə k k ə ɽ
ولایت	ʋ ɪ l a: j ə t
ویاکرن	ʋ j a: k ə ɽ ə n
دوپے	d oː p eː
سوادو	s ʋ a: d uː
پھیلی	pʰ eː l iː
دھونا	dʰ uː n a:
خبر	x ə b ə ɽ
عمری	a ʊ m r iː
آئے	a: ɪ ɛː
قدیم	q ə d iː m
درگاہ	d ə r ɡ a: ɦ
سٹی	s ʈ iː
دونا	d uː n a:
نقش	n ə q ʃ
فالسہ	f a: l s a:
باہری	b a: ɦ ɪ r iː
نمبیار	n ə m b j aː r
کیابس	k j a: b s
کالم	k aː l ʊ m
راؤنڈر	ɽ a: ʊ n ɖ ə ɽ
قیدی	q iː d iː
اسٹون	ɪ s t oʊ n
آگاہی	a: ɡ a: ɦ iː
کانفرنس	k a: n f ɽ ə n s
باعزت	b a: a ɪ z z ə t
مارگ	m a: ɽ ɡ
سبزی	s ə b z iː
نسل	n ə s l
اہلیہ	a: ɦ l iː a:
ش	ʃ
جیوتی	d͡ʒ j oː t iː
عقبہ	a ɪ q b a:
سیما	s iː m a:
نیا	n ə j a:
لمپٹ	l ə m p ə ʈ
علما	a ə l m a:
کتاب	k ɪ t a: b
گارنر	ɡ a: r n ə r
اسکواڈ	a: s k uː a: d
شناخت	ʃ ɪ n a: x t
چراغاں	t͡ʃ ɽ a: ɣ a:
رخ	r ʊ x
مہندا	m ə ɦ n d a:
جنتی	d͡ʒ ə n ə t iː
ریپھ	ɽ eː pʰ
سوتیلا	s ɔː t eː l a:
ظہیرآباد	z ə ɦ iː ɽ aː b aː d
جیش	d͡ʒ æː ʃ
تھیراپی	tʰ eː ɽ a: p iː
پرگنا	p ə r ɡ n a:
پھول	pʰ uː l
کری	k ə ɽ iː
نقلی	n ə q l iː
گرہن	ɡ ɽ ə ɦ ə n
لہرانا	l ɛ ɦ ɽ a: n a:
عقل	ʔ ə q l
شام	ʃ a: m
یورانیم	j ʊ ɽ aː n iː m
عبد	a ʊ b d
دام	d a: m
سوہال	s uː ɦ aː l
ڈیولپمنٹ	ɖ iː oʊ l p m ə n ʈ
شرم	ʃ ə ɽ m
اندر	ɪ n d ə ɽ
پھاڑ	pʰ a: ɽ
راکٹ	ɽ a: k ɪ ʈ
خاصی	x a: s iː
میراں	m iː r aː n
ہجوم	ɦ ə d͡ʒ oʊ m
ممتا	m ʊ m t a:
سرشت	s ə ɽ ɪ ʃ t
ذلیل	z ə l iː l
کمل	k ə m ə l
مسئلہ	m ə s l a:
روزی	r oː z iː
آیوکت	a: j oː k t
فانی	f a: n iː
کھانا	kʰ a: n a:
یومی	j oː m iː
بہشت	b ɪ ɦ ɪ ʃ t
کردنت	k ɽ ɪ d ə n t
ابو	ə b b uː
جل	d͡ʒ ə l
قاسمی	q aː s m iː
ترپاٹھی	t ə ɽ p a: tʰ iː
کشادہ	k ə ʃ aː d ə
وشنو	ʋ ɪ ʃ n uː
ہلڑ	ɦ ə l ɽ
مہر	m ʊ ɦ ə ɽ
موڈ	m oː d
افتخار	a: f t ɪ x a: r
چمو	t͡ʃ ə m uː
پھیلاؤ	pʰ eː l aː oː
بادبانی	b a: d b a: n iː
فرق	f ɽ q
بروخے	b ɽ uː x eː
نورین	n ʊ ɽ iː n
پوجنا	p uː d͡ʒ n a:
چاندی	t͡ʃ a: d iː
نہا	n ə ɦ a:
بڑھوتری	b a ɽ ʊ t ɽ iː
یونان	j uː n a: n
مرنا	m ə ɽ n a:
ڈوگر	ɖ oː ɡ ɛː ɽ
بحسن	b ɦ ʊ s n
کارکردگی	k a: ɽ k ə ɽ d ə ɡ iː
تمیز	t ə m iː z
بھائی	bʰ a: iː
خط	x a t
سیاستدان	s ɪ j a: s ə t d a: n
گیلانی	ɡ iː l a: n iː
دہی	d eː ɦ iː
اطفال	ə t f a: l
واکیہ	ʋ a: k j
بند	b ə n d
بکم	b ʊ k m
ہتیارا	ɦ ə t j a: ɽ a:
مرکندہ	m ʊ ɽ k ə n d ə
گلاس	ɡ l a: s
ویٹرنری	ʋ eː ʈ ə r n ə r iː
کاپٹر	k a: p ʈ ɽ
نذرانہ	n ɪ z r a: n a:
شوارع	ʃ oː aː r a
اوقافی	oː q aː f iː
مراکیش	m ɽ a: k ɛː ʃ
معبود	m a: ʔ b uː d
رامچندر	ɽ a: m t͡ʃ ə n d ɽ ə
پرگی	p ə r ɡ iː
انگوری	ə ŋ ɡ uː ɽ iː
سل	s ə l
پیشاب	p eː ʃ a: b
دیکشت	d iː k ʃ t
ٹرانسپورٹ	ʈ r a: n s p ɔː r ʈ
کھنک	kʰ ə n ə k
بالکل	b ɪ l k ʊ l
اسکولس	ə s k uː l s
چھتیس	t͡ʃʰ a t iː s
ترقی	t ə ɽ q iː
ایونٹ	a: j uː n ʈ
معاشرہ	m ʊ ʔ a: ʃ ɪ ɽ a:
در	d a: ɽ
چھہ	t͡ʃʰ eː
نوٹس	n oː ʈ s
ابوعبدالرحمن	ə b ʊ a ə b d ə l ɽ a: ɦ m ə n
اڈے	ə ɖ ɛː
چاٹ	t͡ʃ a: ʈ
باغ	b a: ɣ
مذکور	m ʊ z k ʊ r
ساتواں	s a: t ʋ a:
مولا	m ɔː l a:
واجبی	ʋ aː d͡ʒ b iː
کمرہ	k ə m ɽ a:
جانکاری	d͡ʒ a: n k a: ɽ iː
التواء	ʔ ə l t ʋ a:
خلیج	x ə l iː d͡ʒ
ہیک	ɦ iː k
ہمدردی	ɦ ə m d ə r d iː
یوہان	j uː ɦ aː n
حراست	ɦ ɪ ɽ a: s ə t
باقاعدگی	b a: q a: ʔ ɪ d ɡ iː
جمعرات	d͡ʒ ʊ m eː ɽ a: t
لائینز	l aɪ n z
خربوزہ	x ə ɽ b uː z a:
مولین	m oː l iː n
درود	d ʊ ɽ uː d
غیرمعروف	ɣ ɪ ɽ m a: ɽ uː f
رہ	r ə ɦ
جنرل	d͡ʒ ə n ɽ ə l
اتصال	ɪ t t ɪ s a: l
استفسار	a s t a f s aː r
تئن	t ɛː n
وظیفدار	ʋ ʊ z iː f d a: ɽ
شرع	ʃ ʊ r a
غور	ɣ ʊ ɽ
ڈگر	ɖ ə ɡ ə ɽ
حج	ɦ ə d͡ʒ d͡ʒ
ایکشن	ɛː k ʃ ə n
غنچہ	ɣ ʊ n t͡ʃ a:
اشتقاق	ɪ ʃ t ɪ q a: q
قیمہ	q iː m a:
آبشار	a: b ʃ a: ɽ
انتقال	ɪ n t iː q a: l
دیوناگری	d eː ʋ n a: ɡ ɽ iː
دلی	d ɪ l iː
الم	ə l ə m
ٹسکرس	ʈ s k ə ɽ s
محمدو	m ʊ ɦ ə m ə d ʋ oʊ
انہیں	ʊ n ɦ e:
بدعنوانی	b ə d a n ʋ a: n iː
بنجارا	b ə n d͡ʒ a: ɽ a:
کاپوریشن	k a: p oː ɽ iː ʃ ə n
کیمیا	k iː m ɪ j a:
توں	t ʊ n
کیتیش	k eː t iː ʃ
کیئر	k iː ɛ ɽ
حسین	ɦ ʊ s eɪ n
پرتگیا	p ɽ ə t ɪ ɡ j a:
ویش	ʋ eɪ ʃ
ڈوجی	ɖ oː d͡ʒ iː
ببھکشا	b ʊ bʰ ʊ k ʂ a:
چوبے	t͡ʃ oː b eː
نتائج	n ɪ t aː ɪ d͡ʒ
چاند	t͡ʃ a: d
آتما	a: t m a:
زیر۔قیادت	z iː ɽ q iː a: d ə t
پرفتن	p ʊ ɽ f t ʊ n
وستو	ʋ ə s t uː
کپڑا	k ə p ɽ a:
دل	d ɪ l
خواہشمند	x ʋ a: ɦ ɪ ʃ m ɛː n d
ممالک	m ə m a: l ɪ k
شیطان	ʃ eː t a: n
فنڈ	f ʊ n ʈ
کارنی	k aː r n iː
پرابین	p ə ɽ aː b iː n
قیام	q iː a: m
برت	b ə r t
پریت	p ə ɽ iː t
انعام	ɪ n a aː m
متقاضی	m ʊ t q aː z iː
جدیدترین	d͡ʒ a d iː d t a r iː n
مہربند	m ə ɦ ɽ b ə n d
مینار	m iː n aː r
صارفین	s a: ɽ ɪ f iː n
قرعہ	q ʊ r a a a:
الجھن	ʔ ə l d͡ʒ ʱ ʊ n
مارنا	m a: ɽ n a:
کارکرد	k a: r k ə r d
گلانی	ɡ l a: n iː
سائینس	s a: ɪ n s
کھمم	kʰ ʊ m m
برکها	b ə ɽ kʰ a:
بنگالی	b ʊ ŋ ɡ a: l iː
بشیر	b ə ʃ iː ɽ
عیاشی	ʔ ə i j a: ʃ iː
یزدانی	j ɛ z d a: n iː
پیکلس	p eɪ k l s
غزہ	ɣ ə z ə
نے	n eː
میٹرس	m eː t ə r s
دیو	d eː ʋ
آغوش	a: ɣ oː ʃ
ابهار	ʊ bʰ a: ɽ
مہلوک	m ə ɦ l oː k
لہذا	l ɪ ɦ a: z a:
اینٹورپن	ɛː n ʈ ʋ ə ɽ p ə n
بریگیڈیر	b ɽ iː ɡ eɪ d iː r
رنڈی	ɽ ə n ɖ iː
ملک	m ʊ l k
پھیر	pʰ eː ɽ
صفائی	s ɪ f a: iː
چاۓ	t͡ʃ a: eː
بہیمانہ	b ə ɦ iː m aː n ə
ٹھکانا	tʰ ɪ k a: n a:
بچھڑی	b ɪ t͡ʃʰ ɽ iː
بغير	b ə ɣ ɛː ɽ
وتر	ʋ ə t ə ɽ
دمشق	d ə m ɪ ʃ q
ریاضی	ɽ ɪ j a: z iː
ہانگ	ɦ a: ŋ ɡ
کھڑی	kʰ ə ɽ iː
آندھرائی	a: n dʰ ə r a: iː
مکھن	m ə kʰ ə n
کوہ	k oː ɦ
ہاں	ɦ a:
لوشیا	l oː ʃ iː a:
پوزم	p oː z ə m
جواب	d͡ʒ ə ʋ a: b
جمہوریہ	d͡ʒ ʊ m ɦ uː ɽ ɪ j a:
مہنگائی	m ə ɦ ə ŋ ɡ a: iː
بیٹسمےن	b eː ʈ s m ɛ n
علوم	ʔ ʊ l uː m
بدلوانا	b ə d ə l ʋ a: n a:
انگلستان	ɪ ŋ ɡ l ɪ s t a: n
تنازع	t ə n a: z oː ʔ
تلخ	t ə l ə x
ثروت	s ə ɽ ʋ ə t
بکرا	b ə k ɽ a:
آسام	a: s a: m
فلورنگ	f l ɔː r n ɪ ŋ
دشمن	d ʊ ʃ m ə n
مترا	m ʊ t r a:
پیچھا	p iː t͡ʃʰ a:
ٹیکساس	ʈ iː k s a: s
كا	k a:
خونریز	x ʊ n r iː z
تین	t iː n
لاشعوری	l a: ʃ eː ʋ oː ɽ iː
عوام	ə ʋ a: m
صابن	s a: b ʊ n
غفلت	ɣ ə f l ə t
پولیو	p oː l iː oː
سوپر	s uː p ɪ ɽ
مؤذن	m ʊ ə z z ɪ n
قدرت	q ʊ d ɽ a: t
جوا	d͡ʒ ʊ a:
مباین	m ʊ b a: j n
اهہ	ɪ ɦ
کمپت	k ə m p ɪ t
مفت	m ʊ f t
ورزش	ʋ ə ɽ z ɪ ʃ
نندی	n ə n d iː
خارجہ	x a: ɽ ɪ d͡ʒ a:
غیردستوری	ɣ ɛː r d ʊ s t ʊ ɽ iː
مہارت	m ə ɦ a: ɽ ə t
ایکسپریس	aɪ k s p ɽ iː s
لوگ	l oː ɡ
طالبا	t a: l ɪ b a:
انگلینڈ	ɪ ŋ ɡ l ɛː n ɖ
نند	n ə n d
ندی	n ə d iː
پنیسر	p a n iː s ɛ r
الیکٹریسٹی	æ l iː k t r ɪ s t iː
اداس	ʊ d a: s
عبید	a ʊ b eː d
بنيان	b ə n ɪ j a: n
بھنڈاری	bʰ ʊ n ʈʰ a: r iː
ٹھیک	ʈʰ iː k
فلسطین	f ɪ l ɪ s t iː n
رسول	ɽ ə s uː l
کرانیکل	k ə r a: n iː k ə l
دشواری	d ʊ ʃ ʋ a: ɽ iː
شک	ʃ ʊ k
جبوتی	d͡ʒ ɪ b uː t iː
کسمپرسی	k ə s m ʊ p r ə s iː
روٹس	r ɔː ʈ s
انجنئیر	ɪ n d͡ʒ ɪ n i: ɽ
عوامی	a ʋ aː m iː
سیوریج	s iː ʋ ə ɽ ɪ d͡ʒ
کیڈٹس	k eː ɖ ɪ t s
تمھیں	t ʊ m e:
ہلاکت	ɦ ɛː l a: k t
احتمال	eː ɦ t eː m a: l
کارڈ	k a: ɽ d
پسند	p ə s ə n d
ئن	ʔ ɪ n
تھکا	tʰ ə k a:
تماشہ	t ʊ m a: ʃ a:
سالومان	s a: l oː m a: n
از	ə z
ایذارسانیوں	a: ɪ z a: ɽ s a: n iː ʊ n
ارادہ	ʔ ɪ ɽ a: d ə
بڑا	b ə ɽ a:
مفاہمانہ	m ʊ f a: ɦ m a: n a:
جارجن	d͡ʒ a: r d͡ʒ ə n
معضون	m aː z uː n
کو	k oː
صائب	s a: ɪ b
اپریل	ə p ɽ ɛː l
یات	ɪ j a: t
ٹریژری	ʈ r iː ʒ ɛ r iː
معیشت	m ə ʔ iː ʃ ə t
مچلکہ	m ʊ t͡ʃ a l k a:
شعار	ʃ a a: ɽ
استوار	ə s t ʋ a: ɽ
اجگر	ə d͡ʒ ɡ ə ɽ
خلاف	x ɪ l a: f
سرسوں	s ə ɽ s o:
رب	ɽ ə b
احباب	ə ɦ b a: b
گرجا	ɡ ɪ ɽ d͡ʒ a:
خرگوش	x ə ɽ ɡ oː ʃ
مہاجرت	m ʊ ɦ a: d͡ʒ ə ɽ ə t
ورون	ʋ ə ɽ uː n
جگدیشور	d͡ʒ ʊ ɡ d iː ʃ ʊ ɽ
لڑکی	l ə ɽ k iː
گائے	ɡ a: eː
ہم	ɦ ə m
ھما	ɦ m a:
ذائقہ	z a: j q a:
اجوائن	ə d͡ʒ ʋ a: ɪ n
خسرہ	x ə s ɽ a:
جھانجھ	d͡ʒʰ a: d͡ʒʰ
واحد	ʋ a: ɦ ɪ d
گجنی	ɡ ʊ d͡ʒ n iː
دفتری	d ə f t ə r iː
کوچ	k ʊ t͡ʃ
تدریسی	t ə d ɽ iː s iː
بیورو	b j ʊ ɽ oː
مکرجی	m a k ɽ d͡ʒ iː
تکنیکی	t a k n iː k iː
ہے	ɦ ɛː
طبقات	ʈ a: b q a: t
سفارتخانہ	s ɪ f a: ɽ ə t x a: n a:
گینڈا	ɡ ɛː n ɖ a:
خانساماں	x a: n s a: m a:
کہاوت	k ə ɦ a: ʋ ə t
اسمبلی	a s m b l iː
غم	ɣ ə m
سرفروش	s ə ɽ f ə ɽ oː ʃ
میگھ	m eː ɡʰ
چوتڑ	t͡ʃ uː t ə ɽ
بادشاہ	b a: d ʃ a: ɦ
آدمی	a: d m iː
نسبتا	n ɪ s b ə t ə n
نذرآتش	n ɛː z ɽ a: t ɪ ʃ
پٹریو	p ʈ r iː oː
حجام	ɦ ə d͡ʒ d͡ʒ a: m
ویٹ	ʋ eɪ t
پرہیزگاری	p ə r ɦ eː z ɡ a: r iː
اکسپریس	ə k s p eɪ r iː s
فرمائش	f ə ɽ m a: ɪ ʃ
کشیدہ	k a ʃ iː d a:
انگریزی	ə ŋ ɡ ɽ eː z iː
کاج	k a: d͡ʒ
پذیرائی	p ə z iː r aː iː
پٹل	p ə ʈ ə l
سماعت	s ə m a: ʔ ə t
کهان	kʰ a: n
اگرچہ	ə ɡ ə ɽ t͡ʃ eː
لیکھنی	l eː kʰ ə n iː
نام	n a: m
انڈین	ɪ n ʈ iː n
مولوی	m uː l oʊ ʋ iː
بجائے	b ʊ d͡ʒ aː ɪ ə
کتره	k ʊ t ɽ
مراسم	m ʊ r aː s ɪ m
رکوع	ɽ ʊ k uː a
شائنی	ʃ a: ɪ n iː
مسافر	m ʊ s a: f ɪ ɽ
نظم	n ə z ə m
معلوم	m aː l uː m
چہارم	t͡ʃ ə ɦ a: ɽ ʊ m
انگلانگ	ɪ ŋ ɡ l a: ŋ ɡ
دھیریہ	dʰ ɛː ɽ j
فون	f o: n
کوششں	k oː ʃ ɪ ʃ a n
جور	d͡ʒ ʋ ə ɽ
فارمس	f a: r m s
لیکچرر	l iː k t͡ʃ ə ɽ ɽ
اسٹیون	ɪ s t iː ʋ ə n
پیرس	p ɛː ɽ ɪ s
قابض	q a: b ɪ z
برچھا	b ə ɽ t͡ʃʰ a:
شرط	ʃ ə ɽ t
گود	ɡ uː d
بلز	b ə l z
آگ	aː ɡ
ذوق	z ɔː q
جرمنی	d͡ʒ ə ɽ m ə n iː
سرزنش	s ə ɽ z n ɪ ʃ
اشتراکیت	ɪ ʃ t e ɽ a: k ɪ j ə t
قسمت	q ɪ s m ə t
پیغام	p eː ɡ a: m
زندگی	z ɪ n d ə ɡ iː
اکثریت	a k s ʊ ɽ iː t
زکوا	z ə k ʋ a:
ٹھہراؤ	ʈʰ ɛ ɦ r a: oʊ
ساتھی	s a: tʰ iː
دلربا	d ɪ l ɽ ʊ b a:
تیرنا	t ɛː ɽ n a:
سکریٹری	s ə k ɽ iː ʈ ə ɽ iː
کیا	k ɪ j a:
گجویل	ɡ ə d͡ʒ ʋ ə iː l
انٹرملان	ɪ n ʈ ə ɽ m ə l a: n
کمرے	k ə m ɽ eː
متذکرہ	m ʊ t z ɪ k ɽ a:
شیشے	ʃ iː ʃ eː
ٹورسٹ	ʈ ɔː ɽ s ʈ
انگوٹھا	ə ŋ ɡ uː ʈʰ a:
ایموٹو	ɛː m oʊ ʈ oʊ
دوگنا	d oː ɡ ʊ n a:
کھوکس	kʰ oː k s
طبیعیات	t ə b iː ʔ j a: t
مانکیا	m a: n k iː a:
شوق	ʃ ɔː q
سہیل	s ə ɦ iː l
جزیرہ	d͡ʒ a z iː r a
جائپھل	d͡ʒ a: ɪ pʰ ə l
گنبھیر	ɡ ə m bʰ iː ɽ
تصادم	t ə s a: d ə m
احد	a: ɦ ə d
دھرنہ	dʰ ʊ r n a
تقریباً	t ə q ɽ iː b ə n
تخلیہ	t ə x l iː ə
قاعدہ	q a: ʔ ɪ d a: ɦ
مدینہ	m ə d iː n a:
کیوی	k iː ʋ iː
وزیرستان	ʋ ə z iː ɽ ə s t a: n
مانند	m aː n ɪ n d
ابھیجیت	ə bʰ iː d͡ʒ iː t
چھال	t͡ʃʰ a: l
ٹینڈرس	ʈ eː n d ʊ ɽ s
گیند	ɡ eː n d
سستی	s ʊ s t iː
سماس	s ə m a: s
العبیدی	ʔ ɛː l a ɛː b iː d iː
آخرالزماں	a: x ɪ r a l z ʊ m a: n
جادھوپور	d͡ʒ a: dʰ oː p ʊ ɽ
تحفظ	t ə ɦ f ə z
کیلی	k eː l iː
لگے	l ə ɡ eː
سست	s ʊ s t
راہداری	ɽ a: ɦ d a: ɽ iː
چور	t͡ʃ oː ɽ
اقامت	ɪ q a: m ə t
شہر	ʃ ɛ ɦ ɛ ɽ
ابتر	ə b t ə ɽ
ڈیولس	ɖ iː oː l s
ارجت	ə ɽ d͡ʒ ɪ t
سیاست	s ɪ j a: s ə t
پرکاش	p ɽ ə k a: ʃ
درشی	d ɽ ʃ iː
جانور	d͡ʒ a: n ʋ ə ɽ
طرابلس	t ɽ a: b ʊ l s
پریشد	p ɪ r eː ʃ d
بےجا	b eː d͡ʒ a:
نیاک	n iː a: k
ہاتھی	ɦ a: tʰ iː
روچڈیل	ɽ ɔː t͡ʃ ɖ eː l
ریشی	r eː ʃ iː
جنت	d͡ʒ ə n ə t
ثابت	s a: b ɪ t
نمائند	n ʊ m aː ɪ n d
دوستانہ	d oː s t a: n a:
مسجد	m ə s d͡ʒ ɪ d
دکن	d ʊ k n
آنسو	a: s uː
عامہ	a a: m ə
بندیل	b ə n d iː l
ذات	z a: t
کتراپی	k ʊ t ɽ a: p iː
ستاری	s t a: ɽ iː
ریشم	ɽ eː ʃ ə m
ابیان	a: b j a: n
گرانا	ɡ ɪ ɽ a: n a:
اسٹارس	ə s ʈ a: ɽ s
استنبول	ɪ s t ə m b oː l
سبھا	s ə bʰ a:
اداہرن	ʊ d a: ɦ ɽ ə n
سواری	s ʋ a: ɽ iː
لتھوینیا	l ɪ tʰ ʊ eː n ɪ j a:
چنانچہ	t͡ʃ ʊ n a: n t͡ʃ a:
شجرکاری	ʃ ʊ d͡ʒ r k a: r iː
تعزیتی	t ə a z iː t iː
چاہیئے	t͡ʃ a: ɦ iː ɛ
صلیب	s ə l iː b
حمیدالدین	ɦ ʊ m iː d a l d iː n
منظوری	m ə n z ʊ r iː
غزوۂ	ɣ ə z ʋ ə
چابھی	t͡ʃ a: bʰ iː
کوئ	k ʊ ɪ
شنید	ʃ ə n iː d
اوز	oː z
ابوغریب	a: b ʊ ɣ ɽ iː b
فورٹ	f ɔː ɽ ʈ
یونیسیف	j uː n iː s iː f
طوطی	ʈ ɔː ʈ iː
بادام	b a: d a: m
چیمپین	t͡ʃ iː m p iː n
دشت	d ə ʃ t
انھیں	ʊ n e:
پنکھڑی	p ə ŋ kʰ ʊ ɽ iː
ململ	m ə l m ə l
ذ	z
سفید	s ə f eː d
ارتعاش	ɪ ɽ t eː a: ʃ
رائےدہی	ɽ aː ɪ ə d ɦ iː
راجستھان	ɽ a: d͡ʒ s tʰ a: n
کمپیوٹر	k a m p j uː ʈ ə ɽ
رحمت	ɽ ɪ ɦ m a t
بنزین	b ə n z iː n
صالح	s a: l ɪ ɦ
علامہ	a ə l aː m ə
آئیرن	a: ɪ ɽ ə n
کشما	k ʂ ə m a:
شعب	ʃ a a b
ڈھانچہ	ɖʰ a: n t͡ʃ a:
سختی	s a x t iː
مینڈس	m eː n ɖ s
ڈاکٹر	ɖ a: k ʈ ə ɽ
ضمانت	z ə m a: n ə t
آس	a: s
تہائی	t ɪ ɦ a: iː
پرکلا	p ɛ ɽ k l a:
کالسانگرا	k a: l s a: ŋ ɡ r a:
کالنگ	k a: l ə ŋ ɡ
پرسار	p ə ɽ s a: ɽ
رنجن	r ə n d͡ʒ ə n
اروکھ	aː r oː kʰ
زیرقیادت	z i: r q iː a: d t
کنگارو	k ə ŋ ɡ a: ɽ uː
یکجا	j ə k d͡ʒ aː
لغت	l ʊ ɣ ə t
گنی	ɡ ɪ n iː
الزہرہ	a l z ə ɦ r ə
فیالوقت	f iː a: l ʋ ʊ q t
ناراض	n a: ɽ a: z
فلک	f ə l ə k
مقدسہ	m ʊ q ə d d ə s a:
چین	t͡ʃ iː n
دھول	dʰ uː l
گنبذ	ɡ ʊ m b ə z
گلبرگہ	ɡ ʊ l b ə ɽ ɡ ə
کرشمہ	k ə ɽ ɪ ʃ m a:
بیوی	b iː ʋ iː
خریدنا	x ə ɽ iː d n a:
محروم	m ə ɦ ɽ uː m
بنفشی	b ə n ə f ʃ iː
چڑھنا	t͡ʃ ə ɽʰ n a:
پاکستانی	p a: k ɪ s t a: n iː
ناپاک	n a: p a: k
دانت	d ə n t
پوشاک	p oː ʃ a: k
قسط	q ɪ s t
عیسیٰ	iː s a:
ارش	ə ɽ ʃ
لازمی	l a: z m iː
دھل	d ɦ ɛː l
پراڈکٹس	p ɽ a: ʈ k ʈ s
پسندیدہ	p ʊ s n d iː d ə
لکشمن	l ʊ k ʃ m ʊ n
ایماندار	iː m a: n d a: ɽ
مہندی	m ɪ ɦ ə d iː
تمہارا	t ʊ m ɦ a: ɽ a:
تلبیہ	t ə l b iː ə
اودبلاؤ	uː d b ɪ l a: oː
شنتانو	ʃ ə n t ə n uː
تڑت	t ə ɽ ɪ t
ماک	m a: k
دیواکر	d iː ʋ a: k ə ɽ
مدعوئین	m ʊ d a ʋ i: n
اسپنر	ə s p n ə ɽ
دھماکہ	dʰ ə m a: k a: ɦ
ہاشمی	ɦ a: ʃ m iː
گے	ɡ eː
ونڈے	ʋ ʊ n ʈ eː
بہت	b ə ɦ ʊ t
لئے	l ɛː
بائیسکل	b a: iː s ɪ k ə l
ہنگامہ	ɦ ʊ ŋ ɡ a: m ə
النکار	ə l ə ŋ k a: ɽ
کم	k a m
بتانا	b ɪ t a: n a:
گندا	ɡ ʊ n d a:
تجارتی	t ɪ d͡ʒ a: r t iː
کاری	k a: ɽ iː
سوا	s ʋ aː
کمبلے	k ə m b l eː
کنٹرولرس	k ə n ʈ r oː l ə r s
بنوکلب	b ə n oː k l a b
نصاریٰ	n ə s a: ɽ a:
حقیقت	ɦ ə q iː q ə t
پاکستان	p a: k ɪ s t a: n
کمپٹرولر	k a m p j uː t ə ɽ oʊ l ə ɽ
فی۔الحال	f eː a: l ɦ a: l
سندر	s ʊ n d ə ɽ
ملکہ	m ə l ɪ k a:
کارن	k a: ɽ ə n
کفر	k ə f ə r
ارے	ə ɽ eː
ادا	ə d a:
بشرط	b ə ʃ ɽ ʈ
بات	b a: t
منی	m ə n iː
آج	a: d͡ʒ
تہجی	t ə ɦ ə d͡ʒʰ iː
القرآن	a l q ʊ r aː n
خودکش	x ʊ d k ʊ ʃ
پرشنسا	p ɽ ə ʃ ə n s a:
کلکٹر	k ʊ l k ʈ ɛ ɽ
سینکڑا	s ɛː ŋ k ɽ a:
جیبھ	d͡ʒ iː bʰ
ریکارڈس	ɽ eː k a: ɽ ʈ s
ذریعہ	z ə ɽ ɪ j ə
نوواں	n ə u ʋ a:
نبض	n ə b z
تلاش	t ə l a: ʃ
عجیب	ə d͡ʒ iː b
تكميل	t ə k m iː l
نزول	n ə z uː l
ایشیا	a: ɪ ʃ iː a:
ڈیویژنل	ɖ iː ʋ iː ʒ n l
د	d
نيت	n iː t
متوازن	m ʊ t ʋ aː z ə n
گردی	ɡ ʊ r d iː
نومنتخب	n oː m ə n t ɪ x ə b
چکنگنیا	t͡ʃ ɪ k ə n ɡ ʊ n ɪ j a:
ٹھنڈا	ʈʰ ʊ n ɖ a:
ساڑی	s a: ɽ iː
اسٹال	ɪ s ʈ aː l
اصغر	ɪ s ɣ ə ɽ
فریقی	f ə r iː q iː
عبادت	ɪ b a: d ə t
کنواری	k ʊ ʋ a: ɽ iː
انتہا	a n t a a:
بھروسہ	bʰ ə ɽ oː s a:
کھڑا	kʰ ə ɽ a:
اداشدہ	ʔ ə d a: ʃ ʊ d ə
قانون	q a: n uː n
بوڑھا	b uː ɽʰ a:
بونا	b ɔː n a:
بدھسٹ	b ʊ dʰ s ʈ
پراکرت	p ɽ a: k ɽ ɪ t
دارالقضات	d a: ɽ ʊ l q ʊ z a: t
کمان	k ə m a: n
گنگولی	ɡ ʊ ŋ ɡ ɔː l iː
وینیو	ʋ eɪ n iː uː
ماتحت	m aː tʰ a t
سائنسداں	s a: ɪ n s d a: n
سائبرٹاورس	s a: ɪ b ə ɽ ʈ a: ʋ ə ɽ s
نصبین	n ə s b iː n
سینا	s iː n a:
نشانی	n ə ʃ aː n iː
آسرا	a: s ɽ a:
سفارت	s ɪ f a: ɽ ə t
سائنس	s a: ɪ n s
دیپکا	d iː p ɪ k a:
مصنوعات	m ʊ s n u: a a: t
گذارنا	ɡ ʊ z a: ɽ n a:
انفراسٹرکچر	ɪ n f r a: s t ɽ ʊ k t͡ʃ ʊ ɽ
نسبت	n ɪ s b ə t
سوپراسٹار	s uː p ɽ a: s ʈ a: ɽ
پالکرتی	p a: l k ə ɽ t iː
پانچوں	p a: n t͡ʃ o
ڈمرو	ɖ ə m ɽ uː
عاشق	a aː ʃ ɪ q
مثلا	m ə s l ə n
خانہ	x a: n a:
سائیٹ	s aɪ ʈ
جھونکا	d͡ʒʰ uː n k a:
دلیل	d ɪ l iː l
گردوارہ	ɡ ʊ ɽ d ʋ a: ɽ a:
ملازم	m ʊ l a: z ə m
روپ	ɽ uː p
مواصلات	m ʊ ʋ a: s ə l a: t
نکالنا	n ɪ k a: l n a:
جوہر	d͡ʒ ɔː ɦ ə ɽ
لٹیرا	l ʊ ʈ iː ɽ a:
سلیکٹر	s ʊ l iː k ʈ ɛ ɽ
نکل	n ɪ k ə l
کسی	k ə s iː
نفس	n ə f s
بھاجن	bʰ a: d͡ʒ ə n
کبج	k ʊ b d͡ʒ
نر	n ə ɽ
رنگاریڈی	ɽ ə ŋ ɡ a: ɽ iː d iː
کودنڈا	k ʊ d n ʊ n d a:
ہوس	ɦ ə ʋ ə s
وامن	ʋ a: m ə n
حیوانیات	ɦ ɛː ʋ a: n ɪ j a: t
شیواجی	ʃ iː ʋ a: d͡ʒ iː
لدھیانہ	l ʊ dʰ ɪ j a: n a:
غرناطہ	ɣ ə ɽ n a: t a: ɦ
کیف	k eː f
گرنا	ɡ ɪ ɽ n a:
میدان	m eː d a: n
ایشیائی	a: iː ʃ iː a: iː
راشٹرپتی	r a: ʃ t r p a t iː
بکاؤ	b ɪ k a: uː
مقبوض	m ə q b uː z
عارضی	a a: r ɪ z iː
تولہ	t u: l a:
تاریخی	t a: r ɪ x iː
پرجوش	p ʊ r d͡ʒ oː ʃ
زینت	z eɪ n ə t
ڈھانک	ɖʰ a: n k
جوفری	d͡ʒ o f r iː
سہواس	s ə ɦ ʋ a: s
امان	ə m a: n
گنتی	ɡ ɪ n t iː
وہی	ʋ ə ɦ iː
گزارش	ɡ ʊ z a: ɽ ɪ ʃ
کاشف	k a: ʃ f
اتم	ɪ t ə m
ظفر	z ʊ f ə r
سورج	s uː r d͡ʒ
فارچو	f a: ɽ t͡ʃ oː
پاور	p a: ʋ ə ɽ
کپتان	k ə p t a: n
سوشیل	s oː ʃ iː l
برڈ	b ɽ ʊ d
روایاتی	ɽ ʋ a: j a: t iː
بلکہ	b ə l k iː
گزشتہ	ɡ ʊ z ʃ t ɦ
جہنم	d͡ʒ ə ɦ ə n n ə m
رومس	ɽ uː m s
مدائن	m ʊ d a: ɪ n
گندھاری	ɡ ʊ n d ɦ a: ɽ iː
اڈوائزری	ə ɖ ʋ a: ɪ z ə ɽ iː
اختتام۔پزیر	a: x t t a: m p ə z iː ɽ
لداخ	l ə d a: x
چکنائی	t͡ʃ ʊ k n aɪ iː
سفر	s ə f ə ɽ
الداخلہ	ʔ ɛː l d a: x l a:
جنگل	d͡ʒ ə ŋ ɡ ə l
سندھ	s ɪ n dʰ
البتہ	a l b ə t a:
لنگ	l ɪ ŋ ɡ
مول	m oː l
مکر	m ʊ k ə ɽ
پوشیدہ	p oː ʃ iː d ə
گدا	ɡ ʊ d a:
پاستا	p a: s t a:
جوانی	d͡ʒ ə ʋ a: n iː
دفعہ	d ə f ʔ a:
کمپن	k ə m p ə n
پار	p a: ɽ
اومیش	oː m iː ʃ
خریدوانا	x ə ɽ iː d ʋ a: n a:
یچوری	j ɛ t͡ʃ oː r iː
ناکامی	n a: k a: m iː
بازو	b a: z uː
دباؤ	d ə b a: oː
احمق	ə ɦ m ə q
راستہ	ɽ a: s t ə
کولکاتا	k oː l k a: t a:
خلافت	x ɪ l a: f ə t
مسوری	m ʊ s ʋ ʊ r iː
محفوظ	m ʊ ɦ f oː z
ریچھ	ɽ iː t͡ʃʰ
نستعلیق	n ə s t a: l iː q
ڈسمبر	ɖ ə s m b ə ɽ
جس	d͡ʒ ʊ s
ٹیکسی	ʈ iː k s iː
یوسف	j uː s ə f
فرنانڈو	f a r n a: n ɖ a uː
چھینک	t͡ʃʰ i: k
جاہی	d͡ʒ a: ɦ iː
