хонуурь	x ɔ n ʊː rʲ
кинонуудгүй	kʰ i n ɔ n ʊː t k u i̯
амьтнаас	a mʲ tʰ n aː s
холтоснуудгүй	x ɔ ɮ tʰ ɔ s n ʊː t k u i̯
мөгөөрс	m ɵ ɣ ɵː r s
холтостойгоо	x ɔ ɮ tʰ ɔ s tʰ ɔ i̯ ɣ oː
шинэлэг	ʃ i n ɮ ə ɡ
Пёньян	pʰʲ ɔ n j a ŋ
кинон	kʰ i n ɔ ŋ
аавынд	aː w̜ i n t
холтсыгоо	x ɔ ɮ tʰ s i ɣ oː
номуудад	n ɔ m ʊː t a t
бүхэн	p u x ə ŋ
Аргентин	a r kʲ ɵ n tʰ i ŋ
Хонконг	x ɔ ŋ kʰ ɔ ŋ k
таах	tʰ aː x
автомашинуудгүй	a w̜ tʰ ɔ m a ɕ i n ʊː t k u i̯
үйлдвэржих	u i ɮ t w ə r t͡ɕ ə x
сээр	s eː r̥
ё	j ɔ
нэрийн	n e r iː ŋ
гитарууддаа	k i tʰ a r ʊː t͉ t aː
хөвгүүнээ	x ɵ w̜ k uː n eː
гүнжийгээ	k u n t͡ɕ iː k eː
амжилт	a m t͡ɕ i ɮ tʰ
лалраас	ɮ a ɮ r aː s
жишээнүүдгүй	t͡ɕ i ɕ eː n uː t k u i̯
мануул	m a n ʊ ɮ
абстрактад	a p s tʰ r a kʰ tʰ a t
унших	ʊ n ʃ ə x
нэрээр	n e r eː r̥
анхилгыгаа	a ŋ x i ɮ k i ɣ aː
төр	tʰ ɵ r
динозавруудгүй	t i n ɔ t͡s a w̜ r ʊː t k u i̯
лалрын	ɮ a ɮ r i ŋ
аавуудыг	aː w̜ ʊː t i k
Казахстан	kʰ ä t͜s ä ɢ s tʰ äˑ n
хөших	x ɵ ɕ i x
Финлянд	f i n ɮʲ a n t
ихгүй	i x k u i̯
тэргээр	tʰ e r k eː r̥
Лхама	ɬʰ a m a
бургаснуудын	p ʊ r k a s n ʊː t i ŋ
бургасан	p ʊ r k a s a ŋ
нэрснүүдээсээ	n e r s n uː t eː s eː
ван	w a ŋ̠
пид	pʰ i t
бороо	p ɔ r oː
төгрөгүүдтэй	tʰ ɵ k r ɵ ɣ uː t tʰ e i̯
түлхэх	t u ɮ x ə x
адгууснаас	a t k ʊː s n aː s
хүнийх	x u n iː x
архичны	a r x i t͡ɕʰ n i
нэргүй	n e r k u i̯
бүрхүүл	p u r x u ɮ
залуучуудын	t͡s a ɮ ʊː t͡ɕʰ ʊː t i ŋ
Өгэдэйн	ɵ ɣ e t e i̯ ŋ
ёл	j ɔ ɮ
баймж	p ɛː m t͡ɕ
массаж	m a s s a t͡ɕ
усандаас	ʊ s a n t aː s
кинотеатр	kʰ i n ɔ tʰʲ ɵ a tʰ r̥
хаанаараа	x aː n aː r aː
суух	s ʊː x
нөхөр	n ɵ x u r
эмнэлэг	i m n ə ɮ ə ɡ
бөөг	p ɵː k
баянтай	p a j a n tʰ ɛː
у	ʊ
гитаруудынхан	k i tʰ a r ʊː t i ŋ x a ŋ
гэрүүдтэй	k e r uː t tʰ e i̯
диктатур	t i kʰ tʰ a tʰ ʊ r̥
хааных	x aː n i x
телефон	tʰʲ ɵ ɮʲ ɵ f ɔ ŋ
Герман	ɡ e r m aˑ ɴ̟
загас	t͡s a ɢ ə s
борш	p ɔ r ɕ
булаалгах	p ʊ ɮ aː ɮ k a x
цайгүй	t͡sʰ ɛː k u i̯
алчуур	a ɮ t͡ʃ ʊː r
орой	ɔ r ɔ i
ээ	eː
хөвгүүнгүй	x ɵ w̜ k uː ŋ k u i̯
эн	e ŋ
хааныгаа	x aː n i ɣ aː
бөө	p ɵː
рестораныг	rʲ ɵ s tʰ ɔ r a n i k
хаалт	x aː ɮ tʰ
тахиануудынхан	tʰ a x i̯ aː n ʊː t i ŋ x a ŋ
тойруу	tʰ ɔ i r ʊ
сексүүдэд	s j ɵ kʰ s uː t e t
утга	ʊ tʰ ə ɢ
грекүүдээсээ	k rʲ ɵ kʰ uː t eː s eː
автомашинуудаас	a w̜ tʰ ɔ m a ɕ i n ʊː t aː s
тэнгисийнх	tʰ e ŋ k i s iː ŋ x
киданчууд	kʰ i t a n t͡ɕʰ ʊː t
англи	a ŋ k i ɮ
мөчир	m o t͡ɕʰ ə r
юм	j ʊ m
ресторануудаар	rʲ ɵ s tʰ ɔ r a n ʊː t aː r̥
динозавруудтай	t i n ɔ t͡s a w̜ r ʊː t tʰ ɛː
авгалдайнууд	a w̜ k a ɮ t ɛː n ʊː t
валют	w̜ a ɮʲ ʊ tʰ
моринд	m ɔ r i n t
Доржоос	t ɔ r t͡ɕ oː s
жишээнийх	t͡ɕ i ɕ eː n iː x
галиггүй	k a ɮ i ɣ u i̯
үзүүр	u t͡s u r
анаашнууд	a n aː ɕ n ʊː t
холтоснуудыгаа	x ɔ ɮ tʰ ɔ s n ʊː t i ɣ aː
анхилгын	a ŋ x i ɮ k i ŋ
шил	ʃ i ɮ
автомашинаас	a w̜ tʰ ɔ m a ɕ i n aː s
завь	t͡s a wʲ
Чингисийнхээс	t͡ɕʰ i ŋ k i s iː ŋ x eː s
зүүнтэн	t͜s uː n tʰ ə ŋ
мотоцикл	m ɔ tʰ ɔ t͡sʰ i kʰ ɮ
заан	t͜s aː ɴ̟
Улаанбаатараас	ʊ ɮ aː m p aː tʰ a r aː s
ноёдын	n ɔ j ɔ t i ŋ
зурвас	t͡s ʊ r w ə s
мориндоос	m ɔ r i n t oː s
мориныхгүй	m ɔ r i n i x k u i̯
авгалдайнуудгүй	a w̜ k a ɮ t ɛː n ʊː t k u i̯
Грек	kʲ ɵ rʲ ɵ kʰ
Мьянмар	m j a m m a r̥
гэрүүдийнхээ	k e r uː t iː ŋ x eː
гүнжүүдийнх	k u n t͡ɕ uː t iː ŋ x
алуурчнаар	a ɮ ʊː r̥ t͡ɕʰ n aː r̥
гэрүүдгүйгээ	k e r uː t k u i̯ ɣ eː
бараг	p a r a k
гэрүүд	k e r uː t
тонн	tʰ ɔ nː
шалбархай	ɕ a ɮ p a r x ɛː
амьтдынд	a mʲ tʰ t i n t
дур	t ʊ r̥
завод	t͜s ä w̜ ɔˑ t
амьтангүй	a mʲ tʰ a ŋ k u i̯
гүнжидгүй	k u n t͡ɕ i t k u i̯
шүүрдэх	ɕ uː r t e x
гайхамшиг	ɢ a i x a m ʃ i ɡ
сүрэг	s u r ə ɡ
хадаг	x a t ə ɡ
анхилга	a ŋ x i ɮ k
амьтдад	a mʲ tʰ t a t
савхаар	s a w̜ x aː r̥
байгалийг	p ɛː k a ɮ iː k
гольфчин	k ɔ ɮʲ f t͡ɕʰ i ŋ
авгаар	a w̜ k aː r̥
арьстны	a rʲ s tʰ n i
авдар	a w̜ t a r̥
хос	x ɔ s
кинонуудаас	kʰ i n ɔ n ʊː t aː s
сэтгүүл	s e tʰ ɡ u ɮ
тахиудаараа	tʰ a x i̯ ʊː t aː r aː
тэ	tʰ e
агаараас	a ɣ aː r aː s
спорт	s pʰ ɔ r̥ tʰ
байрныхан	p ɛː r n i x a ŋ
борной	p ɔ r n ɔ i
хүлэх	x u ɮ ə x
дүрс	t u r s
буян	p ʊ j ə ŋ
нэрснийхэн	n e r s n iː x e ŋ
грекүүдгүй	k rʲ ɵ kʰ uː t k u i̯
ааруулгүй	aː r ʊː ɮ k u i̯
чавхдас	t͡ɕʰ a w x t ə s
төгрөгт	tʰ ɵ k r ɵ k tʰ
зан	t͡s a ŋ
индүү	i n t uː
Өэлүнтэй	ɵ e ɮ u n tʰ e i̯
морилох	m ɔ rʲ ɮ ə x
аагуудаас	aː k ʊː t aː s
гуайнуудгүй	k u̯ ɛː n ʊː t k u i̯
пиджакаас	pʰ i t t͡ɕ a kʰ aː s
гайхлуудын	k ɛː x ɮ ʊː t i ŋ
ангиасаа	a ŋ k i̯ aː s aː
гол	ɢ ɔ ɮ
гүнжүүддээ	k u n t͡ɕ uː t͉ t eː
зоримог	t͡s ɔ rʲ ə m ə ɡ
шашнуудтайгаа	ɕ a ɕ n ʊː t tʰ ɛː k aː
нэрийгээ	n e r iː k eː
мээм	m eː m
илжиггүй	i ɮ t͡ɕ i ɣ u i̯
тухайд	tʰ ʊ x a i t
ганц	ɢ a n t͡sʰ
байгууллагынхан	p ɛː k ʊː ɮː a ɣ i ŋ x a ŋ
шивээс	ʃ i w e s
гуя	k ʊ j
бодьсадва	p ɔ tʲ s a t w̜
өеө	ɵ j ɵ
алуурчдын	a ɮ ʊː r̥ t͡ɕʰ t i ŋ
ангиудаа	a ŋ k i̯ ʊː t aː
шашныг	ɕ a ɕ n i k
галигуудаар	k a ɮ i ɣ ʊː t aː r̥
Сөүл	s ɵ u ɮ
авдруудгүй	a w̜ t r ʊː t k u i̯
хөвгүүнийхэн	x ɵ w̜ k uː n iː x e ŋ
уруул	ʊ r ʊ ɮ
хэрэглээ	x i r ə ɡ ɮ e
жаргалтай	t͡ɕ a r k a ɮ tʰ ɛː
талх	tʰ a ɮ x
нэрстэй	n e r s tʰ e i̯
лалруудынхан	ɮ a ɮ r ʊː t i ŋ x a ŋ
гийгүүлэгч	k iː k uː ɮ e k t͡ɕʰ
байгууллагагүй	p ɛː k ʊː ɮː a ɣ a k u i̯
тавигдаагүй	tʰ a w̜ i k t aː k u i̯
худалдах	x ʊ t ə ɮ t ə x
ба	p a
гүнжийнх	k u n t͡ɕ iː ŋ x
пиццагүй	pʰ i t͡sʰ a ɣ u i̯
Мандалговь	m a n t a ɮ k ɔ w̜ʲ
гүнжүүдийгээ	k u n t͡ɕ uː t iː k eː
монголч	m ɔ ɴ ɢ ʊ ɮ t͡ʃʰ
тэс	tʰ i s
Өэлүнгүй	ɵ e ɮ u ŋ k u i̯
бүхнээр	p u x n eː r̥
золгох	t͡s ɔ ɮ ɢ ə x
аадар	aː d ə r
хошууч	x ɔ ɕ ʊː t͡ɕʰ
нэрсээсээ	n e r s eː s eː
байр	p ɛː r̥
гэргий	ɡ e r ɡ iː
устайгаа	ʊ s tʰ ɛː k aː
хүнцэл	x u n t͡sʰ e ɮ
байгалиас	p ɛː k a ɮ i̯ aː s
төгрөгөөр	tʰ ɵ k r ɵ ɣ ɵː r̥
хүмүүсийнх	x u m uː s iː ŋ x
залуучуудад	t͡s a ɮ ʊː t͡ɕʰ ʊː t a t
ус	ʊ s
анхилгагүй	a ŋ x i ɮ k a ɣ u i̯
авгалдайнуудаар	a w̜ k a ɮ t ɛː n ʊː t aː r̥
урчуудын	ʊ r̥ t͡ɕʰ ʊː t i ŋ
хөвгүүнийхээ	x ɵ w̜ k uː n iː x eː
абстрактуудыг	a p s tʰ r a kʰ tʰ ʊː t i k
хэхрэх	x e x r e x
гэрүүдээ	k e r uː t eː
архивуудын	a r x i w̜ ʊː t i ŋ
улсуудыг	ʊ ɮ s ʊː t i k
гитаруудынх	k i tʰ a r ʊː t i ŋ x
хүүхэлдэй	x uː x ə ɮ t e
лийр	ɮ iː r
Чингисээ	t͡ɕʰ i ŋ k i s eː
цахим	t͡sʰ a x i m
Өэлүнийд	ɵ e ɮ u n iː t
тэнгисүүд	tʰ e ŋ k i s uː t
хөхөх	x ɵ x ɵ x
зонтик	t͜s ɔˑ n tʰ ʊ̈ kʰ
уул	ʊː l a
кинонуудын	kʰ i n ɔ n ʊː t i ŋ
муж	m ʊ t͡ɕ
сэрээх	s e r eː x
хөвгүүдийнхээ	x ɵ w̜ k uː t iː ŋ x eː
пиццануудын	pʰ i t͡sʰ a n ʊː t i ŋ
нэргүйгээ	n e r k u i̯ ɣ eː
номны	n ɔ m n i
авгыг	a w̜ k i k
амьтдыг	a mʲ tʰ t i k
хүмүүнгүй	x u m uː ŋ k u i̯
илжигнийх	i ɮ t͡ɕ i k n iː x
сартуул	s a r tʰ ʊː ɮ
гүнжийн	k u n t͡ɕ iː ŋ
нэрснүүдийнхэн	n e r s n uː t iː ŋ x e ŋ
үүлэнд	uː ɮ e n t
гүрэн	ɡ u r e ŋ
тоормос	tʰ oː r m ɔ s
мориндоо	m ɔ r i n t oː
ресторанууд	rʲ ɵ s tʰ ɔ r a n ʊː t
шонхор	ʃ ɔ ŋ x ɔ r
мал	m a ɮ
луунуудаасаа	ɮ ʊː n ʊː t aː s aː
мөсөн	m ɵ s ɵ ŋ
хөдөлмөр	x ɵ t ɵ ɮ m ɵ r
гүнжийнхэн	k u n t͡ɕ iː ŋ x e ŋ
авлигач	a w̜ ɮ i ɣ a t͡ɕʰ
сексүүдтэй	s j ɵ kʰ s uː t tʰ e i̯
луунуудаас	ɮ ʊː n ʊː t aː s
пиццанд	pʰ i t͡sʰ a n t
өдөр	ɵ t ə r̥
нэрснүүдээрээ	n e r s n uː t eː r eː
жууцайнд	t͡ɕ ʊː t͡sʰ ɛː n t
Чингисийг	t͡ɕʰ i ŋ k i s iː k
дэлхий	t e ɬʰ iː
аймшиг	a i m ʃ i ɡ
хөнжил	x ɵ n t͡ɕ ə ɮ
утаа	ʊ tʰ a
хялгас	xʲ a ɮ ʁ a s
луутай	ɮ ʊː tʰ ɛː
бэлтгэл	p e ɮ tʰ ɡ e ɮ
тэмээнийхэн	tʰ e m eː n iː x e ŋ
амттан	a m tʰ a ŋ
оочир	ɔː t͡ɕʰ ə r
агаарын	a ɣ aː r i ŋ
тэрэгнүүдийн	tʰ e r e k n uː t iː ŋ
хүнийхэн	x u n iː x e ŋ
зөгийнүүдэд	t͡s ɵ ɣ iː n uː t e t
дэслэгч	t e s ɮ e k t͡ɕʰ
аагийг	aː k iː k
лалрынх	ɮ a ɮ r i ŋ x
щ	ɕ
ханхайнхан	x a ŋ x ɛː ŋ x a ŋ
усгүйгээ	ʊ s k u i̯ ɣ eː
шашнууд	ɕ a ɕ n ʊː t
омог	ɔ m ə ɡ
архиваар	a r x i w̜ aː r̥
гүнжидтэйгээ	k u n t͡ɕ i t tʰ e i̯ ɣ eː
ааваар	aː w̜ aː r̥
аадрын	aː t r i ŋ
сармис	s a r mʲ ə s
лалрууд	ɮ a ɮ r ʊː t
анхилгуудгүй	a ŋ x i ɮ k ʊː t k u i̯
цайгаар	t͡sʰ ɛː k aː r̥
япончуудын	j a pʰ ɔ n t͡ɕʰ ʊː t i ŋ
Чингисээр	t͡ɕʰ i ŋ k i s eː r̥
нохой	n ɔ x ɔ i
дал	t a ɮ
тахиудгүйгээ	tʰ a x i̯ ʊː t k u i̯ ɣ eː
тэнгисээр	tʰ e ŋ k i s eː r̥
огурцы	o ɡ ə r t͡sʰ i
нам	n a m
од	ɔ t
тахиудаас	tʰ a x i̯ ʊː t aː s
бүжигчин	p u t͡ɕ ə ɡ t͡ɕʰ ə ŋ
усаар	ʊ s aː r̥
хязаалан	xʲ a t͡s aː ɮ a ŋ
хаадынх	x aː t i ŋ x
хэлэлцэх	x i ɮ ə ɮ t͡sʰ ə x
соруул	s ɔ r ʊ ɮ
анчдаас	a n t͡ɕʰ t aː s
ноёдтой	n ɔ j ɔ t tʰ ɔ i̯
уу	ʊː
анх	a ŋ x
шүд	ʃ u d
шафа	ʃ a f a
архивуудтай	a r x i w̜ ʊː t tʰ ɛː
ажлынхаа	a t͡ɕ ɮ i ŋ x aː
амьтадгүй	a mʲ tʰ a t k u i̯
тархи	tʰ a rʲ xʲ
морьгүйгээ	m ɔ rʲ k u i̯ ɣ eː
ганжин	ɢ a n t͡ɕ ə ŋ
малчин	m a ɮ t͡ɕʰ ə ŋ
Чингист	t͡ɕʰ i ŋ k i s tʰ
грекүүдтэйгээ	k rʲ ɵ kʰ uː t tʰ e i̯ ɣ eː
цайнуудад	t͡sʰ ɛː n ʊː t a t
байгууллагуудын	p ɛː k ʊː ɮː a ɣ ʊː t i ŋ
дуучин	t ʊː t͡ɕʰ ə ŋ
анаашнаас	a n aː ɕ n aː s
хаг	x a ɡ
луундаа	ɮ ʊː n t aː
түрүүч	tʰ u r uː t͡ɕʰ
буддаараа	p ʊ t͉ t aː r aː
нөхөөс	n ɵ x ɵː s
холтоснуудаар	x ɔ ɮ tʰ ɔ s n ʊː t aː r̥
тахиудаар	tʰ a x i̯ ʊː t aː r̥
цангах	t͡sʰ a ŋ ɢ ə x
алуурчдад	a ɮ ʊː r̥ t͡ɕʰ t a t
грекээ	k rʲ ɵ kʰ eː
үүлнүүдээр	uː ɮ n uː t eː r̥
илжигнүүдийнхэн	i ɮ t͡ɕ i k n uː t iː ŋ x e ŋ
байгууллагуудынх	p ɛː k ʊː ɮː a ɣ ʊː t i ŋ x
гуайтай	k u̯ ɛː tʰ ɛː
анчин	a n t͡ɕʰ i ŋ
математик	m a tʰʲ ɵ m a tʰ i kʰ
өлмий	o ɮ m i
тэнгисүүдийнхэн	tʰ e ŋ k i s uː t iː ŋ x e ŋ
өр	ɵ r̥
халдваргүйжил	x a ɮ t w̜ a r k u i̯ d͡ʑ i ɮ
хурим	x ʊ rʲ ə m
сексгүй	s j ɵ kʰ s k u i̯
ноёны	n ɔ j ɔ n i
эрхүүд	e r x uː t
хариуцах	x a r i̯ ʊː t͡sʰ a x
рестораныхан	rʲ ɵ s tʰ ɔ r a n i x a ŋ
ял	j a ɮ
байгууллагын	p ɛː k ʊː ɮː a ɣ i ŋ
тахиудтайгаа	tʰ a x i̯ ʊː t tʰ ɛː k aː
байрнуудаа	p ɛː r n ʊː t aː
мөндөрлөх	m ɵ n t ɵ r ɮ ə x
байрнаас	p ɛː r n aː s
фотогоос	f ɔ tʰ ɔ ɣ oː s
фототой	f ɔ tʰ ɔ tʰ ɔ i̯
адгуусан	a t k ʊː s a ŋ
бөхчүүд	p ɵ x t͡ɕʰ uː t
болор	p ɔ ɮ ʊ r
нисгэгч	n i s ɡ e ɡ t͡ʃʰ
туг	tʰ ʊ k
авъяастай	a w̜ j aː s tʰ ɛː
хэл	x e ɮ
авдарт	a w̜ t a r̥ tʰ
нээлттэй	n eː ɮ tʰ tʰ e
хөвгүүдийгээ	x ɵ w̜ k uː t iː k eː
савар	s a w ə r
улсад	ʊ ɮ s a t
холтсондоо	x ɔ ɮ tʰ s ɔ n t oː
хүмүүнийх	x u m uː n iː x
хайчлах	χ æː t͡ʃʰ ɮ ə χ
анхилгуудтай	a ŋ x i ɮ k ʊː t tʰ ɛː
ааг	aː k
гитаруудынхаа	k i tʰ a r ʊː t i ŋ x aː
байрнуудтай	p ɛː r n ʊː t tʰ ɛː
хаанд	x aː n t
жууцайтай	t͡ɕ ʊː t͡sʰ ɛː tʰ ɛː
Украин	ʊ kʰ r a i ŋ
агаарынх	a ɣ aː r i ŋ x
боошиг	p oː ɕ i k
чийг	t͡ɕʰ iː ɡ
Бөртийнд	p ɵ r̥ tʰ iː n t
Мексик	mʲ ɵ kʰ s i kʰ
шүүслэх	ʃ uː s ɮ ə x
бодох	p ɔ t ɔ x
ноёдыг	n ɔ j ɔ t i k
архивтай	a r x i w̜ tʰ ɛː
хавчих	x a w t͡ɕʰ ə x
гүнжид	k u n t͡ɕ i t
номуудын	n ɔ m ʊː t i ŋ
маллах	m a ɮ ɮ ə x
аль	æ ɮ
хайнаг	x a i n ə ɡ
трактор	tʰ r a kʰ tʰ ə r̥
орчуулагч	ɔ r̥ t͡ɕʰ ʊː ɮ a k t͡ɕʰ
гэрийн	k e r iː ŋ
абстрактаас	a p s tʰ r a kʰ tʰ aː s
тос	tʰ ɔ s
хүмүүстээ	x u m uː s tʰ eː
тэвэр	tʰ i w ə r
Бөртэтэй	p ɵ r̥ tʰ e tʰ e i̯
тэмээгээр	tʰ e m eː k eː r̥
автобуснууд	a w̜ tʰ ɔ p ʊ s n ʊː t
ангийнхан	a ŋ k iː ŋ x a ŋ
хүмүүний	x u m uː n iː
руу	r ʊː
наяд	n a j a t
пиццануудаар	pʰ i t͡sʰ a n ʊː t aː r̥
үгс	u k s
тэмээгүй	tʰ e m eː k u i̯
үйлчлэх	u i ɮ t͡ɕʰ ɮ ə x
шашнуудын	ɕ a ɕ n ʊː t i ŋ
нурам	n ʊ r ə m
барамнас	p a r a m n a s
анхилгуудад	a ŋ x i ɮ k ʊː t a t
гитаруудаар	k i tʰ a r ʊː t aː r̥
тархах	tʰ a r x ə x
хатмал	x a tʰ m ə ɮ
жишээ	t͡ɕ i ɕ eː
Чингисийнхээ	t͡ɕʰ i ŋ k i s iː ŋ x eː
грекүүдийнхэн	k rʲ ɵ kʰ uː t iː ŋ x e ŋ
баруун	p a r ʊː n
илжигнээс	i ɮ t͡ɕ i k n eː s
номуудтай	n ɔ m ʊː t tʰ ɛː
нэрсийнхэн	n e r s iː ŋ x e ŋ
тэрэгнүүдийнхэн	tʰ e r e k n uː t iː ŋ x e ŋ
хамба	x a m p
зүс	t͡s u s
францчууд	f r a n t͡sʰ t͡ɕʰ ʊː t
адгууснууд	a t k ʊː s n ʊː t
алуурчингүй	a ɮ ʊː r̥ t͡ɕʰ i ŋ k u i̯
үгийн	u ɡ i ŋ
аашны	aː ɕ n i
жишээнүүдээс	t͡ɕ i ɕ eː n uː t eː s
аадраар	aː t r aː r̥
боодог	p oː t ɔ k
баянд	p a j a n t
мажоритар	m a d͡ʑ ɔ r i tʰ a r̥
мэсэс	m e s e s
жишээнүүдээр	t͡ɕ i ɕ eː n uː t eː r̥
фронт	f r ɔˑ n tʰ
баавгай	p aː w̜ k ɛː
дэвшилт	t i w ʃ ə ɮ tʰ
ханхайгаас	x a ŋ x ɛː k aː s
байгальгүй	p ɛː k a ɮʲ k u i̯
дэл	t i ɮ
бич	p i t͡ɕʰ
мөрөөдөл	m o r o t ə ɮ
боомт	p oː m tʰ
зам	t͡s a m
лалрыг	ɮ a ɮ r i k
өвчин	ɵ w̜ t͡ɕʰ i ŋ
мэргэн	m e r ɡ e ŋ
холтоснууд	x ɔ ɮ tʰ ɔ s n ʊː t
Шанхай	ɕ a ŋ x ɛː
грекийнхэн	k rʲ ɵ kʰ iː ŋ x e ŋ
жууцайгаар	t͡ɕ ʊː t͡sʰ ɛː k aː r̥
авгуудынд	a w̜ k ʊː t i n t
япончууд	j a pʰ ɔ n t͡ɕʰ ʊː t
гүнжидгүйгээ	k u n t͡ɕ i t k u i̯ ɣ eː
грекээсээ	k rʲ ɵ kʰ eː s eː
анхилгад	a ŋ x i ɮ k a t
компани	kʰ ɔ m pʰ a n
аашийг	aː ɕ iː k
машинд	m a ɕ i n t
үгнийх	u k n iː x
вакцин	w̜ a kʰ t͡sʰ i ŋ
тахийнхан	tʰ a x iː ŋ x a ŋ
холтосгүйгээ	x ɔ ɮ tʰ ɔ s k u i̯ ɣ eː
усны	ʊ s n i
шанд	ʃ a n t
орон	ɔ r ə ŋ
каучук	kʰ a w t͡ʃʰ ʊˑ kʰ
усаараа	ʊ s aː r aː
анчны	a n t͡ɕʰ n i
үүл	uː l
найрамдахчуудын	n ɛː r a m t a x t͡ɕʰ ʊː t i ŋ
пулемёт	pʰ u ɮ mʲ ɔˑ tʰ
тэнгисүүдийнх	tʰ e ŋ k i s uː t iː ŋ x
хөрөө	x o r o
ХДХВ	x eː t eː x eː w eː
луунуудаараа	ɮ ʊː n ʊː t aː r aː
адгуусаар	a t k ʊː s aː r̥
холтос	x ɔ ɮ tʰ ə s
тб	tʰ e r p ʊ m
хоньчин	x ɔ nʲ t͡ʃʰ i ŋ
нэрээ	n e r eː
бүхнээс	p u x n eː s
фотогийн	f ɔ tʰ ɔ ɣ iː ŋ
тэмээн	tʰ e m eː ŋ
тахианд	tʰ a x i̯ aː n t
вирусийг	w̜ i r ʊ s iː k
байрнуудаараа	p ɛː r n ʊː t aː r aː
авгуудаас	a w̜ k ʊː t aː s
илжиг	i ɮ t͡ɕ i k
гүнжийг	k u n t͡ɕ iː k
сүмо	s u m ɔ
ёслол	j ɔ s ɮ ʊ ɮ
үнээ	u n e
бичлэг	p i t͡ʃʰ ɮ e ɡ
Халимаг	x a ɮ i m a k
хорсох	x ɔ r s ə x
авдруудыг	a w̜ t r ʊː t i k
арьстан	a rʲ s tʰ a ŋ
шашных	ɕ a ɕ n i x
шалтгаан	ʃ a ɮ tʰ ɢ a ŋ
нэрснүүдтэйгээ	n e r s n uː t tʰ e i̯ ɣ eː
анчдын	a n t͡ɕʰ t i ŋ
мориндоосоо	m ɔ r i n t oː s oː
баянаар	p a j a n aː r̥
Даланзадгад	t a ɮ a n t͡s a t k a t
лифт	ɮ i f tʰ
холтоснуудтайгаа	x ɔ ɮ tʰ ɔ s n ʊː t tʰ ɛː k aː
тухай	tʰ ʊ x a i
рубль	r ʊ p ɮʲ
царс	t͡sʰ a r s
хүнээс	x u n eː s
факсдах	f a kʰ s t a x
төгрөгийг	tʰ ɵ k r ɵ ɣ iː k
харгана	x a r ɢ ə n
Чингисийгээ	t͡ɕʰ i ŋ k i s iː k eː
ажил	a t͜ɕ ə ɮ
Ром	r ɔ m
энэ	e n
эхлэх	e x ɮ ə x
зөгийнүүдтэй	t͡s ɵ ɣ iː n uː t tʰ e i̯
Бээжинтэй	p eː t͡ɕ i n tʰ e i̯
дуусгах	t ʊː s ɢ ə x
он	ɔ ŋ
хувилбар	x ʊ wʲ ə ɮ p ə r
хужаа	x ʊ d͡ʑ aː
илжигнүүдийн	i ɮ t͡ɕ i k n uː t iː ŋ
солонго	s ɔ ɮ ʊ ɴ ɢ
уснаас	ʊ s n aː s
арынхан	a r i ŋ x a ŋ
үзэм	u t͡s ə̆ m
Хархорин	x a r x ɔ r i ŋ
хүнийхээ	x u n iː x eː
авдрыг	a w̜ t r i k
агаарыг	a ɣ aː r i k
жилгүй	t͡ɕ i ɮ k u i̯
ерөнхийлөх	j ɵ r ɵ ŋ x iː ɮ ɵ x
зорилго	t͡s ɔ rʲ ə ɮ ə ɢ
халдваргүйжих	x a ɮ t w̜ a r k u i̯ d͡ʑ i x
ө	ɵ
цэдэнбализм	t͡sʰ e t e m p a ɮ i t͡s m
чи	t͡ɕʰ i
цөцгий	t͡sʰ o t͡sʰ ɡ i
архивын	a r x i w̜ i ŋ
Төвөд	tʰ u p ɘ t
сексийн	s j ɵ kʰ s iː ŋ
аяган	a j a ɣ a ŋ
футболк	f ʊ tʰ p ɔ ɮ kʰ
ааруулуудыг	aː r ʊː ɮ ʊː t i k
шашныгаа	ɕ a ɕ n i ɣ aː
Битлз	p i tʰ ə ɮ t͡s
мэндлэх	m e n t ɮ e x
израйльчууд	i t͡s r ɛː ɮʲ t͡ɕʰ ʊː t
аавд	aː w̜ t
жижиглэн	t͡ɕ i t͡ɕ i k ɮ e ŋ
арвай	a r w a i
бандан	p a n t a ŋ
магма	m a k m
аашгүй	aː ɕ k u i̯
бургастай	p ʊ r k a s tʰ ɛː
арал	a r ə ɮ
автомашинаар	a w̜ tʰ ɔ m a ɕ i n aː r̥
тэрэгнийх	tʰ e r e k n iː x
хуваарь	x ʊ w̜ aː rʲ
луунуудаа	ɮ ʊː n ʊː t aː
адгууснуудгүй	a t k ʊː s n ʊː t k u i̯
гүүр	ɡ uː r
Чингистэй	t͡ɕʰ i ŋ k i s tʰ e i̯
ангиудыг	a ŋ k i̯ ʊː t i k
шанаа	ʃ a n a
цэцэг	t͡ʃʰ i t͡ʃʰ ɘ k
Бөртийн	p ɵ r̥ tʰ iː ŋ
нөөцлөх	n oː t͡sʰ ɮ ə x
хүмүүсээс	x u m uː s eː s
адгууснуудаас	a t k ʊː s n ʊː t aː s
хотууд	x ɔ tʰ ʊː t
нэрээсээ	n e r eː s eː
танц	tʰ a n t͡sʰ
пальтонуудаар	pʰ a ɮʲ tʰ ɔ n ʊː t aː r̥
алган	a ɮ k a ŋ
төгрөгөөс	tʰ ɵ k r ɵ ɣ ɵː s
ша	ɕ a
ресторанаар	rʲ ɵ s tʰ ɔ r a n aː r̥
хөвгүүнтэйгээ	x ɵ w̜ k uː n tʰ e i̯ ɣ eː
Англи	æˑ ŋ ɡ a ɮ
галигтай	k a ɮ i k tʰ ɛː
байлдагч	p ɛː ɮ t a k t͡ɕʰ
найз	n a i t͡s
аавуудынд	aː w̜ ʊː t i n t
амьтад	a mʲ tʰ a t
луугаараа	ɮ ʊː k aː r aː
өд	o t
үгний	u k n iː
нэрсийнхээ	n e r s iː ŋ x eː
вий	w̜ iː
тогооч	tʰ ɔ ɢ ɔː t͡ʃʰ
бичгийн	p i t͡ɕʰ k iː ŋ
хаанаа	x aː n aː
хулхи	x ʊ ɮ xʲ
тэд	tʰ e tʰ
уснуудад	ʊ s n ʊː t a t
жаал	t͡ɕ aː ɮ
нэрсээс	n e r s eː s
анхилгыг	a ŋ x i ɮ k i k
өглөө	ɵ k ɮ ɵː
ангиудтай	a ŋ k i̯ ʊː t tʰ ɛː
байрнуудынхаа	p ɛː r n ʊː t i ŋ x aː
хаялах	x a j ɮ ə x
ангиар	a ŋ k i̯ aː r̥
алх	a ɮ x
ангиудтайгаа	a ŋ k i̯ ʊː t tʰ ɛː k aː
тахиа	tʰ a x i̯ aː
тахианыхан	tʰ a x i̯ aː n i x a ŋ
амбаар	a m p aː r
өргөө	ɵ r k ɵː
тэрэггүй	tʰ e r e ɣ u i̯
төмөрсөг	tʰ ɵ m ɵ r s ɵ k
тавин	tʰ ɛ w̜ ə ŋ
сүрчиг	s u r t͡ʃʰ i k
маркетинг	m a r̥ kʰʲ ɵ tʰ i ŋ k
гэрүүддээ	k e r uː t͉ t eː
холтосных	x ɔ ɮ tʰ ɔ s n i x
гоймон	ɢ ɔ i m ə ŋ
гүнждийг	k u n t͡ɕ t iː k
хэн	x e ŋ
шинжлэл	ɕ i n t͡ɕ ɮ e ɮ
хоёрдогч	x ɔ j ɔ r t ɔ k t͡ɕʰ
мэргэжил	m i r ə ɡ t͡ɕ ə ɮ
аагуудыг	aː k ʊː t i k
морьхон	m œ r χ ʊ ŋ̠
жилтэй	t͡ɕ i ɮ tʰ e i̯
ногоон	n ɔ ɢ ɔː ŋ
холтоснуудгүйгээ	x ɔ ɮ tʰ ɔ s n ʊː t k u i̯ ɣ eː
пиццануудыг	pʰ i t͡sʰ a n ʊː t i k
зөгийгөөс	t͡s ɵ ɣ iː k ɵː s
аавуудаас	aː w̜ ʊː t aː s
хулгайлах	x ʊ ɮ k ɛː ɮ a x
холтсоо	x ɔ ɮ tʰ s oː
секст	s j ɵ kʰ s tʰ
орос	ɔ r ʊ s
орвон	ɔ r w̜ ɔ ŋ
хаадаа	x aː t aː
автобуснуудгүй	a w̜ tʰ ɔ p ʊ s n ʊː t k u i̯
хагас	x a ɣ a s
явдал	j a w t ə ɮ
аалзнуудтай	aː ɮ t͡s n ʊː t tʰ ɛː
тахиануудад	tʰ a x i̯ aː n ʊː t a t
Доржоор	t ɔ r t͡ɕ oː r̥
ю	j u
халуун	x a ɮ ʊː ŋ
илжгэн	i ɮ t͡ɕ k e ŋ
бахиал	p a x i̯ aː ɮ
авснаас	a w̜ s n aː s
хөөмий	x ɵː m iː
цээжлэх	t͡sʰ eː t͡ʃ ɮ e x
Доржийг	t ɔ r t͡ɕ iː k
сумо	s ʊ m ɔ
завгүй	t͡s a w̜ k u i̯
грекээрээ	k rʲ ɵ kʰ eː r eː
тэнгистэй	tʰ e ŋ k i s tʰ e i̯
үгсэд	u k s e t
өрсөлдөөн	ɵ r s ɵ ɮ t oː ŋ
сексүүдээр	s j ɵ kʰ s uː t eː r̥
шоколад	ɕ ɔ kʰ ɮ a t
үгнийхэн	u k n iː x e ŋ
ятуу	j a tʰ ʊ
Непал	nʲ ɵ pʰ a ɮ
хөргүүр	x ɵ r k uː r̥
усыг	ʊ s i k
бригад	p r i ɣ a t
сүүдэр	s uː t ə r
бургасанд	p ʊ r k a s a n t
фотогүй	f ɔ tʰ ɔ ɣ u i̯
ресторангүй	rʲ ɵ s tʰ ɔ r a ŋ k u i̯
гэрийнхээ	k e r iː ŋ x eː
сувдын	s ʊ w̜ t i ŋ
архичин	ɛ r x t͜ɕʰ ə ŋ
хирс	x i r s
залбирах	t͡s a ɮ p i r a x
зөгийнүүд	t͡s ɵ ɣ iː n uː t
дун	t ʊ ŋ
хөвгүүдтэйгээ	x ɵ w̜ k uː t tʰ e i̯ ɣ eː
тэмцэгч	tʰ e m t͡sʰ e ɡ t͡ʃʰ
нөхцөл	n o x t͡sʰ ə ɮ
долоо	t ɔ ɮ oː
архивуудаар	a r x i w̜ ʊː t aː r̥
пиджакт	pʰ i t t͡ɕ a kʰ tʰ
хүнгүй	x u ŋ k u i̯
жуулчин	t͡ɕ ʊː ɮ t͡ɕʰ i ŋ
гуайнуудынд	k u̯ ɛː n ʊː t i n t
больниц	p ɔ ɮʲ nʲ ə t͡sʰ
залуур	t͡s a ɮ ʊ r
шугам	ʃ ʊ ɢ ə m
хүмүүсээсээ	x u m uː s eː s eː
ангиуд	a ŋ k i̯ ʊː t
байрнуудынх	p ɛː r n ʊː t i ŋ x
тайван	tʰ æː w ə̠ ŋ̠
жилд	t͡ɕ i ɮ t
гүнждээсээ	k u n t͡ɕ t eː s eː
анхилгуудыгаа	a ŋ x i ɮ k ʊː t i ɣ aː
фотод	f ɔ tʰ ɔ t
алуурчнаас	a ɮ ʊː r̥ t͡ɕʰ n aː s
нэрснээсээ	n e r s n eː s eː
Малайз	m a ɮ ɛː t͡s
лантуу	ɮ a n tʰ ʊː
огих	ɔ ɡʲ ə x
алуурчдынх	a ɮ ʊː r̥ t͡ɕʰ t i ŋ x
хог	x ɔ k
грекүүдийг	k rʲ ɵ kʰ uː t iː k
Твиттер	tʰ w̜ i tʰʲ ɵ r̥
хаадыгаа	x aː t i ɣ aː
Өгэдэйгүй	ɵ ɣ e t e i̯ ɣ u i̯
илжгээр	i ɮ t͡ɕ k eː r̥
ханхайнуудынхан	x a ŋ x ɛː n ʊː t i ŋ x a ŋ
янхан	j a ŋ x a ŋ
бясалгах	pʲ a s ə ɮ ɢ ə x
хааныхаа	x aː n i x aː
бургаснуудтай	p ʊ r k a s n ʊː t tʰ ɛː
амьтдаар	a mʲ tʰ t aː r̥
хөлдөх	x ɵ ɮ t ɵ x
нөөц	n oː t͡sʰ
ангиуддаа	a ŋ k i̯ ʊː t͉ t aː
гадна	ɢ a t ə n
Бээжингийнх	p eː t͡ɕ i ŋ k iː ŋ x
Сажа	s a d͡ʑ
арьс	a rʲ s
гүзээлзгэнэ	k u t͡s eː ɮ t͡s k e n
шийжүү	ʃ iː t͡ɕ u
бага	p a ɢ
овъёосон	ɔ w̜ j ɔː s ɔ ŋ
шашнуудаараа	ɕ a ɕ n ʊː t aː r aː
уг	ʊ ɡ
гүнжүүдтэйгээ	k u n t͡ɕ uː t tʰ e i̯ ɣ eː
металл	mʲ ɵ tʰ a ɮ
бургасгүй	p ʊ r k a s k u i̯
пиццануудаас	pʰ i t͡sʰ a n ʊː t aː s
морьтой	m ɔ rʲ tʰ ɔ i̯
байгальтай	p ɛː k a ɮʲ tʰ ɛː
жишээтэй	t͡ɕ i ɕ eː tʰ e i̯
мойл	m ɔ i ɮ
гайхамшигтай	ɢ a i x a m ʃ i ɡ tʰ a i
тавхай	tʰ a w x a i
хүрэл	x u r ə ɮ
хүү	x uː
Канад	kʰ a n a t
грекийнх	k rʲ ɵ kʰ iː ŋ x
хуруувч	x ʊ r ʊ w t͡ɕʰ
шашны	ɕ a ɕ n i
цөл	t͡sʰ o ɮ
төгрөгийн	tʰ ɵ k r ɵ ɣ iː ŋ
тэмээтэй	tʰ e m eː tʰ e i̯
грекүүд	k rʲ ɵ kʰ uː t
нэрснүүдгүйгээ	n e r s n uː t k u i̯ ɣ eː
пиджакуудаас	pʰ i t t͡ɕ a kʰ ʊː t aː s
гараг	k a r a k
Хуацай	x u̯ a t͡sʰ ɛː
үйлдэл	u i ɮ t ə ɮ
зээргэнэ	t͡s eː r ɡ ə n
ёотон	j ɔː tʰ ɔ ŋ
сонин	s œ n ə ŋ
чийдэн	t͡ɕʰ iː t e ŋ
ханхайтай	x a ŋ x ɛː tʰ ɛː
амьтадтай	a mʲ tʰ a t tʰ ɛː
агаараар	a ɣ aː r aː r̥
төстэй	tʰ o s tʰ e
адгууснуудаар	a t k ʊː s n ʊː t aː r̥
хөвгүүдийг	x ɵ w̜ k uː t iː k
ангиудыгаа	a ŋ k i̯ ʊː t i ɣ aː
аагт	aː k tʰ
элэг	i ɮ ə ɡ
ихэр	i x ə r
буддын	p ʊ t͉ t i ŋ
аадаргүй	aː t a r k u i̯
холтоснуудад	x ɔ ɮ tʰ ɔ s n ʊː t a t
гүнждийн	k u n t͡ɕ t iː ŋ
гайхлаар	k ɛː x ɮ aː r̥
автобуснаас	a w̜ tʰ ɔ p ʊ s n aː s
абстрактуудад	a p s tʰ r a kʰ tʰ ʊː t a t
төгрөгтэй	tʰ ɵ k r ɵ k tʰ e i̯
авснуудад	a w̜ s n ʊː t a t
заг	t͡s a ɡ
баглаа	p a k ɮ aː
нэрсэн	n e r s e ŋ
троллейбус	tʰ r ɔ ɮːʲ ɵ i̯ β ʊ s
холтсоороо	x ɔ ɮ tʰ s oː r oː
үггүй	u ɣ u i̯
вирусээс	w̜ i r ʊ s eː s
киногүй	kʰ i n ɔ ɣ u i̯
тахианы	tʰ a x i̯ aː n i
хий	x iː
гэрүүдийгээ	k e r uː t iː k eː
ангиудын	a ŋ k i̯ ʊː t i ŋ
Өгэдэйнд	ɵ ɣ e t e i̯ n t
нүдүүр	n u t u r
тахиуддаа	tʰ a x i̯ ʊː t͉ t aː
Доржийнд	t ɔ r t͡ɕ iː n t
хүнээ	x u n eː
хана	χ ä n
гэрүүдээс	k e r uː t eː s
гэрүүдээсээ	k e r uː t eː s eː
авгалдайнуудыг	a w̜ k a ɮ t ɛː n ʊː t i k
тарвага	tʰ a r w ə ɢ
одоо	ɔ t ɔ
гүнжүүдтэй	k u n t͡ɕ uː t tʰ e i̯
холтостой	x ɔ ɮ tʰ ɔ s tʰ ɔ i̯
орчуулга	ɔ r̥ t͡ɕʰ ʊː ɮ k
Төвшрүүлэх	tʰ ɵ w̜ ɕ r uː ɮ e x
хөмүүн	x ɵ m uː ŋ
атаархах	a tʰ a r x ə x
агаартай	a ɣ aː r̥ tʰ ɛː
залбирал	t͡s a ɮ p i r a ɮ
автобуснуудад	a w̜ tʰ ɔ p ʊ s n ʊː t a t
тоосго	tʰ oː s k
тосгон	tʰ ɔ s k ɔ ŋ
зэвсэг	t͡s i w s ə ɡ
вирусүүдээс	w̜ i r ʊ s uː t eː s
хүмүүсийнхээ	x u m uː s iː ŋ x eː
хутга	x ʊ tʰ ə ɢ
вирусүүдээр	w̜ i r ʊ s uː t eː r̥
сар	s ɐ ɾ
динозавр	t i n ɔ t͡s a w̜ r̥
Чингистэйгээ	t͡ɕʰ i ŋ k i s tʰ e i̯ ɣ eː
функц	f ʊ ŋ kʰ t͡sʰ
алба	a ɮ p
жорлон	t͡ɕ ɔ r ɮ ə ŋ
бух	p ʊ x
Бээжингийн	p eː t͡ɕ i ŋ k iː ŋ
урчууд	ʊ r̥ t͡ɕʰ ʊː t
жижүүр	t͡ɕ i t͡ɕ u r
галт	ɢ a ɮ tʰ
соёл	s ɔ j ʊ ɮ
пальтонууд	pʰ a ɮʲ tʰ ɔ n ʊː t
автомашинтай	a w̜ tʰ ɔ m a ɕ i n tʰ ɛː
Өгэдэйгээс	ɵ ɣ e t e i̯ ɣ eː s
махийх	m a xʲ i x
дүү	t uː
халдварт	χ a ɮ t w ə̠ r tʰ
Өэлүнд	ɵ e ɮ u n t
байгууллагад	p ɛː k ʊː ɮː a ɣ a t
анги	a ŋ k
алуурчныхан	a ɮ ʊː r̥ t͡ɕʰ n i x a ŋ
гайхалгүй	k ɛː x a ɮ k u i̯
зэс	t͡s i s
хаадгүйгээ	x aː t k u i̯ ɣ eː
Улаанбаатарынхан	ʊ ɮ aː m p aː tʰ a r i ŋ x a ŋ
үйл	u i ɮ
автомашинууд	a w̜ tʰ ɔ m a ɕ i n ʊː t
цэнэглэх	t͡sʰ e n e k ɮ e x
пальтонуудыг	pʰ a ɮʲ tʰ ɔ n ʊː t i k
хүмүүстэйгээ	x u m uː s tʰ e i̯ ɣ eː
зөгийгүй	t͡s ɵ ɣ iː k u i̯
шуудан	ɕ ʊː t a ŋ
гарчиг	ɢ a r t͡ɕʰ ə ɡ
агаарынхан	a ɣ aː r i ŋ x a ŋ
үүлэн	uː ɮ e ŋ
эрхийвч	i r x i w t͡ɕʰ
алуурчид	a ɮ ʊː r̥ t͡ɕʰ i t
Пёнъян	pʰʲ ɔ n j a ŋ
гомдох	ɢ ɔ m t ɔ x
баатар	p aː tʰ a r̥
торго	tʰ ɔ r ə ɢ
бургаснаас	p ʊ r k a s n aː s
туулай	tʰ ʊː ɮ a i
гэрээс	k e r eː s
хага	x a ɢ
байраараа	p ɛː r aː r aː
бөөгүй	p ɵː k u i̯
хэзээ	x e t͡s eː
хаадаар	x aː t aː r̥
овъёоснуудыг	ɔ w̜ j ɔː s n ʊː t i k
том	tʰ ɔ m
хашилт	χ ä ʃ ĭ ɮ tʰ
агаарт	a ɣ aː r̥ tʰ
грекийгээ	k rʲ ɵ kʰ iː k eː
үйлдэх	u i ɮ t ə x
дайралт	t ɛː r a ɮ tʰ
борщ	p ɔ r ɕ
коммунист	kʰ ɔ mː ʊ n i s tʰ
овьёос	ɔ w̜ j ɔː s
эр	e r̥
ДОХ	t ɔ x
ойлголт	ɔ i̯ ɮ k ɔ ɮ tʰ
киноных	kʰ i n ɔ n i x
нислэг	n i s ɮ e k
өвөр	o w o r
ааруулуудгүй	aː r ʊː ɮ ʊː t k u i̯
өргөдөл	ɵ r k ɵ t ɵ ɮ
тахидаа	tʰ a x i t aː
хариуцлага	x a r i̯ ʊː t͡sʰ ɮ a ɢ
гитартай	k i tʰ a r̥ tʰ ɛː
үйлдвэрийн	u i̯ ɮ t w̜ e r iː ŋ
англичууд	a ŋ k ɮ i t͡ɕʰ ʊː t
амьтныд	a mʲ tʰ n i t
Бөртийг	p ɵ r̥ tʰ iː k
улсыг	ʊ ɮ s i k
шизофрени	ɕ i t͡s ɔ f rʲ ɵ n i
юмдүүжин	j ʊ m t uː t͡ɕ i ŋ
аашин	aː ɕ i ŋ
шашнуудыгаа	ɕ a ɕ n ʊː t i ɣ aː
доромжлох	t ɔ r ɔ m t͡ɕ ɮ ɔ x
нийтгэх	n iː tʰ ɡ e x
жууцайнуудад	t͡ɕ ʊː t͡sʰ ɛː n ʊː t a t
хуульчлах	x ʊː ɬʲ t͡ʃʰ ɬ a x
нэрснүүдтэй	n e r s n uː t tʰ e i̯
морийг	m ɔ r iː k
савхыг	s a w̜ x i k
тэнгэр	tʰ e ŋ ɡ e r
помещик	pʰ ɔ mʲ ɵ ɕ i kʰ
пиджакийн	pʰ i t t͡ɕ a kʰ iː ŋ
анаашнуудгүй	a n aː ɕ n ʊː t k u i̯
төгрөгүүдгүй	tʰ ɵ k r ɵ ɣ uː t k u i̯
гүнжээрээ	k u n t͡ɕ eː r eː
сайхан	s ɛː x a ŋ
лалрынхан	ɮ a ɮ r i ŋ x a ŋ
Бөртэгүй	p ɵ r̥ tʰ e ɣ u i̯
Кидан	kʰ i t a ŋ
хүмүүн	x u m uː ŋ
гуайнуудаас	k u̯ ɛː n ʊː t aː s
эх	i x
бярга	pʲ a r k
цамц	t͡sʰ a m t͡sʰ
холтосны	x ɔ ɮ tʰ ɔ s n i
ф	f
нэрснийх	n e r s n iː x
үгсийнх	u k s iː ŋ x
өвөө	ɵ w̜ ɵː
хувь	x ʊ wʲ
тэрбум	tʰ e r p ʊ m
Узбекээр	ʊ t͡s pʲ ɵ kʰ eː r̥
луугаа	ɮ ʊː k aː
бургасных	p ʊ r k a s n i x
авъяасаар	a w̜ j aː s aː r̥
байгууллагынх	p ɛː k ʊː ɮː a ɣ i ŋ x
лалартай	ɮ a ɮ a r̥ tʰ ɛː
довжоо	t ɔ w̜ t͡ɕ ɔ
тэнгисийн	tʰ e ŋ k i s iː ŋ
ангид	a ŋ k i t
авгаас	a w̜ k aː s
нэрснүүдийнхээ	n e r s n uː t iː ŋ x eː
зарим	t͡s a rʲ ə m
Вьетнам	w̜ j ɵ tʰ n a m
Шианган	ɕ i̯ aː ŋ k a ŋ
хамт	x a m tʰ
хуанли	x ʊ a ŋ ɮ i
алуурчных	a ɮ ʊː r̥ t͡ɕʰ n i x
холтоснуудыг	x ɔ ɮ tʰ ɔ s n ʊː t i k
халаад	x a ɮ a t
цайтай	t͡sʰ ɛː tʰ ɛː
үлээх	u ɮ e x
резин	e r t͡s eː ŋ
халим	x a ɮ i m
ангигүйгээ	a ŋ k i ɣ u i̯ ɣ eː
пиццаны	pʰ i t͡sʰ a n i
луйвар	ɮ ʊ̙ i w̜ a r
шаардлага	ʃ aː r t ɮ ə ɢ
гэгээнтэн	k e ɣ eː n tʰ e ŋ
цөөн	t͡sʰ oː ŋ
даатгал	t aː tʰ ɢ a ɮ
өрсөлдөх	ɵ r s u ɮ t u x
богино	p ɔ ɡʲ ə n
пиджакуудад	pʰ i t t͡ɕ a kʰ ʊː t a t
үгсийнхэн	u k s iː ŋ x e ŋ
унгарчууд	ʊ ŋ k a r̥ t͡ɕʰ ʊː t
хотон	χ ɔ tʰ o ŋ
Чингисээс	t͡ɕʰ i ŋ k i s eː s
сексийг	s j ɵ kʰ s iː k
жар	t͡ɕ a r̥
ац	a t͡sʰ
сонирхол	s ɔ nʲ ə r x ə ɮ
заримдаа	t͡s a rʲ ə m t a
албадлага	a ɮ p ə t ɮ ə ɢ
зөөлөн	t͡s ɵː ɮ ɵ ŋ
хөвгүүдэд	x ɵ w̜ k uː t e t
зөгийнүүдийн	t͡s ɵ ɣ iː n uː t iː ŋ
хүмүүс	x u m uː s
шалгалт	ɕ a ɮ k a ɮ tʰ
луунууддаа	ɮ ʊː n ʊː t͉ t aː
хагарах	x a ɢ r ə x
Куба	kʰ ʊ β
авгуудыг	a w̜ k ʊː t i k
философи	f i ɮ ɔ s ɔ f
юу	j ʊː
ой	ɔ͜i
төрсөн	tʰ ɵ r s u ŋ
гуайнуудаар	k u̯ ɛː n ʊː t aː r̥
автобус	a f tʰ ʊː s
ч	t͡ɕʰ
гудамж	ɢ ʊ t ə m t͡ɕ
гүнжүүдийнхээ	k u n t͡ɕ uː t iː ŋ x eː
хаанаар	x aː n aː r̥
эмчилгээ	e m t͡ɕʰ ə ɮ ɡ e
овъёоснуудын	ɔ w̜ j ɔː s n ʊː t i ŋ
анаашгүй	a n aː ɕ k u i̯
байгалийнхан	p ɛː k a ɮ iː ŋ x a ŋ
гэргүй	k e r k u i̯
Улаанбаатарыг	ʊ ɮ aː m p aː tʰ a r i k
эрчүүдийн	e r̥ t͡ɕʰ uː t iː ŋ
бургаснуудыг	p ʊ r k a s n ʊː t i k
гэлэнмаа	ɡ i ɮ ə m m a
долоох	t ɔ ɮ ɔ x
оёдол	ɔ j t ə ɮ
ивээл	i w eː ɮ
тэнгисээс	tʰ e ŋ k i s eː s
ангидаа	a ŋ k i t aː
галигаар	k a ɮ i ɣ aː r̥
нил	n i ɮ
дайх	t a i x
лалруудгүй	ɮ a ɮ r ʊː t k u i̯
тахьгүйгээ	tʰ a xʲ k u i̯ ɣ eː
суурь	s ʊː rʲ
гитарууд	k i tʰ a r ʊː t
дарс	t a r s
пальтонд	pʰ a ɮʲ tʰ ɔ n t
дүнчүүр	t u n t͡ɕʰ uː r̥
Сири	s iˑ r
гуравдугаар	k ʊ r a w̜ t ʊ ɣ aː r̥
нэртэй	n e r̥ tʰ e i̯
грекгүй	k rʲ ɵ kʰ k u i̯
уснуудаар	ʊ s n ʊː t aː r̥
ханш	x a n ɕ
Сайншанд	s ɛː n ɕ a n t
зардаг	t͡s a r t ə ɡ
буддагүйгээ	p ʊ t͉ t a ɣ u i̯ ɣ eː
мориныхтойгоо	m ɔ r i n i x tʰ ɔ i̯ ɣ oː
өргөөн	ɵ r k ɵː ŋ
авс	a w̜ s
Манж	m a n t͡ɕ
томьёо	tʰ ɔ m j ɔː
тахианууд	tʰ a x i̯ aː n ʊː t
өрсөлдөгч	ɵ r s ɵ ɮ t ɵ ɡ t͡ʃʰ
эрлийзжих	e r ɮ iː t͡s t͡ɕ i x
дугаар	t ʊ ɣ aː r̥
нэрснүүдийнх	n e r s n uː t iː ŋ x
абстрактуудаас	a p s tʰ r a kʰ tʰ ʊː t aː s
байрнуудаас	p ɛː r n ʊː t aː s
зээлбэр	t s eː ɮ p ɪ̆ r
гэрүүдээрээ	k e r uː t eː r eː
банжо	p a n t͡ɕ ɔ
ханхайд	x a ŋ x ɛː t
балет	p a ɮʲ ɵ tʰ
дасгал	t a s ɢ ə ɮ
ханхай	x a ŋ x ɛː
ором	ɔ r ə m
симфони	s i m f ɔˑ n
пиджакийг	pʰ i t t͡ɕ a kʰ iː k
тэрэгний	tʰ e r e k n iː
цайнууд	t͡sʰ ɛː n ʊː t
буудал	p ʊː t a ɮ
анчдыг	a n t͡ɕʰ t i k
динозавргүй	t i n ɔ t͡s a w̜ r k u i̯
авдруудаас	a w̜ t r ʊː t aː s
хувцас	x ʊ w t͡sʰ ə s
тэргэн	tʰ e r k e ŋ
аалзнуудын	aː ɮ t͡s n ʊː t i ŋ
болох	p ɔ ɮ ə x
автобусыг	a w̜ tʰ ɔ p ʊ s i k
мэдээлэл	m i t e ɮ ə ɮ
бэ	p e
паб	pʰ a p
агробиологи	a k r ɔ β i̯ oː ɮ ɔ ɣ
пиццан	pʰ i t͡sʰ a ŋ
аалзнуудаар	aː ɮ t͡s n ʊː t aː r̥
тахийг	tʰ a x iː k
зөгийнүүдийг	t͡s ɵ ɣ iː n uː t iː k
үнэ	u n
нэрсэд	n e r s e t
хуур	x ʊː r̥
хорхой	x ɔ r x ɔ i̯
луунуудгүйгээ	ɮ ʊː n ʊː t k u i̯ ɣ eː
автомашиныг	a w̜ tʰ ɔ m a ɕ i n i k
грекүүдээр	k rʲ ɵ kʰ uː t eː r̥
нэрсгүйгээ	n e r s k u i̯ ɣ eː
Чингисийнхтэй	t͡ɕʰ i ŋ k i s iː ŋ x tʰ e i̯
анаашнуудыг	a n aː ɕ n ʊː t i k
гал	ɢ a ɮ
гүнжүүдийнхэн	k u n t͡ɕ uː t iː ŋ x e ŋ
грекгүйгээ	k rʲ ɵ kʰ k u i̯ ɣ eː
анхилгагүйгээ	a ŋ x i ɮ k a ɣ u i̯ ɣ eː
маань	m æː n
европчууд	j ɵ w r ɔˑ pʰ t͡ʃʰ ʊː t
өеөдөх	ɵ j ɵ ɵ t ɵ x
нэрд	n e r t
ресторануудгүй	rʲ ɵ s tʰ ɔ r a n ʊː t k u i̯
гайхлаас	k ɛː x ɮ aː s
Бээжингээс	p eː t͡ɕ i ŋ k eː s
алтгана	a ɮ tʰ ɢ ə n
гийгүүлэх	ɡ iː ɡ uː ɮ ĕ x
овъёоснуудаас	ɔ w̜ j ɔː s n ʊː t aː s
хөвгүүндээ	x ɵ w̜ k uː n t eː
луунуудыг	ɮ ʊː n ʊː t i k
усанд	ʊ s a n t
мориныхоос	m ɔ r i n i x oː s
баянаас	p a j a n aː s
оньс	ɔ nʲ s
нэрээрээ	n e r eː r eː
уснуудын	ʊ s n ʊː t i ŋ
байцаатай	p ɛː t͡sʰ aː tʰ ɛː
бохь	p ɔ xʲ
ааруулын	aː r ʊː ɮ i ŋ
зөгийнүүдээс	t͡s ɵ ɣ iː n uː t eː s
зүү	t͡s uː
шилүүс	ʃ i ɮ u s
баян	p a j ə ŋ̠
данс	t a n s
тэмээнүүдтэй	tʰ e m eː n uː t tʰ e i̯
Испани	i s pʰ aˑ n
хэлэх	x i ɮ ə x
ном	n ɔ m
динозаврыг	t i n ɔ t͡s a w̜ r i k
таяг	tʰ a j ə ɡ
агшин	a k ɕ i ŋ
илжигнүүдийг	i ɮ t͡ɕ i k n uː t iː k
нус	n ʊ s
лүү	ɮ uː
галигуудгүй	k a ɮ i ɣ ʊː t k u i̯
тэмээнүүдийг	tʰ e m eː n uː t iː k
хөвгүүдээсээ	x ɵ w̜ k uː t eː s eː
аагтай	aː k tʰ ɛː
унгах	ʊ ŋ k a x
ноёноор	n ɔ j ɔ n oː r̥
пиджакууд	pʰ i t t͡ɕ a kʰ ʊː t
үзэх	u t͡s ə x
авга	a w̜ k
шашинд	ɕ a ɕ i n t
т	tʰ
хүмүүсийгээ	x u m uː s iː k eː
гэргүйгээ	k e r k u i̯ ɣ eː
байх	p æː χ
байгууллагаас	p ɛː k ʊː ɮː a ɣ aː s
байрнуудаар	p ɛː r n ʊː t aː r̥
дахь	t a xʲ
анаашийг	a n aː ɕ iː k
замбага	t͡s a m p ə ɢ
фашизм	f a ɕ i t͡s m
эргэх	i r ɡ i x
мөс	m o s
цайнуудын	t͡sʰ ɛː n ʊː t i ŋ
нэрс	n e r s
цэг	t͡sʰ e k
гэрээсээ	k e r eː s eː
Улаанбаатаргүй	ʊ ɮ aː m p aː tʰ a r k u i̯
шүүслэг	ʃ uː s ɮ ə ɡ
ирээдүй	i r e t u i
автобусных	a w̜ tʰ ɔ p ʊ s n i x
бургасыг	p ʊ r k a s i k
хуушуур	x ʊː ʃ ʊ r
тэнгисүүдээс	tʰ e ŋ k i s uː t eː s
байрнууддаа	p ɛː r n ʊː t͉ t aː
тэрэгнүүдэд	tʰ e r e k n uː t e t
автобуснуудыг	a w̜ tʰ ɔ p ʊ s n ʊː t i k
зөгий	t͡s ɵ ɣ iː
нэрийнхэн	n e r iː ŋ x e ŋ
илжигтэй	i ɮ t͡ɕ i k tʰ e i̯
жилийг	t͡ɕ i ɮ iː k
тив	tʰ i w̜
гитараас	k i tʰ a r aː s
мэргэжилтэн	m i r ə ɡ t͡ɕ ə ɮ tʰ ə ŋ
грекээс	k rʲ ɵ kʰ eː s
хөдлөх	x o t ɮ ə x
мориныхгүйгээ	m ɔ r i n i x k u i̯ ɣ eː
абстракт	a p s tʰ r a kʰ tʰ
дарма	t a r m
Цэдэнбал	t͡sʰ e t e m p a ɮ
дудран	t ʊ t r ə ŋ
туршлага	tʰ ʊ r ʃ ɮ ə ɢ
хойно	x ɔ i n
хөвгүүдээ	x ɵ w̜ k uː t eː
гурил	ɢ ʊ rʲ ə ɮ
тэмээнүүд	tʰ e m eː n uː t
булга	p ʊ ɮ ə ɢ
нэрснүүд	n e r s n uː t
гитараасаа	k i tʰ a r aː s aː
плазм	pʰ ɮ a t͡s m
агааргүй	a ɣ aː r k u i̯
олох	ɔ ɮ ɔ x
грекүүдгүйгээ	k rʲ ɵ kʰ uː t k u i̯ ɣ eː
номынх	n ɔ m i ŋ x
хүүгэд	x uː x ə t
хөвгүүнтэй	x ɵ w̜ k uː n tʰ e i̯
адгууснуудын	a t k ʊː s n ʊː t i ŋ
улсуудаас	ʊ ɮ s ʊː t aː s
дэлгүүр	t e ɮ k uː r̥
тэмээ	tʰ e m eː
гайхлуудыг	k ɛː x ɮ ʊː t i k
гитаруудаасаа	k i tʰ a r ʊː t aː s aː
галуу	ɢ a ɮ ʊː
сексээс	s j ɵ kʰ s eː s
харайх	x a r ɛː x
тунадас	tʰ ʊ n t ə s
морь	m œ r
аалзнуудад	aː ɮ t͡s n ʊː t a t
аавуудгүй	aː w̜ ʊː t k u i̯
чулуу	t͡ɕʰ ʊ ɮ ʊː
ресторанаас	rʲ ɵ s tʰ ɔ r a n aː s
номуудгүй	n ɔ m ʊː t k u i̯
лууныхаа	ɮ ʊː n i x aː
пиджак	pʰ i t t͡ɕ a kʰ
радий	r a t iː
үүлний	uː ɮ n iː
хуудас	x ʊː t a s
амьдрал	ɛ m t r ə ɮ
нэрснүүдийн	n e r s n uː t iː ŋ
хууль	x ʊː ɮʲ
эмээл	i m e ɮ
үе	u j
уснаасаа	ʊ s n aː s aː
үүлнүүд	uː ɮ n uː t
улсууд	ʊ ɮ s ʊː t
авгагүй	a w̜ k a ɣ u i̯
лалруудаар	ɮ a ɮ r ʊː t aː r̥
нугалам	n ʊ ɢ ɮ ə m
аппарат	a pʰ a r a tʰ
шаардах	ʃ aː r t ə x
булган	p ʊ ɮ k a ŋ
надад	n a t ə t
аавын	aː w̜ i ŋ
сом	s ɔ m
гайхлуудаар	k ɛː x ɮ ʊː t aː r̥
бүс	p u s
хаях	x a j ə x
амьтантай	a mʲ tʰ a n tʰ ɛː
жишээн	t͡ɕ i ɕ eː ŋ
намтар	n a m tʰ ə r
гараш	k a r a ɕ
унах	ʊ n ə x
нарийн	n a rʲ i ŋ
ангийнхаа	a ŋ k iː ŋ x aː
байгууллагаар	p ɛː k ʊː ɮː a ɣ aː r̥
архивгүй	a r x i w̜ k u i̯
баячуудын	p a j a t͡ɕʰ ʊː t i ŋ
харин	x a rʲ ə ŋ
Чингисгүйгээ	t͡ɕʰ i ŋ k i s k u i̯ ɣ eː
аалзнуудгүй	aː ɮ t͡s n ʊː t k u i̯
учраас	ʊ t͡ɕʰ r aː s
бөөгийнх	p ɵː k iː ŋ x
зөгийн	t͡s ɵ ɣ iː ŋ
ноёд	n ɔ j ɔ t
хавч	x a w t͡ɕʰ
бяруу	pʲ a r ʊ
уснуудгүй	ʊ s n ʊː t k u i̯
дэлгүүрт	t e ɮ k uː r̥ tʰ
тамга	tʰ a m ə ɢ
тогтоол	tʰ ɔ ɡ tʰ ɔ ɮ
нэрснүүдээ	n e r s n uː t eː
цадиг	t͡sʰ a tʲ ə ɡ
шүлс	ʃ u ɮ s
анхилгууд	a ŋ x i ɮ k ʊː t
тахиасаа	tʰ a x i̯ aː s aː
зогсох	t͡s ɔ ɡ s ə x
арга	a r k
ая	a j
тахианаас	tʰ a x i̯ aː n aː s
тэнгисүүдэд	tʰ e ŋ k i s uː t e t
тор	tʰ ɔ r̥
мориныхтой	m ɔ r i n i x tʰ ɔ i̯
хавирга	x a wʲ r ə ɢ
амьтныг	a mʲ tʰ n i k
анчинтай	a n t͡ɕʰ i n tʰ ɛː
я	j a
такси	tʰ a kʰ s i
дуурь	t ʊː rʲ
ноёныхон	n ɔ j ɔ n i x ɔ ŋ
баавар	p aː w̜ ə r
жууцайнууд	t͡ɕ ʊː t͡sʰ ɛː n ʊː t
грекүүддээ	k rʲ ɵ kʰ uː t͉ t eː
овъёоснуудтай	ɔ w̜ j ɔː s n ʊː t tʰ ɛː
зөгийтэй	t͡s ɵ ɣ iː tʰ e i̯
боломж	p ɔ ɮ ə m t͡ɕ
тогос	tʰ ɔ ɢ ə s
таслал	tʰ a s ɮ a ɮ
анаашаар	a n aː ɕ aː r̥
төгрөггүй	tʰ ɵ k r ɵ ɣ u i̯
автокрангүй	a w̜ tʰ ɔ kʰ r a ŋ k u i̯
цайр	t͡sʰ a i r
гэрүүдийнхэн	k e r uː t iː ŋ x e ŋ
нэрсгүй	n e r s k u i̯
эрүү	e r u
сурах	s ʊ r ə x
пиджактай	pʰ i t t͡ɕ a kʰ tʰ ɛː
чинжүү	t͡ɕʰ i n t͡ɕ uː
банзал	p a n t͡s a ɮ
бургаснуудынхан	p ʊ r k a s n ʊː t i ŋ x a ŋ
сум	s ʊ m
ханхайнуудтай	x a ŋ x ɛː n ʊː t tʰ ɛː
бөөгийн	p ɵː k iː ŋ
бүйлс	p u i ɮ s
хөмрүүлэх	x o m r u ɮ ə x
анчдаар	a n t͡ɕʰ t aː r̥
түмэд	tʰ u m e t
аллага	a ɮː a ɣ
үнсэх	u n s e x
тэнгисүүдээр	tʰ e ŋ k i s uː t eː r̥
автомашинуудыг	a w̜ tʰ ɔ m a ɕ i n ʊː t i k
чанарлаг	t͡ɕʰ a n ə r ɮ ə ɡ
жишээнд	t͡ɕ i ɕ eː n t
өсгий	ɵ s k iː
галигийн	k a ɮ i ɣ iː ŋ
ноёдод	n ɔ j ɔ t ɔ t
бөгс	p ɵ k s
молтогчин	m ɔ ɮ tʰ ə ɣ t͡ɕ ə n
чанар	t͡ɕʰ a n ə r
холтоснуудынх	x ɔ ɮ tʰ ɔ s n ʊː t i ŋ x
чек	t͡ɕʰ j ɵ kʰ
авгуудтай	a w̜ k ʊː t tʰ ɛː
лалруудтай	ɮ a ɮ r ʊː t tʰ ɛː
тэмээнүүдгүй	tʰ e m eː n uː t k u i̯
хүнийг	x u n iː k
нүүдэлчин	n uː t e ɮ t͡ɕʰ i ŋ
Чингисийнхгүй	t͡ɕʰ i ŋ k i s iː ŋ x k u i̯
дамжуулагч	t a m t͡ɕ ʊː ɮ a k t͡ɕʰ
галигууд	k a ɮ i ɣ ʊː t
онгоц	ɔ ŋ k ɔ t͡sʰ
магтах	m a x t ă
амь	a mʲ
анхилгаасаа	a ŋ x i ɮ k aː s aː
шивнэх	ʃ i w n ə x
тахиудыг	tʰ a x i̯ ʊː t i k
шавар	ʃ a w ə r
дасах	t a s ə x
гариг	k a r i k
авгалдайгаас	a w̜ k a ɮ t ɛː k aː s
боол	p oː ɮ
цогц	t͡sʰ ɔ ɡ t͡sʰ
өглөг	ɵ k ɮ ɵ k
дэвтэр	t e w̜ tʰ e r̥
анаашны	a n aː ɕ n i
ноёныг	n ɔ j ɔ n i k
ноёных	n ɔ j ɔ n i x
Чингисийнхээрээ	t͡ɕʰ i ŋ k i s iː ŋ x eː r eː
бургаснуудад	p ʊ r k a s n ʊː t a t
байгальтайгаа	p ɛː k a ɮʲ tʰ ɛː k aː
бодис	p œ t ʊ s
орчуулах	ɔ r̥ t͡ɕʰ ʊː ɮ a x
тэмээнүүдээс	tʰ e m eː n uː t eː s
ган	ɢ a ŋ
ангиудаар	a ŋ k i̯ ʊː t aː r̥
сарлаг	s a r ɮ ə ɡ
тэмээнээс	tʰ e m eː n eː s
аагийн	aː k iː ŋ
тэнгист	tʰ e ŋ k i s tʰ
хорвоо	x ɔ r w ɔ
ор	ɔ r
автобусан	a w̜ tʰ ɔ p ʊ s a ŋ
хөвгүүдгүй	x ɵ w̜ k uː t k u i̯
цирк	t͡sʰ i r̥ kʰ
буддыгаа	p ʊ t͉ t i ɣ aː
нэрсийг	n e r s iː k
үүлнүүдгүй	uː ɮ n uː t k u i̯
баасан	p aː s a ŋ
ресторануудад	rʲ ɵ s tʰ ɔ r a n ʊː t a t
бургасны	p ʊ r k a s n i
авгуудгүй	a w̜ k ʊː t k u i̯
усаа	ʊ s aː
болохоор	p ɔ ɮ χ ɔː r
маргах	m a r ɢ a x
Франц	f r a n t͡sʰ
тэвчээр	tʰ e w̜ t͡ɕʰ eː r̥
гуайг	k u̯ ɛː k
минь	m i n
гуайнуудад	k u̯ ɛː n ʊː t a t
хөвгүүнээр	x ɵ w̜ k uː n eː r̥
тахиудынх	tʰ a x i̯ ʊː t i ŋ x
ааруулуудаас	aː r ʊː ɮ ʊː t aː s
үйлдвэрлэл	u i ɮ t w ə r ɮ ə ɮ
хэрэглэл	x i r ə ɡ ɮ ə ɮ
зурхай	t͡s ʊ r x ɛː
хөвгүүний	x ɵ w̜ k uː n iː
бүхэнтэй	p u x e n tʰ e i̯
томсох	tʰ ɔ m s ə x
тахиудын	tʰ a x i̯ ʊː t i ŋ
шашнаас	ɕ a ɕ n aː s
хөвгүүн	x ɵ w̜ k uː ŋ
утас	ʊ tʰ ə s
ханхайгүй	x a ŋ x ɛː k u i̯
Цахар	t͡sʰ a x a r̥
бөөтэй	p ɵː tʰ e i̯
ресторануудынх	rʲ ɵ s tʰ ɔ r a n ʊː t i ŋ x
Варшав	w̜ a r ɕ a w̜
Индонез	i n t ɔ nʲ ɵ t͡s
гүнжээсээ	k u n t͡ɕ eː s eː
бургаснуудынх	p ʊ r k a s n ʊː t i ŋ x
холтоснууддаа	x ɔ ɮ tʰ ɔ s n ʊː t͉ t aː
баялаг	p a j ɮ ə k̠
зөгийгөөр	t͡s ɵ ɣ iː k ɵː r̥
нутаг	n ʊ tʰ ä ɢ
шашинтайгаа	ɕ a ɕ i n tʰ ɛː k aː
луунуудын	ɮ ʊː n ʊː t i ŋ
цилиндр	t͡sʰ i ɮ i n t r̥
холтсонд	x ɔ ɮ tʰ s ɔ n t
нисгэх	n i s ɡ e x
Тайланд	tʰ ɛː ɮ a n t
жууцай	t͡ɕ ʊː t͡sʰ ɛː
унтраах	ʊ n tʰ r aː x
пальтон	pʰ a ɮʲ tʰ ɔ ŋ
хүмүүнээрээ	x u m uː n eː r eː
Википедиа	w̜ i kʰ i pʰʲ ɵ t i̯ aː
залуу	t͡s a ɮ ʊ
галиг	k a ɮ i k
овъёосоор	ɔ w̜ j ɔː s oː r̥
уучлаарай	ʊː t͡ɕʰ ɮ aː r ɛː
абстрактаар	a p s tʰ r a kʰ tʰ aː r̥
жор	t͡ɕ ɔ r
номоор	n ɔ m oː r̥
холтсыг	x ɔ ɮ tʰ s i k
хударга	x ʊ t r ə ɢ
франц	f r äˑ n t͜sʰ
шашиндаа	ɕ a ɕ i n t aː
сурвалж	s ʊ r w ə ɮ t͡ɕ
шашингүй	ɕ a ɕ i ŋ k u i̯
авснууд	a w̜ s n ʊː t
үгүй	u ɡ u i̯
пиццанууд	pʰ i t͡sʰ a n ʊː t
тахь	tʰ a xʲ
пальтогоор	pʰ a ɮʲ tʰ ɔ ɣ oː r̥
хими	x iː m
гүнжүүдгүйгээ	k u n t͡ɕ uː t k u i̯ ɣ eː
Желон	d͡ʒ e l ɔ ŋ
хависгана	x a w̜ i s k a n
байрнуудаасаа	p ɛː r n ʊː t aː s aː
жилийнх	t͡ɕ i ɮ iː ŋ x
байрныхаа	p ɛː r n i x aː
ер	j ɵ r̥
британичууд	p r i tʰ a n i t͡ɕʰ ʊː t
граж	k r a t͡ɕ
жилээр	t͡ɕ i ɮ eː r̥
алгебр	a ɮ kʲ ɵ p r̥
багааж	p a ɣ aː t͡ɕ
Булган	p ʊ ɮ k a ŋ
маргад	m a r k a t
тэрс	tʰ i r s
марк	m ä r k
соёолон	s ɔ j ɔː ɮ ɔ ŋ
арбитраж	a r p i tʰ r a t͡ɕ
каталог	kʰ a tʰ a ɮ ɔ k
алуурчдаар	a ɮ ʊː r̥ t͡ɕʰ t aː r̥
байргүйгээ	p ɛː r k u i̯ ɣ eː
томох	tʰ ɔ m ə x
инээмсэглэх	i n eː m s e k ɮ e x
Чингисийнхдээ	t͡ɕʰ i ŋ k i s iː ŋ x t eː
шилбэ	ʃ i ɮ p
хүнд	x u n t
ангиудынхаа	a ŋ k i̯ ʊː t i ŋ x aː
тахийгаа	tʰ a x iː k aː
үйлчилгээ	u ɮ t͡ɕʰ i ɮ k eː
Өндөрхаан	ɵ n t ɵ r x aː ŋ
үйлдэржилт	u i ɮ t w e r t͡ɕ ə ɮ tʰ
суралцах	s ʊ r a ɮ t͡sʰ a x
чоно	t͡ɕʰ ɔ n
авдраар	a w̜ t r aː r̥
кинонууд	kʰ i n ɔ n ʊː t
аадартай	aː t a r̥ tʰ ɛː
догма	t ɔ k m
сексүүдээс	s j ɵ kʰ s uː t eː s
жишээг	t͡ɕ i ɕ eː k
өөр	oː r
дамнах	t a m n ə x
баяртай	p a j ə̠ r tʰ æː
хаадаас	x aː t aː s
гитаргүйгээ	k i tʰ a r k u i̯ ɣ eː
өвс	o w s
салфетка	s a ɮ fʲ ɵ tʰ kʰ
хусах	x ʊ s ə x
үгсээр	u k s eː r̥
оюутан	ɔ j ʊ tʰ ə ŋ
пигүүж	pʰ i ɡ u t͡ɕ
мориныхыгоо	m ɔ r i n i x i ɣ oː
гүнжтэйгээ	k u n t͡ɕ tʰ e i̯ ɣ eː
анаашнуудаар	a n aː ɕ n ʊː t aː r̥
Өэлүнээс	ɵ e ɮ u n eː s
Александр	a ɮʲ ɵ kʰ s a n t r̥
батган	p a tʰ k a ŋ
Улаанбаатарынх	ʊ ɮ aː m p aː tʰ a r i ŋ x
буддадаа	p ʊ t͉ t a t aː
Сүхбаатар	s u x p aː tʰ a r̥
хэдэрлэх	x e t ə r ɮ ə x
хөвүүн	x ɵ w̜ ɡ uː ŋ
луугүй	ɮ ʊː k u i̯
юү	j uː
үнэг	u n ə ɡ
Чингисийнхийг	t͡ɕʰ i ŋ k i s iː ŋ x iː k
номуудынхан	n ɔ m ʊː t i ŋ x a ŋ
тэрэгнүүдтэй	tʰ e r e k n uː t tʰ e i̯
гректээ	k rʲ ɵ kʰ tʰ eː
шашнуудаас	ɕ a ɕ n ʊː t aː s
гүнждээ	k u n t͡ɕ t eː
километр	kʰ i ɮ ɔ mʲ ɵ tʰ r̥
соруулах	s ɔ r ʊ ɮ ə x
в	w̜
алуурчин	a ɮ ʊː r̥ t͡ɕʰ i ŋ
нийх	n iː x
хаадгүй	x aː t k u i̯
зээр	t͡s eː r
цөлхөөв	t͡sʰ ɵ ɬʰ ɵː w̜
ангийгаа	a ŋ k iː k aː
дампуурах	t a m pʰ ʊː r a x
баяны	p a j a n i
авсыг	a w̜ s i k
Онтарио	ɔ n tʰ a r i̯ oː
пиджакийнхан	pʰ i t t͡ɕ a kʰ iː ŋ x a ŋ
авгалдайн	a w̜ k a ɮ t ɛː ŋ
мөрөвч	m o r ə w t͡ɕʰ
гүнжтэй	k u n t͡ɕ tʰ e i̯
ямар	j a m ə r
ресторантай	rʲ ɵ s tʰ ɔ r a n tʰ ɛː
авгуудын	a w̜ k ʊː t i ŋ
атаа	a tʰ a
сексүүд	s j ɵ kʰ s uː t
иллэг	i ɮː e k
гэрүүдгүй	k e r uː t k u i̯
сул	s o ɬ
шалтаг	ʃ a ɮ tʰ ə ɡ
хөлдөөгч	x o ɮ t o ɡ t͡ɕʰ
аалзны	aː ɮ t͡s n i
алуурчинд	a ɮ ʊː r̥ t͡ɕʰ i n t
авъяасыг	a w̜ j aː s i k
гэртээсээ	k e r̥ tʰ eː s eː
жилүүдээр	t͡ɕ i ɮ uː t eː r̥
үүлийг	uː ɮ iː k
усныхаа	ʊ s n i x aː
хайрлах	x a i r ɮ ə x
нэмэх	n i m ə x
удирдлага	ʊ tʲ ə r t ɮ ə ɢ
цэ	t͡sʰ e
хуруу	x ʊ r ʊ
мориор	m ɔ r i̯ oː r̥
усандаа	ʊ s a n t aː
хамгаалах	x a m k aː ɮ a x
размер	r a t͡s mʲ ɵ r̥
догшин	t ɔ ɡ ʃ ə ŋ
байгууллагуудыг	p ɛː k ʊː ɮː a ɣ ʊː t i k
арыг	a r i k
авснуудаар	a w̜ s n ʊː t aː r̥
жууцайгүй	t͡ɕ ʊː t͡sʰ ɛː k u i̯
авсан	a w̜ s a ŋ
хаадын	x aː t i ŋ
дээл	t eː ɮ
бөөгийнхөн	p ɵː k iː ŋ x ɵ ŋ
өөрчлөх	oː r t͡ɕʰ ɮ ə x
аалзанд	aː ɮ t͡s a n t
зун	t͡s ʊ ŋ
гүнжүүдэд	k u n t͡ɕ uː t e t
илжигний	i ɮ t͡ɕ i k n iː
буддыг	p ʊ t͉ t i k
Бээжинд	p eː t͡ɕ i n t
анаашин	a n aː ɕ i ŋ
бясалгал	pʲ a s ə ɮ ɢ ə ɮ
кинотой	kʰ i n ɔ tʰ ɔ i̯
үгсгүй	u k s k u i̯
бургасаар	p ʊ r k a s aː r̥
тэр	tʰ e r
өөлд	oː ɮ tʰ
ахмад	a x m a t
өв	ɵ w̜
илжгэнд	i ɮ t͡ɕ k e n t
хутгалдах	x ʊ t ɢ a ɮ t a x
байгалиасаа	p ɛː k a ɮ i̯ aː s aː
айл	æː ɮ
Алматы	a ɮ m a tʰ i
гайхлуудгүй	k ɛː x ɮ ʊː t k u i̯
хэмжээ	x i m t͡ɕ e
шалгуур	ʃ a ɮ ɢ ʊ r
дипломатч	t i pʰ ɮ ɔ m a tʰ t͡ɕʰ
нэрснүүддээ	n e r s n uː t͉ t eː
хэрэг	k e r e ɡ
мориныход	m ɔ r i n i x ɔ t
анхилгаараа	a ŋ x i ɮ k aː r aː
вирусгүй	w̜ i r ʊ s k u i̯
луунуудынх	ɮ ʊː n ʊː t i ŋ x
бүхний	p u x n iː
байгалийгаа	p ɛː k a ɮ iː k aː
артай	a r̥ tʰ ɛː
грекүүдийнх	k rʲ ɵ kʰ uː t iː ŋ x
зузаан	t͡s ʊ t͡s a ŋ
гэрийг	k e r iː k
гутал	ɢ ʊ tʰ ə ɮ
испаничууд	i s pʰ a n i t͡ɕʰ ʊː t
байгууллагуудад	p ɛː k ʊː ɮː a ɣ ʊː t a t
гитараа	k i tʰ a r aː
арц	a r̥ t͡sʰ
веб	w̜ʲ ɵ p
Доржийн	t ɔ r t͡ɕ iː ŋ
тусгаарлагч	tʰ ʊ s k aː r ɮ a k t͡ɕʰ
тэргэнд	tʰ e r k e n t
үгсээс	u k s eː s
нэрсээ	n e r s eː
мөнх	m o ŋ x
зөгийд	t͡s ɵ ɣ iː t
алуурчныг	a ɮ ʊː r̥ t͡ɕʰ n i k
сая	s ä j ä
нэрсдээ	n e r s t eː
Багануур	p a ɣ a n ʊː r̥
ирц	i r t͡sʰ
энх	e ŋ x
хүмүүндээ	x u m uː n t eː
хэм	x e m
шанз	ʃ a n t͡s
Чингисийнхийгээ	t͡ɕʰ i ŋ k i s iː ŋ x iː k eː
чадвар	t͡ɕʰ a t w̜ a r̥
Бөртэд	p ɵ r̥ tʰ e t
номуудынх	n ɔ m ʊː t i ŋ x
зоригоор	t͡s ɔ rʲ ə ɡ ɔ r
жууцайнуудаас	t͡ɕ ʊː t͡sʰ ɛː n ʊː t aː s
бөөгөөр	p ɵː k ɵː r̥
Өгэдэйгээр	ɵ ɣ e t e i̯ ɣ eː r̥
гуайнд	k u̯ ɛː n t
баяд	p ä j t ə
зочин	t͡s ɔ t͡ɕʰ i ŋ
ааруулыг	aː r ʊː ɮ i k
үүлнүүдээс	uː ɮ n uː t eː s
эмэгтэйчүүдэд	e m e k tʰ e i̯ t͡ɕʰ uː t e t
тоглоом	tʰ ɔ k ɮ oː m
хонь	x ɔ nʲ
вэ	w̜ e
овъёосыг	ɔ w̜ j ɔː s i k
хааны	x aː n i
юмс	j ʊ m s
миний	m i n iː
ястан	j ä s tʰ ə ŋ
цайнуудынхан	t͡sʰ ɛː n ʊː t i ŋ x a ŋ
анекдот	a nʲ ɵ kʰ t ɔ tʰ
амёб	a mʲ ɔ p
фото	f ɔ tʰ
харваа	x a r w a
байгууллагуудынхан	p ɛː k ʊː ɮː a ɣ ʊː t i ŋ x a ŋ
бууралтах	p ʊː r ə ɮ tʰ ə x
Лхас	ɬʰ a s
барилдах	p a r i ɮ t a x
бульдозерчин	p ʊ ɮʲ t ɔ t͡s j ɵ r̥ t͡ɕʰ i ŋ
Сибирь	s i β i rʲ
эндометриоз	e n t ɔ mʲ ɵ tʰ r i̯ oː t͡s
монгол	m ɔ ɴ ɢ ʊ ɮ
сойз	s ɔ i t͡s
асуух	a s ʊ x
адгуус	a t k ʊː s
Бангладеш	p a ŋ k ɮ a tʲ ɵ ɕ
хөвгүүнээсээ	x ɵ w̜ k uː n eː s eː
нууц	n ʊː t͡s
эмэгтэйчүүдийн	e m e k tʰ e i̯ t͡ɕʰ uː t iː ŋ
күүки	kʰ uː kʰ
өвөл	ɵ w̜ ɵ ɮ
ялгал	j a ɮ ɢ a ɮ
мэдэх	m i t ə x
метр	mʲ ɵ tʰ r̥
үгэнд	u ɣ e n t
тахиудаасаа	tʰ a x i̯ ʊː t aː s aː
пальтоны	pʰ a ɮʲ tʰ ɔ n i
өөд	ɵː t
дэргэд	t e r k e t
Европ	j ɵ w r ɔˑ pʰ
холтоснуудын	x ɔ ɮ tʰ ɔ s n ʊː t i ŋ
хүрхрээ	x u r x r e
Өгэдэйтэй	ɵ ɣ e t e i̯ tʰ e i̯
тахиагүй	tʰ a x i̯ aː k u i̯
Өгэдэйг	ɵ ɣ e t e i̯ k
уур	ʊː r
тэнгисүүдийг	tʰ e ŋ k i s uː t iː k
авснуудгүй	a w̜ s n ʊː t k u i̯
хаадынд	x aː t i n t
шашнуудынхаа	ɕ a ɕ n ʊː t i ŋ x aː
зургаадугаар	t͡s ʊ r k aː t ʊ ɣ aː r̥
ща	ɕ a
хол	χ ɔ ɬ
Зүүнхараа	t͡s uː ŋ x a r aː
цас	t͡sʰ a s
фотогоор	f ɔ tʰ ɔ ɣ oː r̥
холтосноос	x ɔ ɮ tʰ ɔ s n oː s
пиджакуудынхан	pʰ i t t͡ɕ a kʰ ʊː t i ŋ x a ŋ
ирвэс	i r w ə s
зүүд	t͡s uː t
гэдэс	k e t e s
дэвших	t i w ʃ ə x
шашнаасаа	ɕ a ɕ n aː s aː
Өэлүнээр	ɵ e ɮ u n eː r̥
үүлнүүдэд	uː ɮ n uː t e t
номоос	n ɔ m oː s
шахах	ʃ a x ə x
төлөвлөгөө	tʰ ɵ ɮ ɵ w̜ ɮ ɵ ɡ oː
аадраас	aː t r aː s
Обь	ɔ pʲ
зандах	t͡s a n t ə x
ааруулууд	aː r ʊː ɮ ʊː t
хөвгүүдийнхэн	x ɵ w̜ k uː t iː ŋ x e ŋ
луунуудгүй	ɮ ʊː n ʊː t k u i̯
хад	x a t
яам	j aː m
бүхэнд	p u x e n t
хэтэвч	x e tʰ ə w t͡ɕʰ
гүнжгүй	k u n t͡ɕ k u i̯
баклава	p a kʰ ɮ a w̜ a
авдруудад	a w̜ t r ʊː t a t
хүнтэйгээ	x u n tʰ e i̯ ɣ eː
зөвшөөрөх	t͡s ɵ w ʃ oː r ɵ x
өмд	ɵ m t
цайг	t͡sʰ ɛː k
моргейж	m ɔ r kʲ ɵ i̯ t͡ɕ
гууль	ɢ ʊː ɮʲ
өвдөг	o w t ə ɡ
гэрэл	k e r e ɮ
гитаруудаа	k i tʰ a r ʊː t aː
гэрүүдийнх	k e r uː t iː ŋ x
хиа	x i̯ aː
дарь	t ɛ r
буддатай	p ʊ t͉ t a tʰ ɛː
нэрийнх	n e r iː ŋ x
текст	tʰʲ ɵ kʰ s tʰ
агаар	a ɢ aː r
щит	ɕ i tʰ
батга	p a tʰ k
орчим	ɔ r t͡ɕʰ ə m
ангиас	a ŋ k i̯ aː s
сэжиг	s i t͡ɕ ə ɡ
дээр	t eː r
суулгах	s ʊː ɮ ɢ a x
тоть	tʰ œ tʰ
анхилгадаа	a ŋ x i ɮ k a t aː
пальтонуудын	pʰ a ɮʲ tʰ ɔ n ʊː t i ŋ
аашинд	aː ɕ i n t
ангигүй	a ŋ k i ɣ u i̯
автокранд	a w̜ tʰ ɔ kʰ r a n t
дельта	tʲ ɵ ɮʲ tʰ
ханан	x a n a ŋ
авгалдайд	a w̜ k a ɮ t ɛː t
ангийг	a ŋ k iː k
ойлгох	ɔ i ɮ ɢ ə x
трамвай	tʰ r a m w̜ ɛː
шоо	ʃ ɔː
хөвгүүнийгээ	x ɵ w̜ k uː n iː k eː
авгынх	a w̜ k i ŋ x
тайлбар	tʰ ɛː ɮ p a r̥
аалзнуудаас	aː ɮ t͡s n ʊː t aː s
пийшин	pʰ iː ʃ ə ŋ
байгалиа	p ɛː k a ɮ i̯ aː
сур	s ʊ r̥
Улаанбаатартай	ʊ ɮ aː m p aː tʰ a r̥ tʰ ɛː
ханхайгаар	x a ŋ x ɛː k aː r̥
жунгаа	t͡ʃ ʊ ŋ ɢ aː
авгалдайгаар	a w̜ k a ɮ t ɛː k aː r̥
Дани	t äˑ n
програм	pʰ r ɔ k r a m
нөлөө	n o ɮ o
найрах	n ɛː r a x
нэр	n e r̥
морин	m ɔ r i ŋ
гүнжүүдийг	k u n t͡ɕ uː t iː k
идэх	i t ə x
эф	e f
гэрийнх	k e r iː ŋ x
зурагчин	t͜s ʊ r x̠ t͜ɕʰ ə ŋ
бүр	p u r
хүч	x u t͡ɕʰ
кино	kʰ i n ɔˑ
шийдвэр	ʃ iː t w ə r
Чойр	t͡ɕʰ ɔ i̯ r̥
тээрэмчин	tʰ eː r e m t͡ʃʰ i ŋ
вирусүүдгүй	w̜ i r ʊ s uː t k u i̯
ангиараа	a ŋ k i̯ aː r aː
шүүдэр	ʃ uː t ə r
хижээл	x i t͡ɕ e ɮ
бурхан	p ʊ r x a ŋ
авгалдайнуудтай	a w̜ k a ɮ t ɛː n ʊː t tʰ ɛː
архивуудаас	a r x i w̜ ʊː t aː s
бөднө	p o t ə n
мохоо	m ɔ x ɔ
гэр	ɡ e r
автокраныг	a w̜ tʰ ɔ kʰ r a n i k
байрыгаа	p ɛː r i ɣ aː
жилүүдийн	t͡ɕ i ɮ uː t iː ŋ
Бөртээр	p ɵ r̥ tʰ eː r̥
ааш	aː ɕ
сансар	s a n s ə r
алуурчидгүй	a ɮ ʊː r̥ t͡ɕʰ i t k u i̯
Чингисээрээ	t͡ɕʰ i ŋ k i s eː r eː
гитаруудын	k i tʰ a r ʊː t i ŋ
нэрснүүдийг	n e r s n uː t iː k
гуайнуудтай	k u̯ ɛː n ʊː t tʰ ɛː
авсанд	a w̜ s a n t
хөвгүүд	x ɵ w̜ k uː t
халдваргүй	χ a ɮ t w ə̠ r ɡ ʉ͜i
объект	ɔ p j ɵ kʰ tʰ
гитарынхан	k i tʰ a r i ŋ x a ŋ
анхилгынхаа	a ŋ x i ɮ k i ŋ x aː
пальтоноос	pʰ a ɮʲ tʰ ɔ n oː s
ы	i
анхилгаар	a ŋ x i ɮ k aː r̥
цаг	t͜sʰ ä k̠
улсуудад	ʊ ɮ s ʊː t a t
гүнжүүдээсээ	k u n t͡ɕ uː t eː s eː
ангиудгүйгээ	a ŋ k i̯ ʊː t k u i̯ ɣ eː
буддад	p ʊ t͉ t a t
гүн	ɡ u ŋ
чангаанз	t͡ɕʰ a ŋ k aː n t͡s
жууцайнаас	t͡ɕ ʊː t͡sʰ ɛː n aː s
хураангуй	x ʊ r aː ŋ k ʊ i̯
дөө	t ɵː
хойд	χ œː tʰ
буддагүй	p ʊ t͉ t a ɣ u i̯
жилүүдээс	t͡ɕ i ɮ uː t eː s
хүмүүсээрээ	x u m uː s eː r eː
байгууллагуудгүй	p ɛː k ʊː ɮː a ɣ ʊː t k u i̯
Чингисийнхээсээ	t͡ɕʰ i ŋ k i s iː ŋ x eː s eː
саатал	s aː tʰ ə ɮ
хөвгүүнээс	x ɵ w̜ k uː n eː s
улсаас	ʊ ɮ s aː s
уснуудынх	ʊ s n ʊː t i ŋ x
ширхэг	ʃ i r x e ɡ
далбаа	t a ɮ p a
лууны	ɮ ʊː n i
улиас	ʊ ɮʲ a s
дайсан	t ɛː s a ŋ
хүмүүнийхэн	x u m uː n iː x e ŋ
авъяасын	a w̜ j aː s i ŋ
динозавруудаас	t i n ɔ t͡s a w̜ r ʊː t aː s
тавих	tʰ a wʲ ə x
хүмүүсгүйгээ	x u m uː s k u i̯ ɣ eː
очих	ɔ t͡ɕʰ ə x
гэрүүдээр	k e r uː t eː r̥
хааныг	x aː n i k
Өэлүний	ɵ e ɮ u n iː
буддынхан	p ʊ t͉ t i ŋ x a ŋ
илжигнүүдийнх	i ɮ t͡ɕ i k n uː t iː ŋ x
зориг	t͡s ɔ rʲ ə ɡ
Өгэдэйд	ɵ ɣ e t e i̯ t
комиссар	kʰ ɔ m i sː a r̥
анхилгуудаа	a ŋ x i ɮ k ʊː t aː
цахилгаанжуулалт	t͡sʰ a x i ɮ k aː n t͡ɕ ʊː ɮ a ɮ tʰ
жишээнүүдтэй	t͡ɕ i ɕ eː n uː t tʰ e i̯
гавал	ɢ a w ə ɮ
анхаарал	a ŋ x aː r a ɮ
аагуудын	aː k ʊː t i ŋ
тэрэгнүүдээс	tʰ e r e k n uː t eː s
авгуудаар	a w̜ k ʊː t aː r̥
наймалж	n ɛː m a ɮ t͡ɕ
шалтгаа	ʃ a ɮ tʰ ɡ a
авдраас	a w̜ t r aː s
байрнаасаа	p ɛː r n aː s aː
боохой	p oː x ɔ i̯
Чингисийнхээр	t͡ɕʰ i ŋ k i s iː ŋ x eː r̥
ханз	x a n t͡s
тэнгисүүдгүй	tʰ e ŋ k i s uː t k u i̯
гэмших	ɡ i m ʃ ə x
нар	n ɐ ɾ
цахилгаан	t͡sʰ a x i ɮ k aː ŋ
аавуудад	aː w̜ ʊː t a t
тэмдэг	tʰ e m t e k
хугацаа	x ʊ ɢ t͡sʰ a
луунуудтайгаа	ɮ ʊː n ʊː t tʰ ɛː k aː
авдруудаар	a w̜ t r ʊː t aː r̥
тэмээнүүдэд	tʰ e m eː n uː t e t
Хянган	xʲ a ŋ k a ŋ
бөс	p ɵ s
луугүйгээ	ɮ ʊː k u i̯ ɣ eː
кинонуудад	kʰ i n ɔ n ʊː t a t
мориноос	m ɔ r i n oː s
байраар	p ɛː r aː r̥
гарт	ɢ ä r tʰ
жилүүдэд	t͡ɕ i ɮ uː t e t
гитаруудыг	k i tʰ a r ʊː t i k
гитарыг	k i tʰ a r i k
арынх	a r i ŋ x
тэрэгнүүдээр	tʰ e r e k n uː t eː r̥
луунуудынхаа	ɮ ʊː n ʊː t i ŋ x aː
уушги	ʊː ʃ ə ɡʲ
тэрэгнийхэн	tʰ e r e k n iː x e ŋ
пиццаныхан	pʰ i t͡sʰ a n i x a ŋ
хэрэглэгдэхүүн	x e r e k ɮ e k t e x uː ŋ
орчлон	ɔ r̥ t͡ɕʰ ɮ ɔ ŋ
адгууснуудтай	a t k ʊː s n ʊː t tʰ ɛː
дундаж	t ʊ n t a t͡ɕ
трансформатор	tʰ r a n s f ɔ r m a tʰ ɔ r̥
батарей	p a tʰ a rʲ ɵ i̯
нэрлэх	n e r ɮ e x
үүлээр	uː ɮ eː r̥
хааныд	x aː n i t
хэбид	x e β i t
төгрөгүүдийн	tʰ ɵ k r ɵ ɣ uː t iː ŋ
сүмс	s u m s
Тува	tʰ ʊ w̜ aˑ
бум	p ʊ m
жилүүдийнхэн	t͡ɕ i ɮ uː t iː ŋ x e ŋ
махчин	m a x t͡ɕʰ ə ŋ
лууных	ɮ ʊː n i x
авдрын	a w̜ t r i ŋ
цүүц	t͡sʰ uː t͡sʰ
хааддаа	x aː t͉ t aː
гитаруудтайгаа	k i tʰ a r ʊː t tʰ ɛː k aː
овъёосгүй	ɔ w̜ j ɔː s k u i̯
амьтдын	a mʲ tʰ t i ŋ
манай	m a n æː
пиджакуудыг	pʰ i t t͡ɕ a kʰ ʊː t i k
Тав	tʰ a w̜
зулзага	t͡s ʊ ɮ t͡s ə ɢ
архивууд	a r x i w̜ ʊː t
анхилгуудын	a ŋ x i ɮ k ʊː t i ŋ
лобби	ɮ ɔ b i
хэрэглэх	k e r e ɡ l e x ʉ
зоригт	t͡s ɔ rʲ ə ɡ tʰ
хазах	x a t͡s ə x
авдартай	a w̜ t a r̥ tʰ ɛː
үндэстэн	u n t ə s t ə ŋ
ангиудад	a ŋ k i̯ ʊː t a t
унтрах	ʊ n tʰ r a x
Чингисийнхэн	t͡ɕʰ i ŋ k i s iː ŋ x e ŋ
реактор	rʲ ɵ a kʰ tʰ ɔ r̥
сүх	s u x
номуудаас	n ɔ m ʊː t aː s
жууцайнуудын	t͡ɕ ʊː t͡sʰ ɛː n ʊː t i ŋ
авсаар	a w̜ s aː r̥
компьютер	kʰ ɔ m pʰ j ʊ tʰʲ ɵ r̥
шоргоолж	ɕ ɔ r k oː ɮ t͡ɕ
амгай	a m k ɛː
ноён	n ɔ j ɔ ŋ
машин	m a ɕ i ŋ
абстрактуудгүй	a p s tʰ r a kʰ tʰ ʊː t k u i̯
авдруудтай	a w̜ t r ʊː t tʰ ɛː
анчнаас	a n t͡ɕʰ n aː s
та	tʰ a
гэртэйгээ	k e r̥ tʰ e i̯ ɣ eː
луунаасаа	ɮ ʊː n aː s aː
улс	ʊ l ʊ s
какао	kʰ a kʰ ɒː
ааруулаар	aː r ʊː ɮ aː r̥
тогтоох	tʰ ɔ ɡ tʰ ɔ x
байгалиар	p ɛː k a ɮ i̯ aː r̥
америкчуудын	a mʲ ɵ r i kʰ t͡ɕʰ ʊː t i ŋ
булчирхай	p ʊ ɮ t͡ɕʰ ə r x a i
алт	a ɮ tʰ
усгүй	ʊ s k u i̯
тараг	tʰ a r a k
Лондон	ɮ ɔ n t ɔ ŋ
үгэн	u ɣ e ŋ
социализм	s ɔ t͡sʰ i̯ aː ɮ i t͡s m
тайга	tʰ ɛː k
гэрээрээ	k e r eː r eː
золбин	t͡s ɔ ɮʲ pʲ ə ŋ
өөх	oː x
уснуудыг	ʊ s n ʊː t i k
абстракттай	a p s tʰ r a kʰ tʰ ɛː
юмгүй	j ʊ m k u i̯
гүнждэдээ	k u n t͡ɕ t e t eː
галигийг	k a ɮ i ɣ iː k
хаадаасаа	x aː t aː s aː
автобустай	a w̜ tʰ ɔ p ʊ s tʰ ɛː
холтосгүй	x ɔ ɮ tʰ ɔ s k u i̯
гитараараа	k i tʰ a r aː r aː
цавуу	t͡sʰ a w ʊ
байртай	p ɛː r̥ tʰ ɛː
байгууллага	p ɛː k ʊː ɮː a ɣ
австай	a w̜ s tʰ ɛː
гэрүүдийг	k e r uː t iː k
ёкозуна	j ɔ kʰ ɔ t͡s ʊ n
апелсин	a pʰʲ ɵ ɮ s i ŋ
архивуудыг	a r x i w̜ ʊː t i k
жишээгүй	t͡ɕ i ɕ eː k u i̯
Шиньжян	ɕ i nʲ t͡ɕ j a ŋ
аагаас	aː k aː s
шашнуудгүй	ɕ a ɕ n ʊː t k u i̯
нэрснээс	n e r s n eː s
ширээ	ʃ i r e
Бөртээс	p ɵ r̥ tʰ eː s
тэнгисүүдийн	tʰ e ŋ k i s uː t iː ŋ
хайх	x ɛː x
аалзтай	aː ɮ t͡s tʰ ɛː
авдруудын	a w̜ t r ʊː t i ŋ
гүрвэл	k u r w̜ e ɮ
бид	p i t
морьгүй	m ɔ rʲ k u i̯
ард	a r t
лалруудаас	ɮ a ɮ r ʊː t aː s
нялх	nʲ a ɮ x
блог	p ɮ ɔ k
грекээр	k rʲ ɵ kʰ eː r̥
дөрөв	t ɵ r u w̜
сайн	s æː ɴ̟
аалзнууд	aː ɮ t͡s n ʊː t
гүнжүүдийн	k u n t͡ɕ uː t iː ŋ
зурагт	t͡s ʊ r a k tʰ
гүнжүүдээрээ	k u n t͡ɕ uː t eː r eː
анчдад	a n t͡ɕʰ t a t
нэрсийнх	n e r s iː ŋ x
хураамж	x ʊ r aː m t͡ɕ
Бөртэ	p ɵ r̥ tʰ
луунуудынхан	ɮ ʊː n ʊː t i ŋ x a ŋ
Улаанбаатарын	ʊ ɮ aː m p aː tʰ a r i ŋ
номд	n ɔ m t
хурган	x ʊ r k a ŋ
сэрэх	s e r ə x
шатар	ʃ a tʰ ə r
авгалдайнуудад	a w̜ k a ɮ t ɛː n ʊː t a t
алуурчдыг	a ɮ ʊː r̥ t͡ɕʰ t i k
динозавруудад	t i n ɔ t͡s a w̜ r ʊː t a t
авгалдайгүй	a w̜ k a ɮ t ɛː k u i̯
мотор	m ɔ tʰ ɔ r̥
лонх	ɮ ɔ n x
хүзүү	x u t͡s u
тахиараа	tʰ a x i̯ aː r aː
гараас	k a r aː s
зориулах	t͡s ɔ rʲ ʊ ɮ ə x
тахиаг	tʰ a x i̯ aː k
бургаснуудаас	p ʊ r k a s n ʊː t aː s
гүнжидтэй	k u n t͡ɕ i t tʰ e i̯
улсуудаар	ʊ ɮ s ʊː t aː r̥
шашнуудаасаа	ɕ a ɕ n ʊː t aː s aː
тэвнэ	tʰ i w ə n
хүмүүсгүй	x u m uː s k u i̯
үхэр	u x ə r
нэрдээ	n e r t eː
автомашинд	a w̜ tʰ ɔ m a ɕ i n t
Эрхүү	e r x uː
гайхал	ɢ a i x a ɮ
бульдозер	p ʊ ɮʲ t ɔ t͡s j ɵ r̥
гэрт	k e r̥ tʰ
хоймсон	x ɔ i̯ m s ɔ ŋ
заалдлага	t͡s aː ɮ t ɮ a ɣ
авгалдайнуудаас	a w̜ k a ɮ t ɛː n ʊː t aː s
цуйван	t͡sʰ ʊ i w ə ŋ
тэмээнд	tʰ e m eː n t
луунуудаар	ɮ ʊː n ʊː t aː r̥
хуульч	x ʊː ɬʲ t͡ʃʰ
салса	s a ɮ s
Мисир	m i s i r̥
ангийн	a ŋ k iː ŋ
командлагч	kʰ ɔ m a n t ɮ a k t͡ɕʰ
санах	s a n ə x
бургаснууд	p ʊ r k a s n ʊː t
гүнждийнхэн	k u n t͡ɕ t iː ŋ x e ŋ
жилүүдийг	t͡ɕ i ɮ uː t iː k
авдаргүй	a w̜ t a r k u i̯
хонох	x ɔ n ɔ x
имрэх	i m r ə x
улсгүй	ʊ ɮ s k u i̯
хүрэлзгэнэ	x u r ə ɮ t͡s ɡ ə n
хөөрөг	x oː r ə ɡ
жишээнүүд	t͡ɕ i ɕ eː n uː t
Орос	ɔ r ʊ s
жигүүр	t͡ɕ i ɣ uː r̥
гар	ɢ a r
хүний	x u n iː
Азербайжан	a t͡s j ɵ r p ɛː t͡ɕ a ŋ
нөгөө	n ɵ ɡ oː
автомашинуудтай	a w̜ tʰ ɔ m a ɕ i n ʊː t tʰ ɛː
кинонуудтай	kʰ i n ɔ n ʊː t tʰ ɛː
гольф	k ɔ ɮʲ f
нийгэм	n iː k e m
Чингисийнхгүйгээ	t͡ɕʰ i ŋ k i s iː ŋ x k u i̯ ɣ eː
автобусаар	a w̜ tʰ ɔ p ʊ s aː r̥
авгад	a w̜ k a t
хоёрдугаар	x ɔ j ɔ r t ʊ ɣ aː r̥
заарь	t͡s aː r
Тирана	tʰ i r a n a
эрхтэн	e r x tʰ e ŋ
хордох	x ɔ r t ə x
автокрануудыг	a w̜ tʰ ɔ kʰ r a n ʊː t i k
байгууллагууд	p ɛː k ʊː ɮː a ɣ ʊː t
хөвгүүдтэй	x ɵ w̜ k uː t tʰ e i̯
гайхлуудаас	k ɛː x ɮ ʊː t aː s
тэмцэх	tʰ e m t͡sʰ e x
анхилгуудаас	a ŋ x i ɮ k ʊː t aː s
пуужин	pʰ ʊː t͡ɕ ə ŋ
гитарын	k i tʰ a r i ŋ
овъёосонд	ɔ w̜ j ɔː s ɔ n t
холтосныхоо	x ɔ ɮ tʰ ɔ s n i x oː
ханхайнуудыг	x a ŋ x ɛː n ʊː t i k
шашнуудыг	ɕ a ɕ n ʊː t i k
илтгэх	i ɮ tʰ ɡ ə x
ноёдынд	n ɔ j ɔ t i n t
зүүн	d͡ʒ uː n
үйлдвэрлэх	u i ɮ t w ə r ɮ ə x
буддаас	p ʊ t͉ t aː s
гуай	k u̯ ɛː
вирусийн	w̜ i r ʊ s iː ŋ
сексийнхэн	s j ɵ kʰ s iː ŋ x e ŋ
хөвгүүдийн	x ɵ w̜ k uː t iː ŋ
байгальгүйгээ	p ɛː k a ɮʲ k u i̯ ɣ eː
гитаруудаараа	k i tʰ a r ʊː t aː r aː
киногоор	kʰ i n ɔ ɣ oː r̥
Улиастай	ʊ ɮ i̯ aː s tʰ ɛː
хяргах	xʲ a r ɢ ə x
абстрактуудаар	a p s tʰ r a kʰ tʰ ʊː t aː r̥
тэнгисүүдтэй	tʰ e ŋ k i s uː t tʰ e i̯
овъёоснуудгүй	ɔ w̜ j ɔː s n ʊː t k u i̯
зайдуу	t͡s a i t ʊ
байгууллагуудаар	p ɛː k ʊː ɮː a ɣ ʊː t aː r̥
кинонд	kʰ i n ɔ n t
цайнуудтай	t͡sʰ ɛː n ʊː t tʰ ɛː
цонх	t͡sʰ ɔ ŋ x
Алтай	a ɮ tʰ ɛː
анаашнуудын	a n aː ɕ n ʊː t i ŋ
түймэр	tʰ u i m ə r
Багахангай	p a ɣ a x a ŋ k ɛː
байрнуудгүй	p ɛː r n ʊː t k u i̯
Цэцэрлэг	t͡sʰ e t͡sʰ e r ɮ e k
абстрактуудын	a p s tʰ r a kʰ tʰ ʊː t i ŋ
нэрсэндээ	n e r s e n t eː
галигаас	k a ɮ i ɣ aː s
нэрийнхээ	n e r iː ŋ x eː
заах	t͡s aː x
хөмрөх	x o m r ə x
анчидгүй	a n t͡ɕʰ i t k u i̯
нэрснүүдэд	n e r s n uː t e t
ноёдынхон	n ɔ j ɔ t i ŋ x ɔ ŋ
тува	tʰ ʊ w̜ äˑ
орчон	ɔ r̥ t͡ɕʰ ɔ ŋ
шүү	ɕ uː
усыгаа	ʊ s i ɣ aː
байргүй	p ɛː r k u i̯
хас	χ a s
бөгөөд	p ɵ ɣ ɵː t
ноёдгүй	n ɔ j ɔ t k u i̯
төгрөгүүдээс	tʰ ɵ k r ɵ ɣ uː t eː s
устөрөгч	ʊ s tʰ ɵ r ɵ k t͡ɕʰ
ресторануудын	rʲ ɵ s tʰ ɔ r a n ʊː t i ŋ
Улаанцав	ʊ ɮ a n t͡sʰ ə w
дэвшигч	t e w̜ ɕ i k t͡ɕʰ
холтоснуудынхаа	x ɔ ɮ tʰ ɔ s n ʊː t i ŋ x aː
мянга	mʲ ä ɴ q
авайлах	a w̜ ɛː ɮ a x
анчныг	a n t͡ɕʰ n i k
шашныхан	ɕ a ɕ n i x a ŋ
хаандаа	x aː n t aː
авгалдай	a w̜ k a ɮ t ɛː
хамтрах	x a m tʰ r a x
гарал	k a r a ɮ
авснуудыг	a w̜ s n ʊː t i k
канжи	kʰ a n t͡ɕ
өөхлөг	oː x ɮ ə ɡ
жишээнүүдийг	t͡ɕ i ɕ eː n uː t iː k
үнс	u n s
Чингисгүй	t͡ɕʰ i ŋ k i s k u i̯
хаантайгаа	x aː n tʰ ɛː k aː
автомашинуудаар	a w̜ tʰ ɔ m a ɕ i n ʊː t aː r̥
аагууд	aː k ʊː t
ислам	i s ɮ a m
луунууд	ɮ ʊː n ʊː t
цайллага	t͡sʰ a i ɮ ɮ ə ɢ
булаацалдах	p ʊ ɮ aː t͡sʰ a ɮ t a x
оёх	ɔ j ʊ χ
үсрэх	u s r e x
гуайгүй	k u̯ ɛː k u i̯
Бээжинг	p eː t͡ɕ i ŋ k
төгрөг	tʰ ɵ k r ɵ k
грекчүүд	k rʲ ɵ kʰ t͡ɕʰ uː t
байгалийн	p ɛː k a ɮ iː ŋ
пальтонуудаас	pʰ a ɮʲ tʰ ɔ n ʊː t aː s
нэрснүүдээр	n e r s n uː t eː r̥
өлсгөлөн	o ɮ s ɡ ə ɮ ə ŋ
сал	s a ɮ
ноёдоор	n ɔ j ɔ t oː r̥
адгуусанд	a t k ʊː s a n t
пиджакаар	pʰ i t t͡ɕ a kʰ aː r̥
гэрүүдэд	k e r uː t e t
автобуснуудаас	a w̜ tʰ ɔ p ʊ s n ʊː t aː s
жад	t͡ɕ a t
буга	p ʊ ɢ
шаазгай	ʃ aː t͡s ɢ a i
нэрсэнд	n e r s e n t
гэрийгээ	k e r iː k eː
ресторануудаас	rʲ ɵ s tʰ ɔ r a n ʊː t aː s
хэрүүл	x i r u ɮ
хэрэглэгдэх	x i r ə ɡ ɮ ə ɡ t ə
гич	k i t͡ɕʰ
ханхайнуудын	x a ŋ x ɛː n ʊː t i ŋ
анчдынх	a n t͡ɕʰ t i ŋ x
авгынд	a w̜ k i n t
герман	ɡ e r m aˑ ŋ
гүнжээс	k u n t͡ɕ eː s
тахийнхаа	tʰ a x iː ŋ x aː
аагуудад	aː k ʊː t a t
үзэлцэх	u t͡s e ɮ t͡sʰ e x
үгнээс	u k n eː s
автокрануудтай	a w̜ tʰ ɔ kʰ r a n ʊː t tʰ ɛː
самбар	s a m p ə r
луун	ɮ ʊː ŋ
Чингисийнх	t͡ɕʰ i ŋ k i s iː ŋ x
шашнуудаа	ɕ a ɕ n ʊː t aː
гректэйгээ	k rʲ ɵ kʰ tʰ e i̯ ɣ eː
амьтдаас	a mʲ tʰ t aː s
морийгоо	m ɔ r iː k oː
аалзаар	aː ɮ t͡s aː r̥
ресторанд	rʲ ɵ s tʰ ɔ r a n t
овъёосны	ɔ w̜ j ɔː s n i
гарааш	k a r aː ɕ
гүнжүүдгүй	k u n t͡ɕ uː t k u i̯
ятга	j a tʰ ə ɢ
ангиудгүй	a ŋ k i̯ ʊː t k u i̯
Бразил	p r ä t͜s iˑ ɮ
бичээч	p i t͡ɕʰ eː t͡ɕʰ
аадарт	aː t a r̥ tʰ
календарь	k a ɮ e n d a rʲ
автокрануудад	a w̜ tʰ ɔ kʰ r a n ʊː t a t
Чингисээсээ	t͡ɕʰ i ŋ k i s eː s eː
судар	s ʊ t ə r
хөх	x ɵ x
авгуудад	a w̜ k ʊː t a t
эм	e m
математикч	m a tʰʲ ɵ m a tʰ i kʰ t͡ɕʰ
ноёноос	n ɔ j ɔ n oː s
дуулга	d u ɮ ɢ a
хүмүүнээс	x u m uː n eː s
боох	p oː x
шээх	ɕ eː x
автокрануудгүй	a w̜ tʰ ɔ kʰ r a n ʊː t k u i̯
оноо	ɔ n ɔ
ханхайнуудаар	x a ŋ x ɛː n ʊː t aː r̥
анхилгуудынхаа	a ŋ x i ɮ k ʊː t i ŋ x aː
гүнжгүйгээ	k u n t͡ɕ k u i̯ ɣ eː
хүндрэл	x u n t r e ɮ
улсуудын	ʊ ɮ s ʊː t i ŋ
Архангай	a r x a ŋ k ɛː
абстрактыг	a p s tʰ r a kʰ tʰ i k
есдүгээр	j ɵ s t u ɣ eː r̥
анхилгуудгүйгээ	a ŋ x i ɮ k ʊː t k u i̯ ɣ eː
төгрөгүүдэд	tʰ ɵ k r ɵ ɣ uː t e t
грекийн	k rʲ ɵ kʰ iː ŋ
ханхайг	x a ŋ x ɛː k
цангаа	t͡sʰ a ŋ ɢ a
нэрстэйгээ	n e r s tʰ e i̯ ɣ eː
тэрэгнүүдгүй	tʰ e r e k n uː t k u i̯
автокраны	a w̜ tʰ ɔ kʰ r a n i
байна	p æː n
блүтүүт	p ɮ u tʰ uː tʰ
автокрантай	a w̜ tʰ ɔ kʰ r a n tʰ ɛː
нээх	n eː x
хүндээ	x u n t eː
автомашинуудад	a w̜ tʰ ɔ m a ɕ i n ʊː t a t
шүүс	ʃ uː s
динозавртай	t i n ɔ t͡s a w̜ r̥ tʰ ɛː
багаж	p a ɢ t͡ɕ
ханхайнх	x a ŋ x ɛː ŋ x
арын	a r i ŋ
бумба	p ʊ m p
гитаруудгүй	k i tʰ a r ʊː t k u i̯
анхилгаас	a ŋ x i ɮ k aː s
тэнгисгүй	tʰ e ŋ k i s k u i̯
хөлдөөх	x ɵ ɮ t ɵː x
жууцайг	t͡ɕ ʊː t͡sʰ ɛː k
дээ	t eː
автобуснуудтай	a w̜ tʰ ɔ p ʊ s n ʊː t tʰ ɛː
хасаг	x ɐ s ɐ k
төгрөгүүдийг	tʰ ɵ k r ɵ ɣ uː t iː k
Арвайхээр	a r w̜ ɛː x eː r̥
дэх	t e x
грекүүдийн	k rʲ ɵ kʰ uː t iː ŋ
х	x
ааруулаас	aː r ʊː ɮ aː s
хаалга	x aː ɮ ə ɢ
дампуурал	t a m pʰ ʊː r a ɮ
халдах	x a ɮ t a x
гайхлуудтай	k ɛː x ɮ ʊː t tʰ ɛː
Москва	m ɔ s kʰ w̜ a
ханхайнуудынх	x a ŋ x ɛː n ʊː t i ŋ x
хүмүүсийг	x u m uː s iː k
чанасан	t͡ɕʰ a n a s a ŋ
мушгирах	m ʊ ʃ ɡʲ ə r ə x
авснуудаас	a w̜ s n ʊː t aː s
нэг	n e ɡ
гитарынхаа	k i tʰ a r i ŋ x aː
гахай	ɢ a χ æː
бийр	p iː r
илжигнүүдтэй	i ɮ t͡ɕ i k n uː t tʰ e i̯
захиа	t͡s a x j a
уснуудтай	ʊ s n ʊː t tʰ ɛː
тэргийг	tʰ e r k iː k
шулуун	ʃ ʊ ɮ ʊ ŋ
рестораных	rʲ ɵ s tʰ ɔ r a n i x
подвоолк	pʰ ɔ t w̜ oː ɮ kʰ
доо	t oː
хавар	x a w̜ ə r̥
айлчлах	a i ɮ t͡ɕʰ ɮ ə x
Чингис	t͡ɕʰ i ŋ k i s
урвагч	ʊ r w̜ a ɡ t͡ʃʰ
тахиудынхаа	tʰ a x i̯ ʊː t i ŋ x aː
үгсийн	u k s iː ŋ
пиццануудтай	pʰ i t͡sʰ a n ʊː t tʰ ɛː
ноёдоос	n ɔ j ɔ t oː s
гуайгаар	k u̯ ɛː k aː r̥
боорцог	p ɔː r t͡sʰ ə ɡ
бойпор	p ɔ i̯ pʰ ɔ r̥
автобусныхан	a w̜ tʰ ɔ p ʊ s n i x a ŋ
Чингисийнхэд	t͡ɕʰ i ŋ k i s iː ŋ x e t
адгуусны	a t k ʊː s n i
Финланд	f i n ɮ a n t
нэгдсэн	n e ɡ t s e n
явцуу	j a w t͡sʰ ʊ
хэрэгтэй	x i r ə ɡ tʰ e
бургаснуудгүй	p ʊ r k a s n ʊː t k u i̯
кураш	kʰ ʊ r a ɕ
долоодугаар	t ɔ ɮ oː t ʊ ɣ aː r̥
еэвэн	j eː w ə ŋ
галигуудыг	k a ɮ i ɣ ʊː t i k
мэдэрхэх	m i t ə r x ə x
гурамсан	k ʊ r a m s a ŋ
хаах	x aː x
бууз	p ʊː t͡s
Улаангом	ʊ ɮ aː ŋ k ɔ m
худалч	x ʊ t ə ɮ t͡ɕʰ
шашныхаа	ɕ a ɕ n i x aː
ресторануудтай	rʲ ɵ s tʰ ɔ r a n ʊː t tʰ ɛː
ачих	a t͡ɕʰ i x
дэ	t e
радиус	r a t i̯ ʊː s
амьтнаар	a mʲ tʰ n aː r̥
лалруудын	ɮ a ɮ r ʊː t i ŋ
тэрэг	tʰ e r e k
жигнэмэг	t͡ɕ i ɡ n ə m ə ɡ
ноёдынх	n ɔ j ɔ t i ŋ x
тавь	tʰ a w̜ʲ
мориныхдоо	m ɔ r i n i x t oː
шүүр	ɕ uː r̥
зуух	t͡s ʊː x
хадуур	x a t ʊ r
киноныхон	kʰ i n ɔ n i x ɔ ŋ
орхоодой	ɔ r x ɔː t ɔ i
хүмүүсээ	x u m uː s eː
анаашинд	a n aː ɕ i n t
жавтий	t͡ɕ a w̜ tʰ iː
Женев	d ʒ ɛ n ɛ f
аалзнаас	aː ɮ t͡s n aː s
оффис	ɔ f i s
зураач	t͡s ʊ r aː t͡ɕʰ
хөхүүр	x o x u r
намар	n a m a r̥
ноёныд	n ɔ j ɔ n i t
маш	m a ʃ
анчных	a n t͡ɕʰ n i x
тахиануудаас	tʰ a x i̯ aː n ʊː t aː s
өөрийн	ɵː r iː ŋ
үйлчлэл	u i̯ ɮ t͡ɕʰ ɮ e ɮ
жишээнүүдийн	t͡ɕ i ɕ eː n uː t iː ŋ
чидун	t͡ɕʰ i t ʊ ŋ
хаадаараа	x aː t aː r aː
хурал	x ʊ r ə ɮ
цэвэрлэх	t͡sʰ e w ə r ɮ ə x
уламжлалт	ʊ ɮ ə m t͡ɕ ɮ ə ɮ tʰ
дуулгавар	t ʊː ɮ ɢ ə w ə r
амьтанд	a mʲ tʰ a n t
анхилгуудаасаа	a ŋ x i ɮ k ʊː t aː s aː
харандаа	x a r ə n t a
үйлдвэр	u i ɮ t w ə r
африкаанс	a f r i kʰ aː n s
оймс	o i m s
буддынхаа	p ʊ t͉ t i ŋ x aː
магистр	m a k i s tʰ r̥
мусульман	m ʊ s ʊ ɮʲ m a ŋ
удирдамж	ʊ t i r t a m t͡ɕ
грекүүдэд	k rʲ ɵ kʰ uː t e t
сексүүдгүй	s j ɵ kʰ s uː t k u i̯
констракшн	kʰ ɔ n s tʰ r a kʰ ɕ ŋ
гүнждийнхээ	k u n t͡ɕ t iː ŋ x eː
автокранууд	a w̜ tʰ ɔ kʰ r a n ʊː t
пэ	pʰ e
наймдугаар	n ɛː m t ʊ ɣ aː r̥
гүнжээр	k u n t͡ɕ eː r̥
аптек	a pʰ tʰ e kʰ
тэнгэс	tʰ i ŋ ɡ ə s
ахлагч	a x ɮ a k t͡ɕʰ
мөнгө	m o ŋ ɡ
гэлэн	ɡ i ɮ ə ŋ
шашнуудад	ɕ a ɕ n ʊː t a t
хүнс	x u n s
байрнуудыг	p ɛː r n ʊː t i k
групп	k r ʊ pʰ
аагаар	aː k aː r̥
мэндчилгээ	m i n t t͡ʃʰ i ɮ ɡ eː
ааруулд	aː r ʊː ɮ t
пиццаных	pʰ i t͡sʰ a n i x
холтсоор	x ɔ ɮ tʰ s oː r̥
видео	w̜ i tʲ ɵ
нэрснийхээ	n e r s n iː x eː
баах	p aː x
ханхайнууд	x a ŋ x ɛː n ʊː t
